id_produto,categoria,custo_medio,data,quantidade_saida,quantidade_entrada,preco_und_medio,valor_total,dia_semana,mes,is_weekend,semana_do_ano,saldo_dia,categoria_encoded
100101,Electronics,80.03144836425781,2022-01-01,102,447,72.72000061035156,39923.280124511715,5,1,1,52,102,1
100101,Electronics,80.03144836425781,2022-01-02,71,0,72.72000122070312,5163.120086669922,6,1,1,52,173,1
100101,Electronics,80.03144836425781,2022-01-03,142,229,69.6857666015625,25754.607714843747,0,1,0,1,315,1
100101,Electronics,80.03144836425781,2022-01-04,42,0,70.821533203125,2974.50439453125,1,1,0,1,357,1
100101,Electronics,80.03144836425781,2022-01-05,129,0,70.821533203125,9135.977783203125,2,1,0,1,486,1
100101,Electronics,80.03144836425781,2022-01-06,98,308,81.51031173706055,33622.32110046387,3,1,0,1,584,1
100101,Electronics,80.03144836425781,2022-01-07,92,0,78.9906234741211,7267.137359619141,4,1,0,1,676,1
100101,Electronics,80.03144836425781,2022-01-08,96,248,71.44905975341797,24139.33947265625,5,1,1,1,772,1
100101,Electronics,80.03144836425781,2022-01-09,57,0,74.33811950683594,4237.272811889648,6,1,1,1,829,1
100101,Electronics,80.03144836425781,2022-01-10,88,0,74.33811950683594,6541.7545166015625,0,1,0,2,917,1
100101,Electronics,80.03144836425781,2022-01-11,112,0,74.33811950683594,8325.869384765625,1,1,0,2,1029,1
100101,Electronics,80.03144836425781,2022-01-12,70,179,68.03926361083984,16693.33690551758,2,1,0,2,1099,1
100101,Electronics,80.03144836425781,2022-01-13,80,0,70.31852722167969,5625.482177734375,3,1,0,2,1179,1
100101,Electronics,80.03144836425781,2022-01-14,52,0,70.31852722167969,3656.5634155273438,4,1,0,2,1231,1
100101,Electronics,80.03144836425781,2022-01-15,126,287,79.69224151611328,33273.17486206055,5,1,1,2,1357,1
100101,Electronics,80.03144836425781,2022-01-16,54,298,72.84684463500977,25232.939220581055,6,1,1,2,1411,1
100101,Electronics,80.03144836425781,2022-01-17,73,0,74.52368927001953,5440.229316711426,0,1,0,3,1484,1
100101,Electronics,80.03144836425781,2022-01-18,101,0,74.52368927001953,7526.892616271973,1,1,0,3,1585,1
100101,Electronics,80.03144836425781,2022-01-19,103,0,74.52368927001953,7675.939994812012,2,1,0,3,1688,1
100101,Electronics,80.03144836425781,2022-01-20,20,0,74.52368927001953,1490.4737854003906,3,1,0,3,1708,1
100101,Electronics,80.03144836425781,2022-01-21,92,0,74.52368927001953,6856.179412841797,4,1,0,3,1800,1
100101,Electronics,80.03144836425781,2022-01-22,87,181,76.48950180053711,20564.09331329346,5,1,1,3,1887,1
100101,Electronics,80.03144836425781,2022-01-23,109,276,72.03603469848633,27517.435564270017,6,1,1,3,1996,1
100101,Electronics,80.03144836425781,2022-01-24,29,0,73.33206939697266,2126.630012512207,0,1,0,4,2025,1
100101,Electronics,80.03144836425781,2022-01-25,55,0,73.33206939697266,4033.263816833496,1,1,0,4,2080,1
100101,Electronics,80.03144836425781,2022-01-26,147,331,70.04471557617188,33263.386379394535,2,1,0,4,2227,1
100101,Electronics,80.03144836425781,2022-01-27,93,0,71.22943115234375,6624.337097167969,3,1,0,4,2320,1
100101,Electronics,80.03144836425781,2022-01-28,201,343,77.76360244750977,42677.76818389892,4,1,0,4,2521,1
100101,Electronics,80.03144836425781,2022-01-29,69,0,75.12720489501953,5183.777137756348,5,1,1,4,2590,1
100101,Electronics,80.03144836425781,2022-01-30,73,0,75.12720489501953,5484.285957336426,6,1,1,4,2663,1
100101,Electronics,80.03144836425781,2022-01-31,103,0,75.12720489501953,7738.102104187012,0,1,0,5,2766,1
100101,Electronics,80.03144836425781,2022-02-01,102,0,75.12720489501953,7662.974899291992,1,2,0,5,2868,1
100101,Electronics,80.03144836425781,2022-02-02,94,215,64.24914367675781,19358.19901123047,2,2,0,5,2962,1
100101,Electronics,80.03144836425781,2022-02-03,41,0,68.33828735351562,2801.8697814941406,3,2,0,5,3003,1
100101,Electronics,80.03144836425781,2022-02-04,76,0,68.33828735351562,5193.7098388671875,4,2,0,5,3079,1
100101,Electronics,80.03144836425781,2022-02-05,81,0,68.33828735351562,5535.401275634766,5,2,1,5,3160,1
100101,Electronics,80.03144836425781,2022-02-06,65,124,67.29259567260742,12692.187437438964,6,2,1,5,3225,1
100101,Electronics,80.03144836425781,2022-02-07,74,0,67.73519134521484,5012.404159545898,0,2,0,6,3299,1
100101,Electronics,80.03144836425781,2022-02-08,84,298,75.31991027832032,29127.464926757813,1,2,0,6,3383,1
100101,Electronics,80.03144836425781,2022-02-09,83,0,73.65982055664062,6113.765106201172,2,2,0,6,3466,1
100101,Electronics,80.03144836425781,2022-02-10,59,0,73.65982055664062,4345.929412841797,3,2,0,6,3525,1
100101,Electronics,80.03144836425781,2022-02-11,108,247,77.09871994018555,27525.90350708008,4,2,0,6,3633,1
100101,Electronics,80.03144836425781,2022-02-12,111,288,79.36697814941405,31905.13914916992,5,2,1,6,3744,1
100101,Electronics,80.03144836425781,2022-02-13,65,0,78.02395629882812,5071.557159423828,6,2,1,6,3809,1
100101,Electronics,80.03144836425781,2022-02-14,54,0,78.02395629882812,4213.293640136719,0,2,0,7,3863,1
100101,Electronics,80.03144836425781,2022-02-15,109,0,78.02395629882812,8504.611236572266,1,2,0,7,3972,1
100101,Electronics,80.03144836425781,2022-02-16,114,0,78.02395629882812,8894.731018066406,2,2,0,7,4086,1
100101,Electronics,80.03144836425781,2022-02-17,66,142,57.77718811035156,11358.188830566407,3,2,0,7,4152,1
100101,Electronics,80.03144836425781,2022-02-18,142,218,77.04025161743164,28055.191459350586,4,2,0,7,4294,1
100101,Electronics,80.03144836425781,2022-02-19,41,0,72.82050323486328,2985.6406326293945,5,2,1,7,4335,1
100101,Electronics,80.03144836425781,2022-02-20,161,267,76.66734558105469,32967.60527709961,6,2,1,7,4496,1
100101,Electronics,80.03144836425781,2022-02-21,135,0,75.21469116210938,10153.983306884766,0,2,0,8,4631,1
100101,Electronics,80.03144836425781,2022-02-22,81,294,73.53212677001953,27454.814536743164,1,2,0,8,4712,1
100101,Electronics,80.03144836425781,2022-02-23,167,0,74.09425354003906,12373.740341186523,2,2,0,8,4879,1
100101,Electronics,80.03144836425781,2022-02-24,104,0,74.09425354003906,7705.8023681640625,3,2,0,8,4983,1
100101,Electronics,80.03144836425781,2022-02-25,111,243,76.83242630004884,27317.15863861084,4,2,0,8,5094,1
100101,Electronics,80.03144836425781,2022-02-26,73,0,75.93485260009766,5543.244239807129,5,2,1,8,5167,1
100101,Electronics,80.03144836425781,2022-02-27,141,305,76.88091156005859,34339.57705993652,6,2,1,8,5308,1
100101,Electronics,80.03144836425781,2022-02-28,112,0,76.57182312011719,8576.044189453125,0,2,0,9,5420,1
100101,Electronics,80.03144836425781,2022-03-01,89,283,75.98386276245117,28222.56757171631,1,3,0,9,5509,1
100101,Electronics,80.03144836425781,2022-03-02,101,0,76.20772552490234,7696.980278015137,2,3,0,9,5610,1
100101,Electronics,80.03144836425781,2022-03-03,111,0,76.20772552490234,8459.05753326416,3,3,0,9,5721,1
100101,Electronics,80.03144836425781,2022-03-04,95,0,76.20772552490234,7239.733924865723,4,3,0,9,5816,1
100101,Electronics,80.03144836425781,2022-03-05,87,171,71.02913375854493,18148.349273986816,5,3,1,9,5903,1
100101,Electronics,80.03144836425781,2022-03-06,115,301,65.68985336303712,26847.126273498536,6,3,1,9,6018,1
100101,Electronics,80.03144836425781,2022-03-07,94,0,68.26970672607422,6417.352432250977,0,3,0,10,6112,1
100101,Electronics,80.03144836425781,2022-03-08,45,0,68.26970672607422,3072.13680267334,1,3,0,10,6157,1
100101,Electronics,80.03144836425781,2022-03-09,195,383,78.07102310180665,45720.81900970459,2,3,0,10,6352,1
100101,Electronics,80.03144836425781,2022-03-10,65,0,74.90204620361328,4868.633003234863,3,3,0,10,6417,1
100101,Electronics,80.03144836425781,2022-03-11,32,0,74.90204620361328,2396.865478515625,4,3,0,10,6449,1
100101,Electronics,80.03144836425781,2022-03-12,77,0,74.90204620361328,5767.457557678223,5,3,1,10,6526,1
100101,Electronics,80.03144836425781,2022-03-13,75,0,74.90204620361328,5617.653465270996,6,3,1,10,6601,1
100101,Electronics,80.03144836425781,2022-03-14,118,192,77.41679443359375,24081.583486328127,0,3,0,11,6719,1
100101,Electronics,80.03144836425781,2022-03-15,129,0,76.3035888671875,9843.162963867188,1,3,0,11,6848,1
100101,Electronics,80.03144836425781,2022-03-16,103,203,71.53666244506836,21708.552463684082,2,3,0,11,6951,1
100101,Electronics,80.03144836425781,2022-03-17,92,0,73.35332489013672,6748.505889892578,3,3,0,11,7043,1
100101,Electronics,80.03144836425781,2022-03-18,103,172,69.27699722290039,18930.63142791748,4,3,0,11,7146,1
100101,Electronics,80.03144836425781,2022-03-19,75,270,78.77617034912109,27747.925552368164,5,3,1,11,7221,1
100101,Electronics,80.03144836425781,2022-03-20,147,0,75.85234069824219,11150.294082641602,6,3,1,11,7368,1
100101,Electronics,80.03144836425781,2022-03-21,74,0,75.85234069824219,5613.073211669922,0,3,0,12,7442,1
100101,Electronics,80.03144836425781,2022-03-22,80,0,75.85234069824219,6068.187255859375,1,3,0,12,7522,1
100101,Electronics,80.03144836425781,2022-03-23,90,147,65.84458770751954,15360.375787353516,2,3,0,12,7612,1
100101,Electronics,80.03144836425781,2022-03-24,41,0,70.13917541503906,2875.7061920166016,3,3,0,12,7653,1
100101,Electronics,80.03144836425781,2022-03-25,107,275,69.10226013183595,26344.60366821289,4,3,0,12,7760,1
100101,Electronics,80.03144836425781,2022-03-26,99,0,69.41452026367188,6872.037506103516,5,3,1,12,7859,1
100101,Electronics,80.03144836425781,2022-03-27,111,0,69.41452026367188,7705.011749267578,6,3,1,12,7970,1
100101,Electronics,80.03144836425781,2022-03-28,65,119,62.744031066894536,11382.68403869629,0,3,0,13,8035,1
100101,Electronics,80.03144836425781,2022-03-29,130,342,79.48411102294922,38293.6688659668,1,3,0,13,8165,1
100101,Electronics,80.03144836425781,2022-03-30,73,0,75.81822204589844,5534.730209350586,2,3,0,13,8238,1
100101,Electronics,80.03144836425781,2022-03-31,121,0,75.81822204589844,9174.004867553711,3,3,0,13,8359,1
100101,Electronics,80.03144836425781,2022-04-01,59,0,75.81822204589844,4473.275100708008,4,4,0,13,8418,1
100101,Electronics,80.03144836425781,2022-04-02,111,200,70.44739120483399,21745.610847473145,5,4,1,13,8529,1
100101,Electronics,80.03144836425781,2022-04-03,97,321,81.51160797119141,34725.57194641113,6,4,1,13,8626,1
100101,Electronics,80.03144836425781,2022-04-04,89,0,78.59321594238281,6994.79621887207,0,4,0,14,8715,1
100101,Electronics,80.03144836425781,2022-04-05,79,0,78.59321594238281,6208.864059448242,1,4,0,14,8794,1
100101,Electronics,80.03144836425781,2022-04-06,65,0,78.59321594238281,5108.559036254883,2,4,0,14,8859,1
100101,Electronics,80.03144836425781,2022-04-07,71,0,78.59321594238281,5580.11833190918,3,4,0,14,8930,1
100101,Electronics,80.03144836425781,2022-04-08,69,264,71.0942593383789,23248.457788696287,4,4,0,14,8999,1
100101,Electronics,80.03144836425781,2022-04-09,43,0,73.27851867675781,3150.976303100586,5,4,1,14,9042,1
100101,Electronics,80.03144836425781,2022-04-10,131,333,82.65653228759766,39028.011459350586,6,4,1,14,9173,1
100101,Electronics,80.03144836425781,2022-04-11,143,0,79.31306457519531,11341.76823425293,0,4,0,15,9316,1
100101,Electronics,80.03144836425781,2022-04-12,132,308,73.85684448242188,32103.326943359378,1,4,0,15,9448,1
100101,Electronics,80.03144836425781,2022-04-13,84,0,76.09368896484375,6391.869873046875,2,4,0,15,9532,1
100101,Electronics,80.03144836425781,2022-04-14,106,0,76.09368896484375,8065.9310302734375,3,4,0,15,9638,1
100101,Electronics,80.03144836425781,2022-04-15,132,328,82.73166122436524,38559.958563232416,4,4,0,15,9770,1
100101,Electronics,80.03144836425781,2022-04-16,93,0,80.16332244873047,7455.188987731934,5,4,1,15,9863,1
100101,Electronics,80.03144836425781,2022-04-17,105,0,80.16332244873047,8417.1488571167,6,4,1,15,9968,1
100101,Electronics,80.03144836425781,2022-04-18,68,0,80.16332244873047,5451.105926513672,0,4,0,16,10036,1
100101,Electronics,80.03144836425781,2022-04-19,62,0,80.16332244873047,4970.125991821289,1,4,0,16,10098,1
100101,Electronics,80.03144836425781,2022-04-20,116,191,77.36741622924805,23662.740565185548,2,4,0,16,10214,1
100101,Electronics,80.03144836425781,2022-04-21,84,0,78.5548324584961,6598.605926513672,3,4,0,16,10298,1
100101,Electronics,80.03144836425781,2022-04-22,59,0,78.5548324584961,4634.7351150512695,4,4,0,16,10357,1
100101,Electronics,80.03144836425781,2022-04-23,35,0,78.5548324584961,2749.4191360473633,5,4,1,16,10392,1
100101,Electronics,80.03144836425781,2022-04-24,30,0,78.5548324584961,2356.644973754883,6,4,1,16,10422,1
100101,Electronics,80.03144836425781,2022-04-25,66,106,62.58955001831055,10501.820602416992,0,4,0,17,10488,1
100101,Electronics,80.03144836425781,2022-04-26,40,119,59.02460922241211,9029.838737792968,1,4,0,17,10528,1
100101,Electronics,80.03144836425781,2022-04-27,66,0,63.51921844482422,4192.268417358398,2,4,0,17,10594,1
100101,Electronics,80.03144836425781,2022-04-28,62,132,63.80578216552735,12387.01698852539,3,4,0,17,10656,1
100101,Electronics,80.03144836425781,2022-04-29,42,0,63.68156433105469,2674.625701904297,4,4,0,17,10698,1
100101,Electronics,80.03144836425781,2022-04-30,29,0,63.68156433105469,1846.765365600586,5,4,1,17,10727,1
100101,Electronics,80.03144836425781,2022-05-01,49,0,63.68156433105469,3120.3966522216797,6,5,1,17,10776,1
100101,Electronics,80.03144836425781,2022-05-02,24,0,63.68156433105469,1528.3575439453125,0,5,0,18,10800,1
100101,Electronics,80.03144836425781,2022-05-03,43,119,56.62712677001953,8986.09290222168,1,5,0,18,10843,1
100101,Electronics,80.03144836425781,2022-05-04,64,142,59.725936050415044,12324.139814453125,2,5,0,18,10907,1
100101,Electronics,80.03144836425781,2022-05-05,70,0,59.46187210083008,4162.3310470581055,3,5,0,18,10977,1
100101,Electronics,80.03144836425781,2022-05-06,35,0,59.46187210083008,2081.1655235290527,4,5,0,18,11012,1
100101,Electronics,80.03144836425781,2022-05-07,60,125,59.35450485229492,10977.69058227539,5,5,1,18,11072,1
100101,Electronics,80.03144836425781,2022-05-08,49,0,59.399009704589844,2910.5514755249023,6,5,1,18,11121,1
100101,Electronics,80.03144836425781,2022-05-09,58,157,54.677384796142576,11577.696636352539,0,5,0,19,11179,1
100101,Electronics,80.03144836425781,2022-05-10,29,0,56.474769592285156,1637.7683181762695,1,5,0,19,11208,1
100101,Electronics,80.03144836425781,2022-05-11,31,0,56.474769592285156,1750.7178573608398,2,5,0,19,11239,1
100101,Electronics,80.03144836425781,2022-05-12,44,0,56.474769592285156,2484.889862060547,3,5,0,19,11283,1
100101,Electronics,80.03144836425781,2022-05-13,53,156,65.03961647033691,13924.979345855714,4,5,0,19,11336,1
100101,Electronics,80.03144836425781,2022-05-14,36,0,61.81923294067383,2225.492385864258,5,5,1,19,11372,1
100101,Electronics,80.03144836425781,2022-05-15,53,0,61.81923294067383,3276.419345855713,6,5,1,19,11425,1
100101,Electronics,80.03144836425781,2022-05-16,67,140,64.22977363586426,13369.30966720581,0,5,0,20,11492,1
100101,Electronics,80.03144836425781,2022-05-17,85,0,63.219547271728516,5373.661518096924,1,5,0,20,11577,1
100101,Electronics,80.03144836425781,2022-05-18,46,0,63.219547271728516,2908.0991744995117,2,5,0,20,11623,1
100101,Electronics,80.03144836425781,2022-05-19,60,109,54.52042510986328,9044.391013183595,3,5,0,20,11683,1
100101,Electronics,80.03144836425781,2022-05-20,42,0,57.98085021972656,2435.1957092285156,4,5,0,20,11725,1
100101,Electronics,80.03144836425781,2022-05-21,81,199,63.87801170349121,18077.237895965576,5,5,1,20,11806,1
100101,Electronics,80.03144836425781,2022-05-22,70,207,62.73238464355469,17402.57385009766,6,5,1,20,11876,1
100101,Electronics,80.03144836425781,2022-05-23,48,0,62.544769287109375,3002.14892578125,0,5,0,21,11924,1
100101,Electronics,80.03144836425781,2022-05-24,19,0,62.544769287109375,1188.3506164550781,1,5,0,21,11943,1
100101,Electronics,80.03144836425781,2022-05-25,36,0,62.544769287109375,2251.6116943359375,2,5,0,21,11979,1
100101,Electronics,80.03144836425781,2022-05-26,72,0,62.544769287109375,4503.223388671875,3,5,0,21,12051,1
100101,Electronics,80.03144836425781,2022-05-27,50,0,62.544769287109375,3127.2384643554688,4,5,0,21,12101,1
100101,Electronics,80.03144836425781,2022-05-28,86,237,71.26130767822266,23381.114920654298,5,5,1,21,12187,1
100101,Electronics,80.03144836425781,2022-05-29,95,0,68.85261535644531,6540.998458862305,6,5,1,21,12282,1
100101,Electronics,80.03144836425781,2022-05-30,57,217,70.23258911132812,19321.715158691404,0,5,0,22,12339,1
100101,Electronics,80.03144836425781,2022-05-31,82,0,69.74517822265625,5719.1046142578125,1,5,0,22,12421,1
100101,Electronics,80.03144836425781,2022-06-01,145,278,72.55413452148437,30825.509011230468,2,6,0,22,12566,1
100101,Electronics,80.03144836425781,2022-06-02,93,0,71.53826904296875,6653.059020996094,3,6,0,22,12659,1
100101,Electronics,80.03144836425781,2022-06-03,44,0,71.53826904296875,3147.683837890625,4,6,0,22,12703,1
100101,Electronics,80.03144836425781,2022-06-04,34,0,71.53826904296875,2432.3011474609375,5,6,1,22,12737,1
100101,Electronics,80.03144836425781,2022-06-05,45,0,71.53826904296875,3219.2221069335938,6,6,1,22,12782,1
100101,Electronics,80.03144836425781,2022-06-06,107,227,75.23858367919922,25279.856907348632,0,6,0,23,12889,1
100101,Electronics,80.03144836425781,2022-06-07,55,0,73.98716735839844,4069.294204711914,1,6,0,23,12944,1
100101,Electronics,80.03144836425781,2022-06-08,134,270,71.33949584960938,28693.384887695312,2,6,0,23,13078,1
100101,Electronics,80.03144836425781,2022-06-09,74,0,72.27899169921875,5348.6453857421875,3,6,0,23,13152,1
100101,Electronics,80.03144836425781,2022-06-10,67,0,72.27899169921875,4842.692443847656,4,6,0,23,13219,1
100101,Electronics,80.03144836425781,2022-06-11,100,256,76.50513412475587,27475.266824951173,5,6,1,23,13319,1
100101,Electronics,80.03144836425781,2022-06-12,138,0,74.97026824951172,10345.897018432617,6,6,1,23,13457,1
100101,Electronics,80.03144836425781,2022-06-13,52,0,74.97026824951172,3898.4539489746094,0,6,0,24,13509,1
100101,Electronics,80.03144836425781,2022-06-14,126,225,80.95069259643554,28629.444534301758,1,6,0,24,13635,1
100101,Electronics,80.03144836425781,2022-06-15,82,0,78.7713851928711,6459.25358581543,2,6,0,24,13717,1
100101,Electronics,80.03144836425781,2022-06-16,42,0,78.7713851928711,3308.398178100586,3,6,0,24,13759,1
100101,Electronics,80.03144836425781,2022-06-17,113,220,72.06264221191407,23748.337139892577,4,6,0,24,13872,1
100101,Electronics,80.03144836425781,2022-06-18,120,302,73.27859634399414,30851.023122558592,5,6,1,24,13992,1
100101,Electronics,80.03144836425781,2022-06-19,123,0,73.67719268798828,9062.294700622559,6,6,1,24,14115,1
100101,Electronics,80.03144836425781,2022-06-20,69,0,73.67719268798828,5083.726295471191,0,6,0,25,14184,1
100101,Electronics,80.03144836425781,2022-06-21,126,0,73.67719268798828,9283.326278686523,1,6,0,25,14310,1
100101,Electronics,80.03144836425781,2022-06-22,63,216,70.71131790161132,19582.90605560303,2,6,0,25,14373,1
100101,Electronics,80.03144836425781,2022-06-23,44,0,71.66263580322266,3153.155975341797,3,6,0,25,14417,1
100101,Electronics,80.03144836425781,2022-06-24,56,0,71.66263580322266,4013.1076049804688,4,6,0,25,14473,1
100101,Electronics,80.03144836425781,2022-06-25,58,0,71.66263580322266,4156.432876586914,5,6,1,25,14531,1
100101,Electronics,80.03144836425781,2022-06-26,110,193,69.8922381591797,21127.362395019532,6,6,1,25,14641,1
100101,Electronics,80.03144836425781,2022-06-27,62,0,70.49447631835938,4370.657531738281,0,6,0,26,14703,1
100101,Electronics,80.03144836425781,2022-06-28,96,203,63.180431060791015,18615.912763671877,1,6,0,26,14799,1
100101,Electronics,80.03144836425781,2022-06-29,27,0,65.75086212158203,1775.2732772827148,2,6,0,26,14826,1
100101,Electronics,80.03144836425781,2022-06-30,39,0,65.75086212158203,2564.283622741699,3,6,0,26,14865,1
100101,Electronics,80.03144836425781,2022-07-01,45,0,65.75086212158203,2958.7887954711914,4,7,0,26,14910,1
100101,Electronics,80.03144836425781,2022-07-02,27,0,65.75086212158203,1775.2732772827148,5,7,1,26,14937,1
100101,Electronics,80.03144836425781,2022-07-03,48,145,63.53450973510742,12177.332934570311,6,7,1,26,14985,1
100101,Electronics,80.03144836425781,2022-07-04,29,0,64.40901947021484,1867.8615646362305,0,7,0,27,15014,1
100101,Electronics,80.03144836425781,2022-07-05,35,0,64.40901947021484,2254.3156814575195,1,7,0,27,15049,1
100101,Electronics,80.03144836425781,2022-07-06,37,0,64.40901947021484,2383.133720397949,2,7,0,27,15086,1
100101,Electronics,80.03144836425781,2022-07-07,46,128,60.09129203796387,10307.358867492676,3,7,0,27,15132,1
100101,Electronics,80.03144836425781,2022-07-08,22,0,61.902584075927734,1361.8568496704102,4,7,0,27,15154,1
100101,Electronics,80.03144836425781,2022-07-09,33,0,61.902584075927734,2042.7852745056152,5,7,1,27,15187,1
100101,Electronics,80.03144836425781,2022-07-10,42,0,61.902584075927734,2599.908531188965,6,7,1,27,15229,1
100101,Electronics,80.03144836425781,2022-07-11,15,0,61.902584075927734,928.538761138916,0,7,0,28,15244,1
100101,Electronics,80.03144836425781,2022-07-12,32,73,54.804934692382815,5604.6658203125,1,7,0,28,15276,1
100101,Electronics,80.03144836425781,2022-07-13,20,0,58.459869384765625,1169.1973876953125,2,7,0,28,15296,1
100101,Electronics,80.03144836425781,2022-07-14,52,154,56.41396423339844,11545.392280273438,3,7,0,28,15348,1
100101,Electronics,80.03144836425781,2022-07-15,29,0,57.157928466796875,1657.5799255371094,4,7,0,28,15377,1
100101,Electronics,80.03144836425781,2022-07-16,86,226,59.8970475769043,18824.092183227538,5,7,1,28,15463,1
100101,Electronics,80.03144836425781,2022-07-17,50,0,58.924095153808594,2946.2047576904297,6,7,1,28,15513,1
100101,Electronics,80.03144836425781,2022-07-18,39,0,58.924095153808594,2298.039710998535,0,7,0,29,15552,1
100101,Electronics,80.03144836425781,2022-07-19,47,0,58.924095153808594,2769.432472229004,1,7,0,29,15599,1
100101,Electronics,80.03144836425781,2022-07-20,65,0,58.924095153808594,3830.0661849975586,2,7,0,29,15664,1
100101,Electronics,80.03144836425781,2022-07-21,39,0,58.924095153808594,2298.039710998535,3,7,0,29,15703,1
100101,Electronics,80.03144836425781,2022-07-22,85,263,68.96382125854493,24393.889613952637,4,7,0,29,15788,1
100101,Electronics,80.03144836425781,2022-07-23,64,0,66.74764251708984,4271.84912109375,5,7,1,29,15852,1
100101,Electronics,80.03144836425781,2022-07-24,38,0,66.74764251708984,2536.410415649414,6,7,1,29,15890,1
100101,Electronics,80.03144836425781,2022-07-25,64,129,67.10399795532226,12961.86173828125,0,7,0,30,15954,1
100101,Electronics,80.03144836425781,2022-07-26,95,231,69.63856109619141,22843.80660827637,1,7,0,30,16049,1
100101,Electronics,80.03144836425781,2022-07-27,116,0,68.59712219238281,7957.266174316406,2,7,0,30,16165,1
100101,Electronics,80.03144836425781,2022-07-28,72,0,68.59712219238281,4938.9927978515625,3,7,0,30,16237,1
100101,Electronics,80.03144836425781,2022-07-29,83,299,75.52710723876953,29277.499801635742,4,7,0,30,16320,1
100101,Electronics,80.03144836425781,2022-07-30,72,0,73.55421447753906,5295.9034423828125,5,7,1,30,16392,1
100101,Electronics,80.03144836425781,2022-07-31,132,0,73.55421447753906,9709.156311035156,6,7,1,30,16524,1
100101,Electronics,80.03144836425781,2022-08-01,117,245,71.55530685424804,25816.58180389404,0,8,0,31,16641,1
100101,Electronics,80.03144836425781,2022-08-02,53,0,72.2306137084961,3828.222526550293,1,8,0,31,16694,1
100101,Electronics,80.03144836425781,2022-08-03,146,257,77.01621871948242,31243.305866088867,2,8,0,31,16840,1
100101,Electronics,80.03144836425781,2022-08-04,158,0,75.16243743896484,11875.665115356445,3,8,0,31,16998,1
100101,Electronics,80.03144836425781,2022-08-05,40,0,75.16243743896484,3006.4974975585938,4,8,0,31,17038,1
100101,Electronics,80.03144836425781,2022-08-06,41,0,75.16243743896484,3081.6599349975586,5,8,1,31,17079,1
100101,Electronics,80.03144836425781,2022-08-07,92,204,75.1304231262207,22237.437855224613,6,8,1,31,17171,1
100101,Electronics,80.03144836425781,2022-08-08,86,247,67.9551188659668,22183.87044494629,0,8,0,32,17257,1
100101,Electronics,80.03144836425781,2022-08-09,47,0,70.7202377319336,3323.851173400879,1,8,0,32,17304,1
100101,Electronics,80.03144836425781,2022-08-10,35,0,70.7202377319336,2475.208320617676,2,8,0,32,17339,1
100101,Electronics,80.03144836425781,2022-08-11,76,0,70.7202377319336,5374.738067626953,3,8,0,32,17415,1
100101,Electronics,80.03144836425781,2022-08-12,118,292,66.9595329284668,27225.549771118167,4,8,0,32,17533,1
100101,Electronics,80.03144836425781,2022-08-13,67,0,68.2690658569336,4574.027412414551,5,8,1,32,17600,1
100101,Electronics,80.03144836425781,2022-08-14,103,0,68.2690658569336,7031.71378326416,6,8,1,32,17703,1
100101,Electronics,80.03144836425781,2022-08-15,107,0,68.2690658569336,7304.7900466918945,0,8,0,33,17810,1
100101,Electronics,80.03144836425781,2022-08-16,97,337,65.48821166992187,28263.913063964843,1,8,0,33,17907,1
100101,Electronics,80.03144836425781,2022-08-17,54,0,66.14642333984375,3571.9068603515625,2,8,0,33,17961,1
100101,Electronics,80.03144836425781,2022-08-18,93,0,66.14642333984375,6151.617370605469,3,8,0,33,18054,1
100101,Electronics,80.03144836425781,2022-08-19,83,0,66.14642333984375,5490.153137207031,4,8,0,33,18137,1
100101,Electronics,80.03144836425781,2022-08-20,85,215,73.98494857788086,22539.341258239747,5,8,1,33,18222,1
100101,Electronics,80.03144836425781,2022-08-21,105,0,71.33989715576172,7490.6892013549805,6,8,1,33,18327,1
100101,Electronics,80.03144836425781,2022-08-22,91,202,76.12006088256837,22502.97108062744,0,8,0,34,18418,1
100101,Electronics,80.03144836425781,2022-08-23,144,291,76.3796940612793,33339.871889648435,1,8,0,34,18562,1
100101,Electronics,80.03144836425781,2022-08-24,48,0,75.5993881225586,3628.7706298828125,2,8,0,34,18610,1
100101,Electronics,80.03144836425781,2022-08-25,174,0,75.5993881225586,13154.293533325195,3,8,0,34,18784,1
100101,Electronics,80.03144836425781,2022-08-26,60,0,75.5993881225586,4535.963287353516,4,8,0,34,18844,1
100101,Electronics,80.03144836425781,2022-08-27,79,213,72.07145935058594,20883.87057739258,5,8,1,34,18923,1
100101,Electronics,80.03144836425781,2022-08-28,57,0,73.27291870117188,4176.556365966797,6,8,1,34,18980,1
100101,Electronics,80.03144836425781,2022-08-29,122,236,77.24566329956055,27828.861845092775,0,8,0,35,19102,1
100101,Electronics,80.03144836425781,2022-08-30,83,0,75.7113265991211,6284.040107727051,1,8,0,35,19185,1
100101,Electronics,80.03144836425781,2022-08-31,90,0,75.7113265991211,6814.019393920898,2,8,0,35,19275,1
100101,Electronics,80.03144836425781,2022-09-01,44,0,75.7113265991211,3331.298370361328,3,9,0,35,19319,1
100101,Electronics,80.03144836425781,2022-09-02,50,105,68.00200119018555,10336.700119018555,4,9,0,35,19369,1
100101,Electronics,80.03144836425781,2022-09-03,139,213,73.29361099243164,25842.743855895995,5,9,1,35,19508,1
100101,Electronics,80.03144836425781,2022-09-04,62,0,72.70722198486328,4507.847763061523,6,9,1,35,19570,1
100101,Electronics,80.03144836425781,2022-09-05,59,0,72.70722198486328,4289.726097106934,0,9,0,36,19629,1
100101,Electronics,80.03144836425781,2022-09-06,71,196,59.88904251098633,15445.49403656006,1,9,0,36,19700,1
100101,Electronics,80.03144836425781,2022-09-07,83,0,64.24808502197266,5332.5910568237305,2,9,0,36,19783,1
100101,Electronics,80.03144836425781,2022-09-08,60,176,58.998966979980466,13674.476037597657,3,9,0,36,19843,1
100101,Electronics,80.03144836425781,2022-09-09,67,0,61.14793395996094,4096.911575317383,4,9,0,36,19910,1
100101,Electronics,80.03144836425781,2022-09-10,135,216,77.69336456298828,27811.988432006834,5,9,1,36,20045,1
100101,Electronics,80.03144836425781,2022-09-11,99,0,71.00672912597656,7029.66618347168,6,9,1,36,20144,1
100101,Electronics,80.03144836425781,2022-09-12,88,0,71.00672912597656,6248.5921630859375,0,9,0,37,20232,1
100101,Electronics,80.03144836425781,2022-09-13,86,216,73.71256698608398,22367.461521606445,1,9,0,37,20318,1
100101,Electronics,80.03144836425781,2022-09-14,101,365,69.52145004272461,32127.33290863037,2,9,0,37,20419,1
100101,Electronics,80.03144836425781,2022-09-15,106,0,70.54290008544922,7477.547409057617,3,9,0,37,20525,1
100101,Electronics,80.03144836425781,2022-09-16,102,0,70.54290008544922,7195.37580871582,4,9,0,37,20627,1
100101,Electronics,80.03144836425781,2022-09-17,73,0,70.54290008544922,5149.631706237793,5,9,1,37,20700,1
100101,Electronics,80.03144836425781,2022-09-18,144,351,74.50403091430664,37124.990903320315,6,9,1,37,20844,1
100101,Electronics,80.03144836425781,2022-09-19,68,0,73.31806182861328,4985.628204345703,0,9,0,38,20912,1
100101,Electronics,80.03144836425781,2022-09-20,83,0,73.31806182861328,6085.399131774902,1,9,0,38,20995,1
100101,Electronics,80.03144836425781,2022-09-21,140,0,73.31806182861328,10264.52865600586,2,9,0,38,21135,1
100101,Electronics,80.03144836425781,2022-09-22,74,207,71.74078140258788,20087.23564758301,3,9,0,38,21209,1
100101,Electronics,80.03144836425781,2022-09-23,41,0,72.28156280517578,2963.544075012207,4,9,0,38,21250,1
100101,Electronics,80.03144836425781,2022-09-24,119,220,77.69212432861329,26562.645590209962,5,9,1,38,21369,1
100101,Electronics,80.03144836425781,2022-09-25,80,0,75.46424865722656,6037.139892578125,6,9,1,38,21449,1
100101,Electronics,80.03144836425781,2022-09-26,102,344,70.01336288452148,30799.226028442383,0,9,0,39,21551,1
100101,Electronics,80.03144836425781,2022-09-27,72,0,71.77672576904297,5167.924255371094,1,9,0,39,21623,1
100101,Electronics,80.03144836425781,2022-09-28,43,0,71.77672576904297,3086.3992080688477,2,9,0,39,21666,1
100101,Electronics,80.03144836425781,2022-09-29,64,0,71.77672576904297,4593.71044921875,3,9,0,39,21730,1
100101,Electronics,80.03144836425781,2022-09-30,60,0,71.77672576904297,4306.603546142578,4,9,0,39,21790,1
100101,Electronics,80.03144836425781,2022-10-01,53,0,71.77672576904297,3804.1664657592773,5,10,1,39,21843,1
100101,Electronics,80.03144836425781,2022-10-02,119,244,68.06878219604492,24540.37016265869,6,10,1,39,21962,1
100101,Electronics,80.03144836425781,2022-10-03,63,0,69.41756439208984,4373.30655670166,0,10,0,40,22025,1
100101,Electronics,80.03144836425781,2022-10-04,86,0,69.41756439208984,5969.910537719727,1,10,0,40,22111,1
100101,Electronics,80.03144836425781,2022-10-05,100,187,74.5921809387207,21590.46618774414,2,10,0,40,22211,1
100101,Electronics,80.03144836425781,2022-10-06,82,0,72.4943618774414,5944.537673950195,3,10,0,40,22293,1
100101,Electronics,80.03144836425781,2022-10-07,94,214,69.65355972290038,21324.469227905272,4,10,0,40,22387,1
100101,Electronics,80.03144836425781,2022-10-08,119,0,70.72711944580078,8416.527214050293,5,10,1,40,22506,1
100101,Electronics,80.03144836425781,2022-10-09,48,0,70.72711944580078,3394.9017333984375,6,10,1,40,22554,1
100101,Electronics,80.03144836425781,2022-10-10,98,277,82.22654815673829,31406.583438720703,0,10,0,41,22652,1
100101,Electronics,80.03144836425781,2022-10-11,24,0,79.03309631347656,1896.7943115234375,1,10,0,41,22676,1
100101,Electronics,80.03144836425781,2022-10-12,91,0,79.03309631347656,7192.011764526367,2,10,0,41,22767,1
100101,Electronics,80.03144836425781,2022-10-13,75,0,79.03309631347656,5927.482223510742,3,10,0,41,22842,1
100101,Electronics,80.03144836425781,2022-10-14,115,166,63.6565837097168,17590.854253234866,4,10,0,41,22957,1
100101,Electronics,80.03144836425781,2022-10-15,50,0,69.4731674194336,3473.6583709716797,5,10,1,41,23007,1
100101,Electronics,80.03144836425781,2022-10-16,78,184,57.40163200378418,14584.314592590332,6,10,1,41,23085,1
100101,Electronics,80.03144836425781,2022-10-17,77,253,73.4663427734375,25029.496787109376,0,10,0,42,23162,1
100101,Electronics,80.03144836425781,2022-10-18,70,0,69.002685546875,4830.18798828125,1,10,0,42,23232,1
100101,Electronics,80.03144836425781,2022-10-19,95,0,69.002685546875,6555.255126953125,2,10,0,42,23327,1
100101,Electronics,80.03144836425781,2022-10-20,41,0,69.002685546875,2829.110107421875,3,10,0,42,23368,1
100101,Electronics,80.03144836425781,2022-10-21,64,0,69.002685546875,4416.171875,4,10,0,42,23432,1
100101,Electronics,80.03144836425781,2022-10-22,91,196,70.37420623779298,20248.405535278318,5,10,1,42,23523,1
100101,Electronics,80.03144836425781,2022-10-23,124,336,82.6071743774414,38869.09924560547,6,10,1,42,23647,1
100101,Electronics,80.03144836425781,2022-10-24,119,0,78.50434875488281,9342.017501831055,0,10,0,43,23766,1
100101,Electronics,80.03144836425781,2022-10-25,49,0,78.50434875488281,3846.713088989258,1,10,0,43,23815,1
100101,Electronics,80.03144836425781,2022-10-26,75,0,78.50434875488281,5887.826156616211,2,10,0,43,23890,1
100101,Electronics,80.03144836425781,2022-10-27,105,301,65.10586059570312,25581.190725097655,3,10,0,43,23995,1
100101,Electronics,80.03144836425781,2022-10-28,114,0,69.45172119140625,7917.4962158203125,4,10,0,43,24109,1
100101,Electronics,80.03144836425781,2022-10-29,68,0,69.45172119140625,4722.717041015625,5,10,1,43,24177,1
100101,Electronics,80.03144836425781,2022-10-30,106,0,69.45172119140625,7361.8824462890625,6,10,1,43,24283,1
100101,Electronics,80.03144836425781,2022-10-31,137,258,77.08182403564453,30702.409785766602,0,10,0,44,24420,1
100101,Electronics,80.03144836425781,2022-11-01,60,0,74.97364807128906,4498.418884277344,1,11,0,44,24480,1
100101,Electronics,80.03144836425781,2022-11-02,55,0,74.97364807128906,4123.550643920898,2,11,0,44,24535,1
100101,Electronics,80.03144836425781,2022-11-03,112,248,76.41221908569335,27565.217075195313,3,11,0,44,24647,1
100101,Electronics,80.03144836425781,2022-11-04,76,0,75.99443817138672,5775.577301025391,4,11,0,44,24723,1
100101,Electronics,80.03144836425781,2022-11-05,163,250,84.11939331054688,34984.96221923828,5,11,1,44,24886,1
100101,Electronics,80.03144836425781,2022-11-06,100,0,81.31878662109375,8131.878662109375,6,11,1,44,24986,1
100101,Electronics,80.03144836425781,2022-11-07,77,0,81.31878662109375,6261.546569824219,0,11,0,45,25063,1
100101,Electronics,80.03144836425781,2022-11-08,120,259,72.26637649536133,27073.93035888672,1,11,0,45,25183,1
100101,Electronics,80.03144836425781,2022-11-09,53,204,63.19362319946289,15498.804059143067,2,11,0,45,25236,1
100101,Electronics,80.03144836425781,2022-11-10,86,0,68.10724639892578,5857.223190307617,3,11,0,45,25322,1
100101,Electronics,80.03144836425781,2022-11-11,62,0,68.10724639892578,4222.649276733398,4,11,0,45,25384,1
100101,Electronics,80.03144836425781,2022-11-12,116,299,64.23573608398438,26413.390771484374,5,11,1,45,25500,1
100101,Electronics,80.03144836425781,2022-11-13,68,0,65.57147216796875,4458.860107421875,6,11,1,45,25568,1
100101,Electronics,80.03144836425781,2022-11-14,51,0,65.57147216796875,3344.1450805664062,0,11,0,46,25619,1
100101,Electronics,80.03144836425781,2022-11-15,91,0,65.57147216796875,5967.003967285156,1,11,0,46,25710,1
100101,Electronics,80.03144836425781,2022-11-16,60,0,65.57147216796875,3934.288330078125,2,11,0,46,25770,1
100101,Electronics,80.03144836425781,2022-11-17,127,187,72.85242813110352,23041.116745300293,3,11,0,46,25897,1
100101,Electronics,80.03144836425781,2022-11-18,66,230,64.20698806762695,18633.482424926755,4,11,0,46,25963,1
100101,Electronics,80.03144836425781,2022-11-19,114,0,66.4739761352539,7578.033279418945,5,11,1,46,26077,1
100101,Electronics,80.03144836425781,2022-11-20,41,0,66.4739761352539,2725.43302154541,6,11,1,46,26118,1
100101,Electronics,80.03144836425781,2022-11-21,75,0,66.4739761352539,4985.548210144043,0,11,0,47,26193,1
100101,Electronics,80.03144836425781,2022-11-22,52,0,66.4739761352539,3456.646759033203,1,11,0,47,26245,1
100101,Electronics,80.03144836425781,2022-11-23,105,263,60.16177230834961,21895.932184753416,2,11,0,47,26350,1
100101,Electronics,80.03144836425781,2022-11-24,65,0,61.70354461669922,4010.730400085449,3,11,0,47,26415,1
100101,Electronics,80.03144836425781,2022-11-25,100,229,64.03833610534667,21178.477221069334,4,11,0,47,26515,1
100101,Electronics,80.03144836425781,2022-11-26,75,0,63.18667221069336,4739.000415802002,5,11,1,47,26590,1
100101,Electronics,80.03144836425781,2022-11-27,75,276,73.0368017578125,26358.150263671872,6,11,1,47,26665,1
100101,Electronics,80.03144836425781,2022-11-28,31,0,69.443603515625,2152.751708984375,0,11,0,48,26696,1
100101,Electronics,80.03144836425781,2022-11-29,30,0,69.443603515625,2083.30810546875,1,11,0,48,26726,1
100101,Electronics,80.03144836425781,2022-11-30,64,0,69.443603515625,4444.390625,2,11,0,48,26790,1
100101,Electronics,80.03144836425781,2022-12-01,34,0,69.443603515625,2361.08251953125,3,12,0,48,26824,1
100101,Electronics,80.03144836425781,2022-12-02,80,0,69.443603515625,5555.48828125,4,12,0,48,26904,1
100101,Electronics,80.03144836425781,2022-12-03,28,0,69.443603515625,1944.4208984375,5,12,1,48,26932,1
100101,Electronics,80.03144836425781,2022-12-04,72,199,69.36168197631835,18792.992204589842,6,12,1,48,27004,1
100101,Electronics,80.03144836425781,2022-12-05,66,0,69.39336395263672,4579.962020874023,0,12,0,49,27070,1
100101,Electronics,80.03144836425781,2022-12-06,108,217,77.50673980712891,25559.555798339847,1,12,0,49,27178,1
100101,Electronics,80.03144836425781,2022-12-07,40,0,74.11347961425781,2964.5391845703125,2,12,0,49,27218,1
100101,Electronics,80.03144836425781,2022-12-08,61,0,74.11347961425781,4520.922256469727,3,12,0,49,27279,1
100101,Electronics,80.03144836425781,2022-12-09,165,329,74.14853103637695,36631.255242004394,4,12,0,49,27444,1
100101,Electronics,80.03144836425781,2022-12-10,108,0,74.1370620727539,8006.802703857422,5,12,1,49,27552,1
100101,Electronics,80.03144836425781,2022-12-11,93,0,74.1370620727539,6894.746772766113,6,12,1,49,27645,1
100101,Electronics,80.03144836425781,2022-12-12,95,194,67.49243041992187,19227.871779785157,0,12,0,50,27740,1
100101,Electronics,80.03144836425781,2022-12-13,31,0,70.29486083984375,2179.1406860351562,1,12,0,50,27771,1
100101,Electronics,80.03144836425781,2022-12-14,97,0,70.29486083984375,6818.601501464844,2,12,0,50,27868,1
100101,Electronics,80.03144836425781,2022-12-15,89,268,78.07011047363281,28318.50966430664,3,12,0,50,27957,1
100101,Electronics,80.03144836425781,2022-12-16,59,0,75.57022094726562,4458.643035888672,4,12,0,50,28016,1
100101,Electronics,80.03144836425781,2022-12-17,113,0,75.57022094726562,8539.434967041016,5,12,1,50,28129,1
100101,Electronics,80.03144836425781,2022-12-18,134,269,75.87909912109376,30592.898564453128,6,12,1,50,28263,1
100101,Electronics,80.03144836425781,2022-12-19,112,0,75.7781982421875,8487.158203125,0,12,0,51,28375,1
100101,Electronics,80.03144836425781,2022-12-20,111,200,68.60029846191406,21069.446258544922,1,12,0,51,28486,1
100101,Electronics,80.03144836425781,2022-12-21,75,0,71.58059692382812,5368.544769287109,2,12,0,51,28561,1
100101,Electronics,80.03144836425781,2022-12-22,96,251,70.7058462524414,24484.422480468747,3,12,0,51,28657,1
100101,Electronics,80.03144836425781,2022-12-23,37,0,71.03169250488281,2628.172622680664,4,12,0,51,28694,1
100101,Electronics,80.03144836425781,2022-12-24,108,285,77.28266998291016,30838.896716308594,5,12,1,51,28802,1
100101,Electronics,80.03144836425781,2022-12-25,131,0,74.64533996582031,9778.539535522461,6,12,1,51,28933,1
100101,Electronics,80.03144836425781,2022-12-26,196,344,74.57018997192384,40263.43446899414,0,12,0,52,29129,1
100101,Electronics,80.03144836425781,2022-12-27,117,0,74.60037994384766,8728.244453430176,1,12,0,52,29246,1
100101,Electronics,80.03144836425781,2022-12-28,137,0,74.60037994384766,10220.252052307129,2,12,0,52,29383,1
100101,Electronics,80.03144836425781,2022-12-29,110,0,74.60037994384766,8206.041793823242,3,12,0,52,29493,1
100101,Electronics,80.03144836425781,2022-12-30,84,189,68.00148696899414,18291.249810791014,4,12,0,52,29577,1
100101,Electronics,80.03144836425781,2022-12-31,63,0,70.60297393798828,4447.987358093262,5,12,1,52,29640,1
100101,Electronics,80.03144836425781,2023-01-01,76,278,72.83750610351562,25938.500927734374,6,1,1,52,29716,1
100101,Electronics,80.03144836425781,2023-01-02,129,0,72.07501220703125,9297.676574707031,0,1,0,1,29845,1
100101,Electronics,80.03144836425781,2023-01-03,98,0,72.07501220703125,7063.3511962890625,1,1,0,1,29943,1
100101,Electronics,80.03144836425781,2023-01-04,40,0,72.07501220703125,2883.00048828125,2,1,0,1,29983,1
100101,Electronics,80.03144836425781,2023-01-05,61,0,72.07501220703125,4396.575744628906,3,1,0,1,30044,1
100101,Electronics,80.03144836425781,2023-01-06,95,240,77.44496383666993,26140.543128967285,4,1,0,1,30139,1
100101,Electronics,80.03144836425781,2023-01-07,67,231,71.75184799194335,21098.02763092041,5,1,1,1,30206,1
100101,Electronics,80.03144836425781,2023-01-08,87,0,73.48369598388672,6393.0815505981445,6,1,1,1,30293,1
100101,Electronics,80.03144836425781,2023-01-09,63,0,73.48369598388672,4629.472846984863,0,1,0,2,30356,1
100101,Electronics,80.03144836425781,2023-01-10,63,0,73.48369598388672,4629.472846984863,1,1,0,2,30419,1
100101,Electronics,80.03144836425781,2023-01-11,135,194,64.43419662475586,20985.613088684084,2,1,0,2,30554,1
100101,Electronics,80.03144836425781,2023-01-12,115,0,68.04839324951172,7825.565223693848,3,1,0,2,30669,1
100101,Electronics,80.03144836425781,2023-01-13,104,216,68.36812911987305,21889.210856933594,4,1,0,2,30773,1
100101,Electronics,80.03144836425781,2023-01-14,90,208,72.26149963378907,21736.70993408203,5,1,1,2,30863,1
100101,Electronics,80.03144836425781,2023-01-15,35,0,70.54299926757812,2469.0049743652344,6,1,1,2,30898,1
100101,Electronics,80.03144836425781,2023-01-16,84,0,70.54299926757812,5925.6119384765625,0,1,0,3,30982,1
100101,Electronics,80.03144836425781,2023-01-17,135,240,70.73443725585938,26533.348059082033,1,1,0,3,31117,1
100101,Electronics,80.03144836425781,2023-01-18,70,0,70.65887451171875,4946.1212158203125,2,1,0,3,31187,1
100101,Electronics,80.03144836425781,2023-01-19,66,0,70.65887451171875,4663.4857177734375,3,1,0,3,31253,1
100101,Electronics,80.03144836425781,2023-01-20,47,0,70.65887451171875,3320.9671020507812,4,1,0,3,31300,1
100101,Electronics,80.03144836425781,2023-01-21,82,225,69.40884231567384,21247.190139770508,5,1,1,3,31382,1
100101,Electronics,80.03144836425781,2023-01-22,140,0,69.83768463134766,9777.275848388672,6,1,1,3,31522,1
100101,Electronics,80.03144836425781,2023-01-23,69,202,57.17446540832519,14869.916226348876,0,1,0,4,31591,1
100101,Electronics,80.03144836425781,2023-01-24,60,0,61.86893081665039,3712.1358489990234,1,1,0,4,31651,1
100101,Electronics,80.03144836425781,2023-01-25,82,0,61.86893081665039,5073.252326965332,2,1,0,4,31733,1
100101,Electronics,80.03144836425781,2023-01-26,130,217,67.74158645629882,23682.802478637692,3,1,0,4,31863,1
100101,Electronics,80.03144836425781,2023-01-27,67,0,65.71317291259766,4402.782585144043,4,1,0,4,31930,1
100101,Electronics,80.03144836425781,2023-01-28,108,236,67.12308090209962,23152.665474853515,5,1,1,4,32038,1
100101,Electronics,80.03144836425781,2023-01-29,76,0,66.63616180419922,5064.348297119141,6,1,1,4,32114,1
100101,Electronics,80.03144836425781,2023-01-30,35,0,66.63616180419922,2332.2656631469727,0,1,0,5,32149,1
100101,Electronics,80.03144836425781,2023-01-31,60,0,66.63616180419922,3998.169708251953,1,1,0,5,32209,1
100101,Electronics,80.03144836425781,2023-02-01,35,0,66.63616180419922,2332.2656631469727,2,2,0,5,32244,1
100101,Electronics,80.03144836425781,2023-02-02,40,0,66.63616180419922,2665.4464721679688,3,2,0,5,32284,1
100101,Electronics,80.03144836425781,2023-02-03,55,99,60.50949493408203,9211.124442749024,4,2,0,5,32339,1
100101,Electronics,80.03144836425781,2023-02-04,38,92,59.1378141784668,7587.593877563477,5,2,1,5,32377,1
100101,Electronics,80.03144836425781,2023-02-05,23,0,60.995628356933594,1402.8994522094727,6,2,1,5,32400,1
100101,Electronics,80.03144836425781,2023-02-06,55,131,62.609583053588864,11699.374135894775,0,2,0,6,32455,1
100101,Electronics,80.03144836425781,2023-02-07,80,0,61.899166107177734,4951.933288574219,1,2,0,6,32535,1
100101,Electronics,80.03144836425781,2023-02-08,25,0,61.899166107177734,1547.4791526794434,2,2,0,6,32560,1
100101,Electronics,80.03144836425781,2023-02-09,39,0,61.899166107177734,2414.0674781799316,3,2,0,6,32599,1
100101,Electronics,80.03144836425781,2023-02-10,58,162,60.252009277343745,13204.273076171874,4,2,0,6,32657,1
100101,Electronics,80.03144836425781,2023-02-11,60,144,54.15745086669922,10795.494104003905,5,2,1,6,32717,1
100101,Electronics,80.03144836425781,2023-02-12,47,0,57.16490173339844,2686.7503814697266,6,2,1,6,32764,1
100101,Electronics,80.03144836425781,2023-02-13,84,0,57.16490173339844,4801.851745605469,0,2,0,7,32848,1
100101,Electronics,80.03144836425781,2023-02-14,34,100,56.492128448486326,7548.02473449707,1,2,0,7,32882,1
100101,Electronics,80.03144836425781,2023-02-15,39,0,56.824256896972656,2216.1460189819336,2,2,0,7,32921,1
100101,Electronics,80.03144836425781,2023-02-16,126,221,58.417365646362306,20321.4261428833,3,2,0,7,33047,1
100101,Electronics,80.03144836425781,2023-02-17,21,0,57.88473129272461,1215.5793571472168,4,2,0,7,33068,1
100101,Electronics,80.03144836425781,2023-02-18,63,0,57.88473129272461,3646.7380714416504,5,2,1,7,33131,1
100101,Electronics,80.03144836425781,2023-02-19,65,0,57.88473129272461,3762.5075340270996,6,2,1,7,33196,1
100101,Electronics,80.03144836425781,2023-02-20,81,192,68.49943756103517,19058.938884887695,0,2,0,8,33277,1
100101,Electronics,80.03144836425781,2023-02-21,36,0,65.26887512207031,2349.6795043945312,1,2,0,8,33313,1
100101,Electronics,80.03144836425781,2023-02-22,178,300,65.99941680908202,31573.4123840332,2,2,0,8,33491,1
100101,Electronics,80.03144836425781,2023-02-23,52,0,65.78883361816406,3421.0193481445312,3,2,0,8,33543,1
100101,Electronics,80.03144836425781,2023-02-24,136,246,68.36739974975586,26226.632731933594,4,2,0,8,33679,1
100101,Electronics,80.03144836425781,2023-02-25,67,0,67.36479949951172,4513.441566467285,5,2,1,8,33746,1
100101,Electronics,80.03144836425781,2023-02-26,49,0,67.36479949951172,3300.875175476074,6,2,1,8,33795,1
100101,Electronics,80.03144836425781,2023-02-27,44,0,67.36479949951172,2964.0511779785156,0,2,0,9,33839,1
100101,Electronics,80.03144836425781,2023-02-28,44,0,67.36479949951172,2964.0511779785156,1,2,0,9,33883,1
100101,Electronics,80.03144836425781,2023-03-01,148,370,74.87495986938477,39165.96812133789,2,3,0,9,34031,1
100101,Electronics,80.03144836425781,2023-03-02,71,0,73.15991973876953,5194.354301452637,3,3,0,9,34102,1
100101,Electronics,80.03144836425781,2023-03-03,113,0,73.15991973876953,8267.070930480957,4,3,0,9,34215,1
100101,Electronics,80.03144836425781,2023-03-04,56,0,73.15991973876953,4096.955505371094,5,3,1,9,34271,1
100101,Electronics,80.03144836425781,2023-03-05,53,131,66.0824917602539,11919.524126586914,6,3,1,9,34324,1
100101,Electronics,80.03144836425781,2023-03-06,76,206,68.88073135375976,19409.971165771483,0,3,0,10,34400,1
100101,Electronics,80.03144836425781,2023-03-07,67,0,68.99146270751953,4622.428001403809,1,3,0,10,34467,1
100101,Electronics,80.03144836425781,2023-03-08,79,0,68.99146270751953,5450.325553894043,2,3,0,10,34546,1
100101,Electronics,80.03144836425781,2023-03-09,102,170,71.61551559448242,19557.245181274415,3,3,0,10,34648,1
100101,Electronics,80.03144836425781,2023-03-10,97,207,70.29029891967772,21359.41799041748,4,3,0,10,34745,1
100101,Electronics,80.03144836425781,2023-03-11,79,0,70.37059783935547,5559.277229309082,5,3,1,10,34824,1
100101,Electronics,80.03144836425781,2023-03-12,72,0,70.37059783935547,5066.683044433594,6,3,1,10,34896,1
100101,Electronics,80.03144836425781,2023-03-13,44,0,70.37059783935547,3096.3063049316406,0,3,0,11,34940,1
100101,Electronics,80.03144836425781,2023-03-14,27,0,70.37059783935547,1900.0061416625977,1,3,0,11,34967,1
100101,Electronics,80.03144836425781,2023-03-15,175,271,75.28556976318359,33713.149417114255,2,3,0,11,35142,1
100101,Electronics,80.03144836425781,2023-03-16,44,0,73.87113952636719,3250.3301391601562,3,3,0,11,35186,1
100101,Electronics,80.03144836425781,2023-03-17,60,0,73.87113952636719,4432.268371582031,4,3,0,11,35246,1
100101,Electronics,80.03144836425781,2023-03-18,101,193,69.20808151245117,20195.55246551514,5,3,1,11,35347,1
100101,Electronics,80.03144836425781,2023-03-19,101,0,70.85616302490234,7156.472465515137,6,3,1,11,35448,1
100101,Electronics,80.03144836425781,2023-03-20,103,269,71.78613998413087,26746.58483673096,0,3,0,12,35551,1
100101,Electronics,80.03144836425781,2023-03-21,88,0,71.53227996826172,6294.840637207031,1,3,0,12,35639,1
100101,Electronics,80.03144836425781,2023-03-22,167,352,80.91120056152343,42486.64098754883,2,3,0,12,35806,1
100101,Electronics,80.03144836425781,2023-03-23,46,0,78.24240112304688,3599.1504516601562,3,3,0,12,35852,1
100101,Electronics,80.03144836425781,2023-03-24,83,0,78.24240112304688,6494.119293212891,4,3,0,12,35935,1
100101,Electronics,80.03144836425781,2023-03-25,137,242,73.02703125,27452.8565625,5,3,1,12,36072,1
100101,Electronics,80.03144836425781,2023-03-26,69,0,75.1640625,5186.3203125,6,3,1,12,36141,1
100101,Electronics,80.03144836425781,2023-03-27,55,0,75.1640625,4134.0234375,0,3,0,13,36196,1
100101,Electronics,80.03144836425781,2023-03-28,53,0,75.1640625,3983.6953125,1,3,0,13,36249,1
100101,Electronics,80.03144836425781,2023-03-29,138,253,79.65891036987304,31323.859262084963,2,3,0,13,36387,1
100101,Electronics,80.03144836425781,2023-03-30,85,0,78.1178207397461,6640.014762878418,3,3,0,13,36472,1
100101,Electronics,80.03144836425781,2023-03-31,65,0,78.1178207397461,5077.658348083496,4,3,0,13,36537,1
100101,Electronics,80.03144836425781,2023-04-01,50,189,66.02296875,15145.236875,5,4,1,13,36587,1
100101,Electronics,80.03144836425781,2023-04-02,127,0,70.5859375,8964.4140625,6,4,1,13,36714,1
100101,Electronics,80.03144836425781,2023-04-03,70,168,69.81288635253907,16583.82408935547,0,4,0,14,36784,1
100101,Electronics,80.03144836425781,2023-04-04,15,0,70.13577270507812,1052.0365905761719,1,4,0,14,36799,1
100101,Electronics,80.03144836425781,2023-04-05,86,0,70.13577270507812,6031.676452636719,2,4,0,14,36885,1
100101,Electronics,80.03144836425781,2023-04-06,24,0,70.13577270507812,1683.258544921875,3,4,0,14,36909,1
100101,Electronics,80.03144836425781,2023-04-07,96,203,59.53795570373535,17410.447495117187,4,4,0,14,37005,1
100101,Electronics,80.03144836425781,2023-04-08,111,277,68.44451385498047,26876.102075805666,5,4,1,14,37116,1
100101,Electronics,80.03144836425781,2023-04-09,90,0,66.51902770996094,5986.712493896484,6,4,1,14,37206,1
100101,Electronics,80.03144836425781,2023-04-10,116,0,66.51902770996094,7716.207214355469,0,4,0,15,37322,1
100101,Electronics,80.03144836425781,2023-04-11,29,0,66.51902770996094,1929.0518035888672,1,4,0,15,37351,1
100101,Electronics,80.03144836425781,2023-04-12,45,0,66.51902770996094,2993.356246948242,2,4,0,15,37396,1
100101,Electronics,80.03144836425781,2023-04-13,25,0,66.51902770996094,1662.9756927490234,3,4,0,15,37421,1
100101,Electronics,80.03144836425781,2023-04-14,36,0,66.51902770996094,2394.6849975585938,4,4,0,15,37457,1
100101,Electronics,80.03144836425781,2023-04-15,59,141,56.71452575683594,11068.65403930664,5,4,1,15,37516,1
100101,Electronics,80.03144836425781,2023-04-16,61,0,60.059051513671875,3663.6021423339844,6,4,1,15,37577,1
100101,Electronics,80.03144836425781,2023-04-17,89,161,52.80675605773926,13023.362578277589,0,4,0,16,37666,1
100101,Electronics,80.03144836425781,2023-04-18,38,0,55.283512115478516,2100.7734603881836,1,4,0,16,37704,1
100101,Electronics,80.03144836425781,2023-04-19,71,129,57.59693305969238,11578.144494476317,2,4,0,16,37775,1
100101,Electronics,80.03144836425781,2023-04-20,58,0,56.583866119384766,3281.8642349243164,3,4,0,16,37833,1
100101,Electronics,80.03144836425781,2023-04-21,64,141,57.703898391723634,11865.188994140624,4,4,0,16,37897,1
100101,Electronics,80.03144836425781,2023-04-22,57,0,57.237796783447266,3262.554416656494,5,4,1,16,37954,1
100101,Electronics,80.03144836425781,2023-04-23,108,150,64.61198532104493,16801.268829345703,6,4,1,16,38062,1
100101,Electronics,80.03144836425781,2023-04-24,40,0,61.483970642089844,2459.3588256835938,0,4,0,17,38102,1
100101,Electronics,80.03144836425781,2023-04-25,50,0,61.483970642089844,3074.198532104492,1,4,0,17,38152,1
100101,Electronics,80.03144836425781,2023-04-26,37,131,53.09593284606933,8606.53903060913,2,4,0,17,38189,1
100101,Electronics,80.03144836425781,2023-04-27,106,250,60.13196083068848,21592.455696105957,3,4,0,17,38295,1
100101,Electronics,80.03144836425781,2023-04-28,52,0,58.84392166137695,3059.8839263916016,4,4,0,17,38347,1
100101,Electronics,80.03144836425781,2023-04-29,63,0,58.84392166137695,3707.167064666748,5,4,1,17,38410,1
100101,Electronics,80.03144836425781,2023-04-30,61,0,58.84392166137695,3589.479221343994,6,4,1,17,38471,1
100101,Electronics,80.03144836425781,2023-05-01,31,0,58.84392166137695,1824.1615715026855,0,5,0,18,38502,1
100101,Electronics,80.03144836425781,2023-05-02,55,136,62.810177688598635,12134.42954574585,1,5,0,18,38557,1
100101,Electronics,80.03144836425781,2023-05-03,59,203,61.02514373779297,15983.526961059571,2,5,0,18,38616,1
100101,Electronics,80.03144836425781,2023-05-04,27,0,61.06028747558594,1648.6277618408203,3,5,0,18,38643,1
100101,Electronics,80.03144836425781,2023-05-05,101,0,61.06028747558594,6167.08903503418,4,5,0,18,38744,1
100101,Electronics,80.03144836425781,2023-05-06,121,307,61.81253746032715,26501.79406539917,5,5,1,18,38865,1
100101,Electronics,80.03144836425781,2023-05-07,68,0,61.5650749206543,4186.425094604492,6,5,1,18,38933,1
100101,Electronics,80.03144836425781,2023-05-08,38,0,61.5650749206543,2339.4728469848633,0,5,0,19,38971,1
100101,Electronics,80.03144836425781,2023-05-09,49,0,61.5650749206543,3016.6886711120605,1,5,0,19,39020,1
100101,Electronics,80.03144836425781,2023-05-10,79,0,61.5650749206543,4863.640918731689,2,5,0,19,39099,1
100101,Electronics,80.03144836425781,2023-05-11,53,0,61.5650749206543,3262.9489707946777,3,5,0,19,39152,1
100101,Electronics,80.03144836425781,2023-05-12,35,0,61.5650749206543,2154.7776222229004,4,5,0,19,39187,1
100101,Electronics,80.03144836425781,2023-05-13,109,284,61.67520866394043,24242.695488739013,5,5,1,19,39296,1
100101,Electronics,80.03144836425781,2023-05-14,37,0,61.65041732788086,2281.065441131592,6,5,1,19,39333,1
100101,Electronics,80.03144836425781,2023-05-15,98,0,61.65041732788086,6041.740898132324,0,5,0,20,39431,1
100101,Electronics,80.03144836425781,2023-05-16,116,221,66.28237915039062,22491.261962890625,1,5,0,20,39547,1
100101,Electronics,80.03144836425781,2023-05-17,83,0,64.81475830078125,5379.624938964844,2,5,0,20,39630,1
100101,Electronics,80.03144836425781,2023-05-18,50,136,65.65002883911133,12243.582883911133,3,5,0,20,39680,1
100101,Electronics,80.03144836425781,2023-05-19,85,241,61.00801376342773,19626.842339782714,4,5,0,20,39765,1
100101,Electronics,80.03144836425781,2023-05-20,46,0,62.68602752685547,2883.5572662353516,5,5,1,20,39811,1
100101,Electronics,80.03144836425781,2023-05-21,108,0,62.68602752685547,6770.090972900391,6,5,1,20,39919,1
100101,Electronics,80.03144836425781,2023-05-22,107,0,62.68602752685547,6707.404945373535,0,5,0,21,40026,1
100101,Electronics,80.03144836425781,2023-05-23,142,260,70.89467346191407,28776.40726318359,1,5,0,21,40168,1
100101,Electronics,80.03144836425781,2023-05-24,66,357,83.51031265258788,36689.5612701416,2,5,0,21,40234,1
100101,Electronics,80.03144836425781,2023-05-25,102,0,78.82062530517578,8039.70378112793,3,5,0,21,40336,1
100101,Electronics,80.03144836425781,2023-05-26,93,0,78.82062530517578,7330.318153381348,4,5,0,21,40429,1
100101,Electronics,80.03144836425781,2023-05-27,74,0,78.82062530517578,5832.726272583008,5,5,1,21,40503,1
100101,Electronics,80.03144836425781,2023-05-28,87,0,78.82062530517578,6857.394401550293,6,5,1,21,40590,1
100101,Electronics,80.03144836425781,2023-05-29,46,0,78.82062530517578,3625.748764038086,0,5,0,22,40636,1
100101,Electronics,80.03144836425781,2023-05-30,74,163,73.10962097167969,17124.983903808592,1,5,0,22,40710,1
100101,Electronics,80.03144836425781,2023-05-31,69,0,75.37924194335938,5201.167694091797,2,5,0,22,40779,1
100101,Electronics,80.03144836425781,2023-06-01,141,279,83.61067047119141,35453.109072875974,3,6,0,22,40920,1
100101,Electronics,80.03144836425781,2023-06-02,73,0,81.17134094238281,5925.507888793945,4,6,0,22,40993,1
100101,Electronics,80.03144836425781,2023-06-03,82,0,81.17134094238281,6656.049957275391,5,6,1,22,41075,1
100101,Electronics,80.03144836425781,2023-06-04,88,154,69.23641540527345,16428.74911132813,6,6,1,22,41163,1
100101,Electronics,80.03144836425781,2023-06-05,127,207,78.27499267578125,26277.048139648436,0,6,0,23,41290,1
100101,Electronics,80.03144836425781,2023-06-06,95,0,76.6099853515625,7277.9486083984375,1,6,0,23,41385,1
100101,Electronics,80.03144836425781,2023-06-07,126,346,72.98475967407227,34225.559437866206,2,6,0,23,41511,1
100101,Electronics,80.03144836425781,2023-06-08,61,0,73.99951934814453,4513.970680236816,3,6,0,23,41572,1
100101,Electronics,80.03144836425781,2023-06-09,85,0,73.99951934814453,6289.959144592285,4,6,0,23,41657,1
100101,Electronics,80.03144836425781,2023-06-10,50,0,73.99951934814453,3699.9759674072266,5,6,1,23,41707,1
100101,Electronics,80.03144836425781,2023-06-11,103,0,73.99951934814453,7621.950492858887,6,6,1,23,41810,1
100101,Electronics,80.03144836425781,2023-06-12,106,259,82.50693466186524,30464.34014831543,0,6,0,24,41916,1
100101,Electronics,80.03144836425781,2023-06-13,84,301,75.45201049804687,28673.177763671876,1,6,0,24,42000,1
100101,Electronics,80.03144836425781,2023-06-14,144,0,77.18402099609375,11114.4990234375,2,6,0,24,42144,1
100101,Electronics,80.03144836425781,2023-06-15,106,0,77.18402099609375,8181.5062255859375,3,6,0,24,42250,1
100101,Electronics,80.03144836425781,2023-06-16,86,273,72.6294386291504,25765.523444213868,4,6,0,24,42336,1
100101,Electronics,80.03144836425781,2023-06-17,66,0,74.27887725830078,4902.405899047852,5,6,1,24,42402,1
100101,Electronics,80.03144836425781,2023-06-18,112,0,74.27887725830078,8319.234252929688,6,6,1,24,42514,1
100101,Electronics,80.03144836425781,2023-06-19,153,287,74.89124649047852,32981.461426086425,0,6,0,25,42667,1
100101,Electronics,80.03144836425781,2023-06-20,166,431,81.98941696166992,49615.63643127442,1,6,0,25,42833,1
100101,Electronics,80.03144836425781,2023-06-21,60,0,79.46883392333984,4768.130035400391,2,6,0,25,42893,1
100101,Electronics,80.03144836425781,2023-06-22,137,0,79.46883392333984,10887.230247497559,3,6,0,25,43030,1
100101,Electronics,80.03144836425781,2023-06-23,114,0,79.46883392333984,9059.447067260742,4,6,0,25,43144,1
100101,Electronics,80.03144836425781,2023-06-24,111,0,79.46883392333984,8821.040565490723,5,6,1,25,43255,1
100101,Electronics,80.03144836425781,2023-06-25,99,282,72.76676223754882,27301.998923034665,6,6,1,25,43354,1
100101,Electronics,80.03144836425781,2023-06-26,83,0,75.07352447509766,6231.1025314331055,0,6,0,26,43437,1
100101,Electronics,80.03144836425781,2023-06-27,81,0,75.07352447509766,6080.95548248291,1,6,0,26,43518,1
100101,Electronics,80.03144836425781,2023-06-28,91,205,70.67227066040039,20700.993260192874,2,6,0,26,43609,1
100101,Electronics,80.03144836425781,2023-06-29,134,0,72.58454132080078,9726.328536987305,3,6,0,26,43743,1
100101,Electronics,80.03144836425781,2023-06-30,133,208,72.58133224487304,24750.13437713623,4,6,0,26,43876,1
100101,Electronics,80.03144836425781,2023-07-01,60,0,72.5826644897461,4354.959869384766,5,7,1,26,43936,1
100101,Electronics,80.03144836425781,2023-07-02,71,257,68.77317993164063,22291.03155029297,6,7,1,26,44007,1
100101,Electronics,80.03144836425781,2023-07-03,79,0,70.20635986328125,5546.302429199219,0,7,0,27,44086,1
100101,Electronics,80.03144836425781,2023-07-04,98,0,70.20635986328125,6880.2232666015625,1,7,0,27,44184,1
100101,Electronics,80.03144836425781,2023-07-05,147,357,67.02304031372071,33573.173852233886,2,7,0,27,44331,1
100101,Electronics,80.03144836425781,2023-07-06,37,0,68.0060806274414,2516.224983215332,3,7,0,27,44368,1
100101,Electronics,80.03144836425781,2023-07-07,56,0,68.0060806274414,3808.3405151367188,4,7,0,27,44424,1
100101,Electronics,80.03144836425781,2023-07-08,130,0,68.0060806274414,8840.790481567383,5,7,1,27,44554,1
100101,Electronics,80.03144836425781,2023-07-09,82,242,71.12998001098633,23239.71672180176,6,7,1,27,44636,1
100101,Electronics,80.03144836425781,2023-07-10,176,0,69.91996002197266,12305.912963867188,0,7,0,28,44812,1
100101,Electronics,80.03144836425781,2023-07-11,75,0,69.91996002197266,5243.997001647949,1,7,0,28,44887,1
100101,Electronics,80.03144836425781,2023-07-12,96,256,70.73034225463867,24935.425712890625,2,7,0,28,44983,1
100101,Electronics,80.03144836425781,2023-07-13,91,0,70.49068450927734,6414.652290344238,3,7,0,28,45074,1
100101,Electronics,80.03144836425781,2023-07-14,71,0,70.49068450927734,5004.838600158691,4,7,0,28,45145,1
100101,Electronics,80.03144836425781,2023-07-15,52,137,69.6414353942871,13130.65928100586,5,7,1,28,45197,1
100101,Electronics,80.03144836425781,2023-07-16,107,216,73.95907989501953,24064.37309753418,6,7,1,28,45304,1
100101,Electronics,80.03144836425781,2023-07-17,22,0,72.34815979003906,1591.6595153808594,0,7,0,29,45326,1
100101,Electronics,80.03144836425781,2023-07-18,49,0,72.34815979003906,3545.059829711914,1,7,0,29,45375,1
100101,Electronics,80.03144836425781,2023-07-19,93,264,77.31748580932617,27932.802360534668,2,7,0,29,45468,1
100101,Electronics,80.03144836425781,2023-07-20,84,0,75.38497161865234,6332.337615966797,3,7,0,29,45552,1
100101,Electronics,80.03144836425781,2023-07-21,24,0,75.38497161865234,1809.2393188476562,4,7,0,29,45576,1
100101,Electronics,80.03144836425781,2023-07-22,88,0,75.38497161865234,6633.877502441406,5,7,1,29,45664,1
100101,Electronics,80.03144836425781,2023-07-23,127,277,70.85771774291993,28382.360306701663,6,7,1,29,45791,1
100101,Electronics,80.03144836425781,2023-07-24,63,0,72.48543548583984,4566.58243560791,0,7,0,30,45854,1
100101,Electronics,80.03144836425781,2023-07-25,81,0,72.48543548583984,5871.320274353027,1,7,0,30,45935,1
100101,Electronics,80.03144836425781,2023-07-26,139,386,71.6834503173828,37576.14918823242,2,7,0,30,46074,1
100101,Electronics,80.03144836425781,2023-07-27,98,0,71.91690063476562,7047.856262207031,3,7,0,30,46172,1
100101,Electronics,80.03144836425781,2023-07-28,114,0,71.91690063476562,8198.526672363281,4,7,0,30,46286,1
100101,Electronics,80.03144836425781,2023-07-29,58,0,71.91690063476562,4171.180236816406,5,7,1,30,46344,1
100101,Electronics,80.03144836425781,2023-07-30,86,198,71.04956039428711,20136.684387817382,6,7,1,30,46430,1
100101,Electronics,80.03144836425781,2023-07-31,50,0,71.41912078857422,3570.956039428711,0,7,0,31,46480,1
100101,Electronics,80.03144836425781,2023-08-01,64,0,71.41912078857422,4570.82373046875,1,8,0,31,46544,1
100101,Electronics,80.03144836425781,2023-08-02,121,192,62.047916412353516,19133.59577178955,2,8,0,31,46665,1
100101,Electronics,80.03144836425781,2023-08-03,112,0,66.09583282470703,7402.7332763671875,3,8,0,31,46777,1
100101,Electronics,80.03144836425781,2023-08-04,69,167,70.85012466430663,16920.537203674314,4,8,0,31,46846,1
100101,Electronics,80.03144836425781,2023-08-05,149,314,78.91899551391602,37135.31066314697,5,8,1,31,46995,1
100101,Electronics,80.03144836425781,2023-08-06,23,0,75.30799102783203,1732.0837936401367,6,8,1,31,47018,1
100101,Electronics,80.03144836425781,2023-08-07,50,0,75.30799102783203,3765.3995513916016,0,8,0,32,47068,1
100101,Electronics,80.03144836425781,2023-08-08,142,0,75.30799102783203,10693.734725952148,1,8,0,32,47210,1
100101,Electronics,80.03144836425781,2023-08-09,62,0,75.30799102783203,4669.095443725586,2,8,0,32,47272,1
100101,Electronics,80.03144836425781,2023-08-10,39,0,75.30799102783203,2937.011650085449,3,8,0,32,47311,1
100101,Electronics,80.03144836425781,2023-08-11,101,209,71.85869979858398,22156.457359313965,4,8,0,32,47412,1
100101,Electronics,80.03144836425781,2023-08-12,97,218,68.67158813476563,21417.188098144532,5,8,1,32,47509,1
100101,Electronics,80.03144836425781,2023-08-13,69,0,70.44317626953125,4860.579162597656,6,8,1,32,47578,1
100101,Electronics,80.03144836425781,2023-08-14,67,0,70.44317626953125,4719.692810058594,0,8,0,33,47645,1
100101,Electronics,80.03144836425781,2023-08-15,171,309,82.04566848754882,39894.498622741696,1,8,0,33,47816,1
100101,Electronics,80.03144836425781,2023-08-16,78,0,78.33133697509766,6109.844284057617,2,8,0,33,47894,1
100101,Electronics,80.03144836425781,2023-08-17,124,269,76.05769165039062,29760.507529296876,3,8,0,33,48018,1
100101,Electronics,80.03144836425781,2023-08-18,43,0,76.95538330078125,3309.0814819335938,4,8,0,33,48061,1
100101,Electronics,80.03144836425781,2023-08-19,90,0,76.95538330078125,6925.9844970703125,5,8,1,33,48151,1
100101,Electronics,80.03144836425781,2023-08-20,91,0,76.95538330078125,7002.939880371094,6,8,1,33,48242,1
100101,Electronics,80.03144836425781,2023-08-21,91,209,76.83676101684571,23045.51050506592,0,8,0,34,48333,1
100101,Electronics,80.03144836425781,2023-08-22,116,0,76.8835220336914,8918.488555908203,1,8,0,34,48449,1
100101,Electronics,80.03144836425781,2023-08-23,66,0,76.8835220336914,5074.312454223633,2,8,0,34,48515,1
100101,Electronics,80.03144836425781,2023-08-24,71,146,67.19177062988281,14278.231429443358,3,8,0,34,48586,1
100101,Electronics,80.03144836425781,2023-08-25,72,173,66.66222732543946,16124.970734863282,4,8,0,34,48658,1
100101,Electronics,80.03144836425781,2023-08-26,76,0,68.7144546508789,5222.298553466797,5,8,1,34,48734,1
100101,Electronics,80.03144836425781,2023-08-27,150,283,70.58929824829102,30653.039474487305,6,8,1,34,48884,1
100101,Electronics,80.03144836425781,2023-08-28,94,0,69.92859649658203,6573.288070678711,0,8,0,35,48978,1
100101,Electronics,80.03144836425781,2023-08-29,93,0,69.92859649658203,6503.359474182129,1,8,0,35,49071,1
100101,Electronics,80.03144836425781,2023-08-30,132,215,75.06326614379883,26205.21226196289,2,8,0,35,49203,1
100101,Electronics,80.03144836425781,2023-08-31,85,0,73.15653228759766,6218.305244445801,3,8,0,35,49288,1
100101,Electronics,80.03144836425781,2023-09-01,119,249,74.10972579956055,27314.014740295414,4,9,0,35,49407,1
100101,Electronics,80.03144836425781,2023-09-02,96,0,73.7894515991211,7083.787353515625,5,9,1,35,49503,1
100101,Electronics,80.03144836425781,2023-09-03,103,0,73.7894515991211,7600.313514709473,6,9,1,35,49606,1
100101,Electronics,80.03144836425781,2023-09-04,128,243,75.25037307739258,27963.8455078125,0,9,0,36,49734,1
100101,Electronics,80.03144836425781,2023-09-05,55,239,71.57713333129882,20812.36466644287,1,9,0,36,49789,1
100101,Electronics,80.03144836425781,2023-09-06,111,0,72.83426666259766,8084.60359954834,2,9,0,36,49900,1
100101,Electronics,80.03144836425781,2023-09-07,122,0,72.83426666259766,8885.780532836914,3,9,0,36,50022,1
100101,Electronics,80.03144836425781,2023-09-08,78,230,69.39712020874023,21190.830752563474,4,9,0,36,50100,1
100101,Electronics,80.03144836425781,2023-09-09,94,0,70.60424041748047,6636.798599243164,5,9,1,36,50194,1
100101,Electronics,80.03144836425781,2023-09-10,165,274,77.12766967773437,34114.36099365234,6,9,1,36,50359,1
100101,Electronics,80.03144836425781,2023-09-11,100,0,74.78533935546875,7478.533935546875,0,9,0,37,50459,1
100101,Electronics,80.03144836425781,2023-09-12,78,0,74.78533935546875,5833.2564697265625,1,9,0,37,50537,1
100101,Electronics,80.03144836425781,2023-09-13,99,238,66.48633514404297,22021.37435852051,2,9,0,37,50636,1
100101,Electronics,80.03144836425781,2023-09-14,120,0,69.25267028808594,8310.320434570312,3,9,0,37,50756,1
100101,Electronics,80.03144836425781,2023-09-15,33,0,69.25267028808594,2285.338119506836,4,9,0,37,50789,1
100101,Electronics,80.03144836425781,2023-09-16,44,143,69.57043502807616,13023.488282470702,5,9,1,37,50833,1
100101,Electronics,80.03144836425781,2023-09-17,112,0,69.43087005615234,7776.2574462890625,6,9,1,37,50945,1
100101,Electronics,80.03144836425781,2023-09-18,101,243,69.55302230834961,23931.490506286624,0,9,0,38,51046,1
100101,Electronics,80.03144836425781,2023-09-19,110,0,69.51604461669922,7646.764907836914,1,9,0,38,51156,1
100101,Electronics,80.03144836425781,2023-09-20,91,195,69.79349060058594,19972.01528930664,2,9,0,38,51247,1
100101,Electronics,80.03144836425781,2023-09-21,49,0,69.68698120117188,3414.662078857422,3,9,0,38,51296,1
100101,Electronics,80.03144836425781,2023-09-22,62,0,69.68698120117188,4320.592834472656,4,9,0,38,51358,1
100101,Electronics,80.03144836425781,2023-09-23,100,172,72.6317739868164,19842.114797363283,5,9,1,38,51458,1
100101,Electronics,80.03144836425781,2023-09-24,91,204,70.36825378417969,20706.852188720703,6,9,1,38,51549,1
100101,Electronics,80.03144836425781,2023-09-25,81,0,70.82650756835938,5736.947113037109,0,9,0,39,51630,1
100101,Electronics,80.03144836425781,2023-09-26,56,0,70.82650756835938,3966.284423828125,1,9,0,39,51686,1
100101,Electronics,80.03144836425781,2023-09-27,62,176,69.21818161010742,16392.05451965332,2,9,0,39,51748,1
100101,Electronics,80.03144836425781,2023-09-28,50,0,69.93636322021484,3496.818161010742,3,9,0,39,51798,1
100101,Electronics,80.03144836425781,2023-09-29,81,0,69.93636322021484,5664.845420837402,4,9,0,39,51879,1
100101,Electronics,80.03144836425781,2023-09-30,110,213,68.17039596557618,21948.957112426757,5,9,1,39,51989,1
100101,Electronics,80.03144836425781,2023-10-01,113,0,68.85079193115234,7780.139488220215,6,10,1,39,52102,1
100101,Electronics,80.03144836425781,2023-10-02,157,299,74.44766372680664,34187.02641021728,0,10,0,40,52259,1
100101,Electronics,80.03144836425781,2023-10-03,64,0,72.76532745361328,4656.98095703125,1,10,0,40,52323,1
100101,Electronics,80.03144836425781,2023-10-04,99,0,72.76532745361328,7203.767417907715,2,10,0,40,52422,1
100101,Electronics,80.03144836425781,2023-10-05,50,156,66.81328582763672,13491.828582763672,3,10,0,40,52472,1
100101,Electronics,80.03144836425781,2023-10-06,53,0,69.37657165527344,3676.958297729492,4,10,0,40,52525,1
100101,Electronics,80.03144836425781,2023-10-07,50,0,69.37657165527344,3468.828582763672,5,10,1,40,52575,1
100101,Electronics,80.03144836425781,2023-10-08,19,0,69.37657165527344,1318.1548614501953,6,10,1,40,52594,1
100101,Electronics,80.03144836425781,2023-10-09,42,0,69.37657165527344,2913.8160095214844,0,10,0,41,52636,1
100101,Electronics,80.03144836425781,2023-10-10,52,96,60.506989593505864,8767.28691772461,1,10,0,41,52688,1
100101,Electronics,80.03144836425781,2023-10-11,90,192,67.5961393737793,19167.565087280273,2,10,0,41,52778,1
100101,Electronics,80.03144836425781,2023-10-12,45,0,66.5622787475586,2995.3025436401367,3,10,0,41,52823,1
100101,Electronics,80.03144836425781,2023-10-13,34,0,66.5622787475586,2263.117477416992,4,10,0,41,52857,1
100101,Electronics,80.03144836425781,2023-10-14,25,0,66.5622787475586,1664.0569686889648,5,10,1,41,52882,1
100101,Electronics,80.03144836425781,2023-10-15,24,0,66.5622787475586,1597.4946899414062,6,10,1,41,52906,1
100101,Electronics,80.03144836425781,2023-10-16,28,0,66.5622787475586,1863.7438049316406,0,10,0,42,52934,1
100101,Electronics,80.03144836425781,2023-10-17,42,120,62.96233200073242,10084.275888061522,1,10,0,42,52976,1
100101,Electronics,80.03144836425781,2023-10-18,17,0,64.44466400146484,1095.5592880249023,2,10,0,42,52993,1
100101,Electronics,80.03144836425781,2023-10-19,62,0,64.44466400146484,3995.5691680908203,3,10,0,42,53055,1
100101,Electronics,80.03144836425781,2023-10-20,89,174,61.62450073242188,16129.511130371095,4,10,0,42,53144,1
100101,Electronics,80.03144836425781,2023-10-21,38,0,62.53900146484375,2376.4820556640625,5,10,1,42,53182,1
100101,Electronics,80.03144836425781,2023-10-22,43,0,62.53900146484375,2689.1770629882812,6,10,1,42,53225,1
100101,Electronics,80.03144836425781,2023-10-23,109,167,61.837528991699216,17053.38132019043,0,10,0,43,53334,1
100101,Electronics,80.03144836425781,2023-10-24,47,0,62.07505798339844,2917.5277252197266,1,10,0,43,53381,1
100101,Electronics,80.03144836425781,2023-10-25,114,288,74.04576583862305,30266.514611206054,2,10,0,43,53495,1
100101,Electronics,80.03144836425781,2023-10-26,68,0,71.1715316772461,4839.664154052734,3,10,0,43,53563,1
100101,Electronics,80.03144836425781,2023-10-27,145,259,76.90228805541992,31301.963536071777,4,10,0,43,53708,1
100101,Electronics,80.03144836425781,2023-10-28,117,0,74.85457611083984,8757.985404968262,5,10,1,43,53825,1
100101,Electronics,80.03144836425781,2023-10-29,104,302,84.62708175659179,34978.9130053711,6,10,1,43,53929,1
100101,Electronics,80.03144836425781,2023-10-30,90,0,81.4941635131836,7334.474716186523,0,10,0,44,54019,1
100101,Electronics,80.03144836425781,2023-10-31,47,0,81.4941635131836,3830.225685119629,1,10,0,44,54066,1
100101,Electronics,80.03144836425781,2023-11-01,101,0,81.4941635131836,8230.910514831543,2,11,0,44,54167,1
100101,Electronics,80.03144836425781,2023-11-02,143,269,83.24283935546876,34364.992055664065,3,11,0,44,54310,1
100101,Electronics,80.03144836425781,2023-11-03,102,275,70.45915283203125,25710.357177734375,4,11,0,44,54412,1
100101,Electronics,80.03144836425781,2023-11-04,100,0,75.3883056640625,7538.83056640625,5,11,1,44,54512,1
100101,Electronics,80.03144836425781,2023-11-05,90,0,75.3883056640625,6784.947509765625,6,11,1,44,54602,1
100101,Electronics,80.03144836425781,2023-11-06,99,0,75.3883056640625,7463.4422607421875,0,11,0,45,54701,1
100101,Electronics,80.03144836425781,2023-11-07,68,178,68.08713485717774,16414.250340576174,1,11,0,45,54769,1
100101,Electronics,80.03144836425781,2023-11-08,106,307,71.0801708984375,29352.056230468752,2,11,0,45,54875,1
100101,Electronics,80.03144836425781,2023-11-09,116,0,71.100341796875,8247.6396484375,3,11,0,45,54991,1
100101,Electronics,80.03144836425781,2023-11-10,56,0,71.100341796875,3981.619140625,4,11,0,45,55047,1
100101,Electronics,80.03144836425781,2023-11-11,86,0,71.100341796875,6114.62939453125,5,11,1,45,55133,1
100101,Electronics,80.03144836425781,2023-11-12,81,0,71.100341796875,5759.127685546875,6,11,1,45,55214,1
100101,Electronics,80.03144836425781,2023-11-13,31,0,71.100341796875,2204.110595703125,0,11,0,46,55245,1
100101,Electronics,80.03144836425781,2023-11-14,97,235,73.48747894287109,24494.79091491699,1,11,0,46,55342,1
100101,Electronics,80.03144836425781,2023-11-15,58,0,72.78495788574219,4221.527557373047,2,11,0,46,55400,1
100101,Electronics,80.03144836425781,2023-11-16,186,269,67.92712844848633,30770.131782836914,3,11,0,46,55586,1
100101,Electronics,80.03144836425781,2023-11-17,90,0,69.57425689697266,6261.683120727539,4,11,0,46,55676,1
100101,Electronics,80.03144836425781,2023-11-18,70,241,64.52764068603516,19758.989696044922,5,11,1,46,55746,1
100101,Electronics,80.03144836425781,2023-11-19,126,0,66.33528137207031,8358.24545288086,6,11,1,46,55872,1
100101,Electronics,80.03144836425781,2023-11-20,122,303,71.05063064575195,30487.813877563476,0,11,0,47,55994,1
100101,Electronics,80.03144836425781,2023-11-21,65,0,69.4412612915039,4513.681983947754,1,11,0,47,56059,1
100101,Electronics,80.03144836425781,2023-11-22,106,0,69.4412612915039,7360.773696899414,2,11,0,47,56165,1
100101,Electronics,80.03144836425781,2023-11-23,80,0,69.4412612915039,5555.3009033203125,3,11,0,47,56245,1
100101,Electronics,80.03144836425781,2023-11-24,34,0,69.4412612915039,2361.002883911133,4,11,0,47,56279,1
100101,Electronics,80.03144836425781,2023-11-25,116,196,76.17946304321289,23956.03542602539,5,11,1,47,56395,1
100101,Electronics,80.03144836425781,2023-11-26,94,244,71.81186416625977,24159.630463256835,6,11,1,47,56489,1
100101,Electronics,80.03144836425781,2023-11-27,93,0,72.56372833251953,6748.426734924316,0,11,0,48,56582,1
100101,Electronics,80.03144836425781,2023-11-28,107,296,79.73128646850586,32632.315304260253,1,11,0,48,56689,1
100101,Electronics,80.03144836425781,2023-11-29,93,0,77.08257293701172,7168.67928314209,2,11,0,48,56782,1
100101,Electronics,80.03144836425781,2023-11-30,117,0,77.08257293701172,9018.661033630371,3,11,0,48,56899,1
100101,Electronics,80.03144836425781,2023-12-01,124,0,77.08257293701172,9558.239044189453,4,12,0,48,57023,1
100101,Electronics,80.03144836425781,2023-12-02,159,275,74.88129760742189,32429.892639160156,5,12,1,48,57182,1
100101,Electronics,80.03144836425781,2023-12-03,43,216,74.01711959838867,19063.672285461427,6,12,1,48,57225,1
100101,Electronics,80.03144836425781,2023-12-04,84,0,74.63423919677734,6269.276092529297,0,12,0,49,57309,1
100101,Electronics,80.03144836425781,2023-12-05,22,0,74.63423919677734,1641.9532623291016,1,12,0,49,57331,1
100101,Electronics,80.03144836425781,2023-12-06,121,0,74.63423919677734,9030.742942810059,2,12,0,49,57452,1
100101,Electronics,80.03144836425781,2023-12-07,99,231,81.95713287353516,27397.352308959962,3,12,0,49,57551,1
100101,Electronics,80.03144836425781,2023-12-08,159,0,79.29426574707031,12607.78825378418,4,12,0,49,57710,1
100101,Electronics,80.03144836425781,2023-12-09,108,199,69.27097381591797,20925.760344238282,5,12,1,49,57818,1
100101,Electronics,80.03144836425781,2023-12-10,129,292,65.37619155883789,27075.747422180175,6,12,1,49,57947,1
100101,Electronics,80.03144836425781,2023-12-11,69,0,68.12238311767578,4700.444435119629,0,12,0,50,58016,1
100101,Electronics,80.03144836425781,2023-12-12,143,0,68.12238311767578,9741.500785827637,1,12,0,50,58159,1
100101,Electronics,80.03144836425781,2023-12-13,47,0,68.12238311767578,3201.7520065307617,2,12,0,50,58206,1
100101,Electronics,80.03144836425781,2023-12-14,81,171,64.87324264526367,16229.865308532715,3,12,0,50,58287,1
100101,Electronics,80.03144836425781,2023-12-15,55,0,66.18648529052734,3640.256690979004,4,12,0,50,58342,1
100101,Electronics,80.03144836425781,2023-12-16,47,0,66.18648529052734,3110.764808654785,5,12,1,50,58389,1
100101,Electronics,80.03144836425781,2023-12-17,26,0,66.18648529052734,1720.848617553711,6,12,1,50,58415,1
100101,Electronics,80.03144836425781,2023-12-18,127,235,70.20570892333984,25541.29006652832,0,12,0,51,58542,1
100101,Electronics,80.03144836425781,2023-12-19,67,268,69.47142929077148,23304.80152496338,1,12,0,51,58609,1
100101,Electronics,80.03144836425781,2023-12-20,91,0,69.31285858154297,6307.47013092041,2,12,0,51,58700,1
100101,Electronics,80.03144836425781,2023-12-21,157,0,69.31285858154297,10882.118797302246,3,12,0,51,58857,1
100101,Electronics,80.03144836425781,2023-12-22,71,0,69.31285858154297,4921.212959289551,4,12,0,51,58928,1
100101,Electronics,80.03144836425781,2023-12-23,72,206,70.15118606567383,19536.71079345703,5,12,1,51,59000,1
100101,Electronics,80.03144836425781,2023-12-24,112,285,67.3208724975586,26567.075439453125,6,12,1,51,59112,1
100101,Electronics,80.03144836425781,2023-12-25,69,0,68.24174499511719,4708.680404663086,0,12,0,52,59181,1
100101,Electronics,80.03144836425781,2023-12-26,119,0,68.24174499511719,8120.767654418945,1,12,0,52,59300,1
100101,Electronics,80.03144836425781,2023-12-27,42,0,68.24174499511719,2866.153289794922,2,12,0,52,59342,1
100101,Electronics,80.03144836425781,2023-12-28,78,0,68.24174499511719,5322.856109619141,3,12,0,52,59420,1
100101,Electronics,80.03144836425781,2023-12-29,79,208,70.10175033569337,20192.50655303955,4,12,0,52,59499,1
100101,Electronics,80.03144836425781,2023-12-30,53,0,69.53350067138672,3685.275535583496,5,12,1,52,59552,1
100101,Electronics,80.03144836425781,2023-12-31,43,0,69.53350067138672,2989.940528869629,6,12,1,52,59595,1
100101,Electronics,80.03144836425781,2024-01-01,66,105,65.82192489624023,11182.154086303712,0,1,0,1,59661,1
100101,Electronics,80.03144836425781,2024-01-02,25,0,67.70384979248047,1692.5962448120117,1,1,0,1,59686,1
100101,Electronics,80.03144836425781,2024-01-03,57,0,67.70384979248047,3859.1194381713867,2,1,0,1,59743,1
100101,Electronics,80.03144836425781,2024-01-04,46,104,56.06488479614258,8103.209401245117,3,1,0,1,59789,1
100101,Electronics,80.03144836425781,2024-01-05,45,146,60.03896186828614,11408.966568145752,4,1,0,1,59834,1
100101,Electronics,80.03144836425781,2024-01-06,35,0,60.617923736572266,2121.6273307800293,5,1,1,1,59869,1
100101,Electronics,80.03144836425781,2024-01-07,73,0,60.617923736572266,4425.108432769775,6,1,1,1,59942,1
100101,Electronics,80.03144836425781,2024-01-08,32,0,60.617923736572266,1939.7735595703125,0,1,0,2,59974,1
100101,Electronics,80.03144836425781,2024-01-09,75,155,65.13308494567872,15118.762741851806,1,1,0,2,60049,1
100101,Electronics,80.03144836425781,2024-01-10,74,163,64.65291915893555,15373.212035522462,2,1,0,2,60123,1
100101,Electronics,80.03144836425781,2024-01-11,134,300,64.95390762329102,28244.127243041992,3,1,0,2,60257,1
100101,Electronics,80.03144836425781,2024-01-12,61,0,64.62781524658203,3942.296730041504,4,1,0,2,60318,1
100101,Electronics,80.03144836425781,2024-01-13,129,0,64.62781524658203,8336.988166809082,5,1,1,2,60447,1
100101,Electronics,80.03144836425781,2024-01-14,83,0,64.62781524658203,5364.108665466309,6,1,1,2,60530,1
100101,Electronics,80.03144836425781,2024-01-15,90,265,67.71108291625976,24212.244924926756,0,1,0,3,60620,1
100101,Electronics,80.03144836425781,2024-01-16,35,0,66.71216583251953,2334.9258041381836,1,1,0,3,60655,1
100101,Electronics,80.03144836425781,2024-01-17,67,0,66.71216583251953,4469.715110778809,2,1,0,3,60722,1
100101,Electronics,80.03144836425781,2024-01-18,54,0,66.71216583251953,3602.4569549560547,3,1,0,3,60776,1
100101,Electronics,80.03144836425781,2024-01-19,77,177,59.04732368469239,14664.287847442627,4,1,0,3,60853,1
100101,Electronics,80.03144836425781,2024-01-20,155,269,73.70499603271485,31779.3087701416,5,1,1,3,61008,1
100101,Electronics,80.03144836425781,2024-01-21,115,0,69.06999206542969,7943.049087524414,6,1,1,3,61123,1
100101,Electronics,80.03144836425781,2024-01-22,237,368,85.2108625793457,52262.47886260986,0,1,0,4,61360,1
100101,Electronics,80.03144836425781,2024-01-23,62,0,79.7917251586914,4947.086959838867,1,1,0,4,61422,1
100101,Electronics,80.03144836425781,2024-01-24,116,0,79.7917251586914,9255.840118408203,2,1,0,4,61538,1
100101,Electronics,80.03144836425781,2024-01-25,88,298,78.04602035522461,29996.399582519534,3,1,0,4,61626,1
100101,Electronics,80.03144836425781,2024-01-26,64,0,78.66204071044922,5034.37060546875,4,1,0,4,61690,1
100101,Electronics,80.03144836425781,2024-01-27,100,0,78.66204071044922,7866.204071044922,5,1,1,4,61790,1
100101,Electronics,80.03144836425781,2024-01-28,112,229,81.1407241821289,27798.772216796875,6,1,1,4,61902,1
100101,Electronics,80.03144836425781,2024-01-29,105,0,80.03144836425781,8403.30207824707,0,1,0,5,62007,1
100101,Electronics,80.03144836425781,2024-01-30,68,0,80.03144836425781,5442.138488769531,1,1,0,5,62075,1
100102,Clothing,66.66712188720703,2022-01-01,117,366,80.16000183105469,38717.280428466795,5,1,1,52,117,0
100102,Clothing,66.66712188720703,2022-01-02,116,0,80.16000366210938,9298.560424804688,6,1,1,52,233,0
100102,Clothing,66.66712188720703,2022-01-03,92,118,78.80749145507812,16536.898427734373,0,1,0,1,325,0
100102,Clothing,66.66712188720703,2022-01-04,113,102,72.74082809448242,15670.857149353029,1,1,0,1,438,0
100102,Clothing,66.66712188720703,2022-01-05,77,85,63.27949478149414,10205.362196350097,2,1,0,1,515,0
100102,Clothing,66.66712188720703,2022-01-06,86,103,59.73209022521972,11221.329518737792,3,1,0,1,601,0
100102,Clothing,66.66712188720703,2022-01-07,96,0,63.73418045043945,6118.4813232421875,4,1,0,1,697,0
100102,Clothing,66.66712188720703,2022-01-08,77,208,74.6025146484375,21484.087255859376,5,1,1,1,774,0
100102,Clothing,66.66712188720703,2022-01-09,134,169,78.13690322875976,23745.24006530762,6,1,1,1,908,0
100102,Clothing,66.66712188720703,2022-01-10,192,0,76.14380645751953,14619.61083984375,0,1,0,2,1100,0
100102,Clothing,66.66712188720703,2022-01-11,51,176,73.74373123168945,16701.860585632323,1,1,0,2,1151,0
100102,Clothing,66.66712188720703,2022-01-12,131,147,71.84481979370116,19959.662785949706,2,1,0,2,1282,0
100102,Clothing,66.66712188720703,2022-01-13,179,161,65.46225143432618,22305.62601348877,3,1,0,2,1461,0
100102,Clothing,66.66712188720703,2022-01-14,156,166,74.97471252441406,24165.310307617186,4,1,0,2,1617,0
100102,Clothing,66.66712188720703,2022-01-15,174,219,77.70773361206054,30606.74129699707,5,1,1,2,1791,0
100102,Clothing,66.66712188720703,2022-01-16,117,0,76.2054672241211,8916.039665222168,6,1,1,2,1908,0
100102,Clothing,66.66712188720703,2022-01-17,112,276,86.14367691040039,33698.66362792969,0,1,0,3,2020,0
100102,Clothing,66.66712188720703,2022-01-18,260,193,81.87203552246095,37160.52847167969,1,1,0,3,2280,0
100102,Clothing,66.66712188720703,2022-01-19,92,0,82.95407104492188,7631.7745361328125,2,1,0,3,2372,0
100102,Clothing,66.66712188720703,2022-01-20,117,189,77.27283462524414,23548.80330230713,3,1,0,3,2489,0
100102,Clothing,66.66712188720703,2022-01-21,73,0,78.61566925048828,5738.9438552856445,4,1,0,3,2562,0
100102,Clothing,66.66712188720703,2022-01-22,116,193,69.12342819213868,21190.245340576173,5,1,1,3,2678,0
100102,Clothing,66.66712188720703,2022-01-23,149,123,67.44305908203125,18388.791606445313,6,1,1,3,2827,0
100102,Clothing,66.66712188720703,2022-01-24,109,123,62.17060546875,14384.0919921875,0,1,0,4,2936,0
100102,Clothing,66.66712188720703,2022-01-25,67,0,64.9912109375,4354.4111328125,1,1,0,4,3003,0
100102,Clothing,66.66712188720703,2022-01-26,84,90,61.63960258483887,10717.49323425293,2,1,0,4,3087,0
100102,Clothing,66.66712188720703,2022-01-27,82,102,63.55275787353516,11698.252291259767,3,1,0,4,3169,0
100102,Clothing,66.66712188720703,2022-01-28,140,186,72.10057067871094,23615.159790039062,4,1,0,4,3309,0
100102,Clothing,66.66712188720703,2022-01-29,107,151,77.08547897338867,20011.892500305177,5,1,1,4,3416,0
100102,Clothing,66.66712188720703,2022-01-30,121,0,74.27095794677734,8986.785911560059,6,1,1,4,3537,0
100102,Clothing,66.66712188720703,2022-01-31,103,97,67.92343170166015,13598.386930541992,0,1,0,5,3640,0
100102,Clothing,66.66712188720703,2022-02-01,103,212,76.60877197265626,24268.147026367187,1,2,0,5,3743,0
100102,Clothing,66.66712188720703,2022-02-02,177,248,76.18286880493164,32395.265556945804,2,2,0,5,3920,0
100102,Clothing,66.66712188720703,2022-02-03,47,0,75.93573760986328,3568.979667663574,3,2,0,5,3967,0
100102,Clothing,66.66712188720703,2022-02-04,69,0,75.93573760986328,5239.565895080566,4,2,0,5,4036,0
100102,Clothing,66.66712188720703,2022-02-05,94,141,62.32306564331054,14407.956340942383,5,2,1,5,4130,0
100102,Clothing,66.66712188720703,2022-02-06,104,0,67.3861312866211,7008.157653808594,6,2,1,5,4234,0
100102,Clothing,66.66712188720703,2022-02-07,49,55,60.8687092590332,6310.793507385254,0,2,0,6,4283,0
100102,Clothing,66.66712188720703,2022-02-08,105,112,63.57758934020996,13795.023761444092,1,2,0,6,4388,0
100102,Clothing,66.66712188720703,2022-02-09,123,338,91.52637329101563,43112.48782958984,2,2,0,6,4511,0
100102,Clothing,66.66712188720703,2022-02-10,279,308,93.2095262145996,54775.19562774658,3,2,0,6,4790,0
100102,Clothing,66.66712188720703,2022-02-11,198,0,91.09905242919922,18037.612380981445,4,2,0,6,4988,0
100102,Clothing,66.66712188720703,2022-02-12,100,107,74.7597640991211,15424.802819824217,5,2,1,6,5088,0
100102,Clothing,66.66712188720703,2022-02-13,130,218,88.26075759887695,30873.956975708006,6,2,1,6,5218,0
100102,Clothing,66.66712188720703,2022-02-14,185,0,86.4515151977539,15993.530311584473,0,2,0,7,5403,0
100102,Clothing,66.66712188720703,2022-02-15,79,98,72.5838134765625,12771.642529296874,1,2,0,7,5482,0
100102,Clothing,66.66712188720703,2022-02-16,43,50,54.013268280029294,4945.0910720825195,2,2,0,7,5525,0
100102,Clothing,66.66712188720703,2022-02-17,63,62,60.50977951049805,7565.862218322754,3,2,0,7,5588,0
100102,Clothing,66.66712188720703,2022-02-18,104,227,86.79902496337891,29284.09719238281,4,2,0,7,5692,0
100102,Clothing,66.66712188720703,2022-02-19,148,187,84.12859741210937,28210.04483398437,5,2,1,7,5840,0
100102,Clothing,66.66712188720703,2022-02-20,83,0,83.43719482421875,6925.287170410156,6,2,1,7,5923,0
100102,Clothing,66.66712188720703,2022-02-21,118,0,83.43719482421875,9845.588989257812,0,2,0,8,6041,0
100102,Clothing,66.66712188720703,2022-02-22,65,142,80.45535583496094,16611.496258544925,1,2,0,8,6106,0
100102,Clothing,66.66712188720703,2022-02-23,142,192,80.23847259521484,26789.226217041018,2,2,0,8,6248,0
100102,Clothing,66.66712188720703,2022-02-24,192,142,67.45888458251953,22793.211679687498,3,2,0,8,6440,0
100102,Clothing,66.66712188720703,2022-02-25,136,115,73.74156219482421,18500.764916992186,4,2,0,8,6576,0
100102,Clothing,66.66712188720703,2022-02-26,121,230,95.19011032104493,33907.66669769287,5,2,1,8,6697,0
100102,Clothing,66.66712188720703,2022-02-27,127,145,81.9664663696289,22225.82245788574,6,2,1,8,6824,0
100102,Clothing,66.66712188720703,2022-02-28,56,0,85.80293273925781,4804.9642333984375,0,2,0,9,6880,0
100102,Clothing,66.66712188720703,2022-03-01,58,0,85.80293273925781,4976.570098876953,1,3,0,9,6938,0
100102,Clothing,66.66712188720703,2022-03-02,134,171,84.77061294555665,25844.28426940918,2,3,0,9,7072,0
100102,Clothing,66.66712188720703,2022-03-03,71,0,85.06122589111328,6039.347038269043,3,3,0,9,7143,0
100102,Clothing,66.66712188720703,2022-03-04,84,86,62.38635101318359,10589.006970214843,4,3,0,9,7227,0
100102,Clothing,66.66712188720703,2022-03-05,60,106,64.11609588623047,10544.551506347656,5,3,1,9,7287,0
100102,Clothing,66.66712188720703,2022-03-06,134,172,70.8345684814453,21727.644353027343,6,3,1,9,7421,0
100102,Clothing,66.66712188720703,2022-03-07,126,137,66.61145446777343,17506.146525878903,0,3,0,10,7547,0
100102,Clothing,66.66712188720703,2022-03-08,156,141,70.5739080810547,20943.109321289063,1,3,0,10,7703,0
100102,Clothing,66.66712188720703,2022-03-09,79,0,69.41781616210938,5484.007476806641,2,3,0,10,7782,0
100102,Clothing,66.66712188720703,2022-03-10,103,117,63.42241851806641,13927.27821472168,3,3,0,10,7885,0
100102,Clothing,66.66712188720703,2022-03-11,117,112,65.73518676757813,15052.533703613282,4,3,0,10,8002,0
100102,Clothing,66.66712188720703,2022-03-12,112,128,70.95975189208984,17056.584423828124,5,3,1,10,8114,0
100102,Clothing,66.66712188720703,2022-03-13,128,160,70.02766632080079,20174.442578125003,6,3,1,10,8242,0
100102,Clothing,66.66712188720703,2022-03-14,152,115,73.267734375,19510.23125,0,3,0,11,8394,0
100102,Clothing,66.66712188720703,2022-03-15,109,107,59.42641860961914,12845.179256896972,1,3,0,11,8503,0
100102,Clothing,66.66712188720703,2022-03-16,57,0,63.96283721923828,3645.881721496582,2,3,0,11,8560,0
100102,Clothing,66.66712188720703,2022-03-17,64,88,57.02901824951172,8624.0343359375,3,3,0,11,8624,0
100102,Clothing,66.66712188720703,2022-03-18,40,53,52.557188720703124,4850.54509765625,4,3,0,11,8664,0
100102,Clothing,66.66712188720703,2022-03-19,93,75,63.25074501037598,10569.438571929932,5,3,1,11,8757,0
100102,Clothing,66.66712188720703,2022-03-20,83,162,68.24025268554688,16849.981945800784,6,3,1,11,8840,0
100102,Clothing,66.66712188720703,2022-03-21,103,123,71.63361770629882,16229.325247497558,0,3,0,12,8943,0
100102,Clothing,66.66712188720703,2022-03-22,53,0,69.62723541259766,3690.243476867676,1,3,0,12,8996,0
100102,Clothing,66.66712188720703,2022-03-23,90,96,70.92747268676757,13195.645083618165,2,3,0,12,9086,0
100102,Clothing,66.66712188720703,2022-03-24,54,65,64.42591995239258,7633.179354858399,3,3,0,12,9140,0
100102,Clothing,66.66712188720703,2022-03-25,146,155,69.76559448242188,21006.053588867188,4,3,0,12,9286,0
100102,Clothing,66.66712188720703,2022-03-26,109,200,73.23575408935547,22736.704391479492,5,3,1,12,9395,0
100102,Clothing,66.66712188720703,2022-03-27,124,0,72.06150817871094,8935.627014160156,6,3,1,12,9519,0
100102,Clothing,66.66712188720703,2022-03-28,59,0,72.06150817871094,4251.628982543945,0,3,0,13,9578,0
100102,Clothing,66.66712188720703,2022-03-29,63,166,68.52418182373046,15633.926909790038,1,3,0,13,9641,0
100102,Clothing,66.66712188720703,2022-03-30,141,155,75.99231643676758,22527.433235168457,2,3,0,13,9782,0
100102,Clothing,66.66712188720703,2022-03-31,110,136,75.94859725952148,18707.831397094727,3,3,0,13,9892,0
100102,Clothing,66.66712188720703,2022-04-01,174,171,74.44960510253907,25685.742575683595,4,4,0,13,10066,0
100102,Clothing,66.66712188720703,2022-04-02,85,0,74.65921020507812,6346.032867431641,5,4,1,13,10151,0
100102,Clothing,66.66712188720703,2022-04-03,108,175,73.76536895751954,20860.49969482422,6,4,1,13,10259,0
100102,Clothing,66.66712188720703,2022-04-04,103,0,73.99073791503906,7621.046005249023,0,4,0,14,10362,0
100102,Clothing,66.66712188720703,2022-04-05,82,116,67.5594953918457,13319.677244262695,1,4,0,14,10444,0
100102,Clothing,66.66712188720703,2022-04-06,116,198,85.03191345214844,26993.423920898436,2,4,0,14,10560,0
100102,Clothing,66.66712188720703,2022-04-07,115,0,81.45382690429688,9367.19009399414,3,4,0,14,10675,0
100102,Clothing,66.66712188720703,2022-04-08,83,94,69.3554183959961,12235.149453735352,4,4,0,14,10758,0
100102,Clothing,66.66712188720703,2022-04-09,94,177,68.36523574829101,18445.20432067871,5,4,1,14,10852,0
100102,Clothing,66.66712188720703,2022-04-10,79,0,69.35047149658203,5478.6872482299805,6,4,1,14,10931,0
100102,Clothing,66.66712188720703,2022-04-11,98,170,74.84143081665039,20145.960440063478,0,4,0,15,11029,0
100102,Clothing,66.66712188720703,2022-04-12,113,136,75.40190689086914,18790.900957336424,1,4,0,15,11142,0
100102,Clothing,66.66712188720703,2022-04-13,193,209,76.1776202392578,30630.801412353518,2,4,0,15,11335,0
100102,Clothing,66.66712188720703,2022-04-14,75,0,75.71524047851562,5678.643035888672,3,4,0,15,11410,0
100102,Clothing,66.66712188720703,2022-04-15,132,115,65.55888000488281,16256.604321289062,4,4,0,15,11542,0
100102,Clothing,66.66712188720703,2022-04-16,117,149,69.28390563964844,18429.393919677736,5,4,1,15,11659,0
100102,Clothing,66.66712188720703,2022-04-17,140,181,72.85102111816406,23427.775913085938,6,4,1,15,11799,0
100102,Clothing,66.66712188720703,2022-04-18,89,136,65.1569451904297,14531.676243896485,0,4,0,16,11888,0
100102,Clothing,66.66712188720703,2022-04-19,183,256,79.02718200683594,34950.098614501956,1,4,0,16,12071,0
100102,Clothing,66.66712188720703,2022-04-20,110,0,75.50436401367188,8305.480041503906,2,4,0,16,12181,0
100102,Clothing,66.66712188720703,2022-04-21,76,0,75.50436401367188,5738.3316650390625,3,4,0,16,12257,0
100102,Clothing,66.66712188720703,2022-04-22,71,56,64.43572479248047,8270.572920532226,4,4,0,16,12328,0
100102,Clothing,66.66712188720703,2022-04-23,109,194,69.5203434753418,21051.034877624512,5,4,1,16,12437,0
100102,Clothing,66.66712188720703,2022-04-24,70,0,69.6806869506836,4877.648086547852,6,4,1,16,12507,0
100102,Clothing,66.66712188720703,2022-04-25,121,98,72.36847885131836,15824.741882019043,0,4,0,17,12628,0
100102,Clothing,66.66712188720703,2022-04-26,101,116,69.76403762817384,15131.685600891113,1,4,0,17,12729,0
100102,Clothing,66.66712188720703,2022-04-27,108,118,73.18037719726563,16548.461474609376,2,4,0,17,12837,0
100102,Clothing,66.66712188720703,2022-04-28,88,109,67.0355647277832,13166.199392089844,3,4,0,17,12925,0
100102,Clothing,66.66712188720703,2022-04-29,136,143,68.70631927490234,19168.528842773438,4,4,0,17,13061,0
100102,Clothing,66.66712188720703,2022-04-30,99,117,64.83632064819336,13976.451488342285,5,4,1,17,13160,0
100102,Clothing,66.66712188720703,2022-05-01,144,100,57.51796730041504,14215.134582519531,6,5,1,17,13304,0
100102,Clothing,66.66712188720703,2022-05-02,95,98,66.84008712768555,12906.316554260255,0,5,0,18,13399,0
100102,Clothing,66.66712188720703,2022-05-03,131,118,69.88709304809569,17378.188378601073,1,5,0,18,13530,0
100102,Clothing,66.66712188720703,2022-05-04,57,88,64.50037399291992,9308.212635192871,2,5,0,18,13587,0
100102,Clothing,66.66712188720703,2022-05-05,83,0,65.93074798583984,5472.252082824707,3,5,0,18,13670,0
100102,Clothing,66.66712188720703,2022-05-06,58,108,65.15220962524414,10806.15631652832,4,5,0,18,13728,0
100102,Clothing,66.66712188720703,2022-05-07,100,143,59.76662643432617,14454.205286865234,5,5,1,18,13828,0
100102,Clothing,66.66712188720703,2022-05-08,71,97,64.89411567687989,10943.444426116945,6,5,1,18,13899,0
100102,Clothing,66.66712188720703,2022-05-09,113,0,63.308231353759766,7153.8301429748535,0,5,0,19,14012,0
100102,Clothing,66.66712188720703,2022-05-10,72,148,59.63807388305664,13065.802639160156,1,5,0,19,14084,0
100102,Clothing,66.66712188720703,2022-05-11,100,117,66.55741546630858,14483.803093261718,2,5,0,19,14184,0
100102,Clothing,66.66712188720703,2022-05-12,110,105,68.47786468505859,14713.23023071289,3,5,0,19,14294,0
100102,Clothing,66.66712188720703,2022-05-13,148,130,71.48123626708984,19838.145935058594,4,5,0,19,14442,0
100102,Clothing,66.66712188720703,2022-05-14,142,197,80.52815719604493,27458.09664367676,5,5,1,19,14584,0
100102,Clothing,66.66712188720703,2022-05-15,122,0,77.63631439208984,9471.630355834961,6,5,1,19,14706,0
100102,Clothing,66.66712188720703,2022-05-16,75,150,76.22271987915039,17128.90798187256,0,5,0,20,14781,0
100102,Clothing,66.66712188720703,2022-05-17,150,210,83.80821823120118,30286.26546936035,1,5,0,20,14931,0
100102,Clothing,66.66712188720703,2022-05-18,31,0,81.88643646240234,2538.4795303344727,2,5,0,20,14962,0
100102,Clothing,66.66712188720703,2022-05-19,47,0,81.88643646240234,3848.66251373291,3,5,0,20,15009,0
100102,Clothing,66.66712188720703,2022-05-20,132,179,73.31818283081054,22693.470267333985,4,5,0,20,15141,0
100102,Clothing,66.66712188720703,2022-05-21,179,222,73.53957626342773,29463.58830230713,5,5,1,20,15320,0
100102,Clothing,66.66712188720703,2022-05-22,112,0,74.13915252685547,8303.585083007812,6,5,1,20,15432,0
100102,Clothing,66.66712188720703,2022-05-23,96,101,67.15304824829101,13216.835263671874,0,5,0,21,15528,0
100102,Clothing,66.66712188720703,2022-05-24,115,177,70.71142410278321,20664.387543640136,1,5,0,21,15643,0
100102,Clothing,66.66712188720703,2022-05-25,177,279,85.74499496459961,39475.58821746826,2,5,0,21,15820,0
100102,Clothing,66.66712188720703,2022-05-26,147,0,82.05998992919922,12062.818519592285,3,5,0,21,15967,0
100102,Clothing,66.66712188720703,2022-05-27,132,128,73.38222869873047,19091.188376464845,4,5,0,21,16099,0
100102,Clothing,66.66712188720703,2022-05-28,120,118,65.8624609375,15682.630625,5,5,1,21,16219,0
100102,Clothing,66.66712188720703,2022-05-29,126,149,71.93094665527343,19797.318557128907,6,5,1,21,16345,0
100102,Clothing,66.66712188720703,2022-05-30,34,0,71.22189331054688,2421.5443725585938,0,5,0,22,16379,0
100102,Clothing,66.66712188720703,2022-05-31,76,111,63.39194046020508,11760.774949951172,1,5,0,22,16455,0
100102,Clothing,66.66712188720703,2022-06-01,138,111,57.409621200561524,14389.21545135498,2,6,0,22,16593,0
100102,Clothing,66.66712188720703,2022-06-02,104,90,56.43302017211914,10973.38819580078,3,6,0,22,16697,0
100102,Clothing,66.66712188720703,2022-06-03,109,159,70.54137786865235,19062.020375366214,4,6,0,22,16806,0
100102,Clothing,66.66712188720703,2022-06-04,159,118,71.11550109863282,19637.719349365234,5,6,1,22,16965,0
100102,Clothing,66.66712188720703,2022-06-05,74,90,53.531148986816405,8677.170050048828,6,6,1,22,17039,0
100102,Clothing,66.66712188720703,2022-06-06,97,104,62.86800064086914,12644.602124328612,0,6,0,23,17136,0
100102,Clothing,66.66712188720703,2022-06-07,135,110,70.55409515380859,17199.35569152832,1,6,0,23,17271,0
100102,Clothing,66.66712188720703,2022-06-08,116,139,80.65782470703125,20659.56533203125,2,6,0,23,17387,0
100102,Clothing,66.66712188720703,2022-06-09,139,201,84.43405136108399,28831.326278381348,3,6,0,23,17526,0
100102,Clothing,66.66712188720703,2022-06-10,153,122,72.09281631469727,19970.38179229736,4,6,0,23,17679,0
100102,Clothing,66.66712188720703,2022-06-11,170,198,76.33833740234374,28088.914716796873,5,6,1,23,17849,0
100102,Clothing,66.66712188720703,2022-06-12,143,175,80.31834075927733,25585.76545715332,6,6,1,23,17992,0
100102,Clothing,66.66712188720703,2022-06-13,134,0,78.92668151855469,10576.175323486328,0,6,0,24,18126,0
100102,Clothing,66.66712188720703,2022-06-14,96,182,81.47762954711914,22696.564873046875,1,6,0,24,18222,0
100102,Clothing,66.66712188720703,2022-06-15,110,145,69.64666320800782,17607.41590576172,2,6,0,24,18332,0
100102,Clothing,66.66712188720703,2022-06-16,126,0,74.00332641601562,9324.419128417969,3,6,0,24,18458,0
100102,Clothing,66.66712188720703,2022-06-17,91,243,89.24603576660157,30173.578509521485,4,6,0,24,18549,0
100102,Clothing,66.66712188720703,2022-06-18,44,0,86.84207153320312,3821.0511474609375,5,6,1,24,18593,0
100102,Clothing,66.66712188720703,2022-06-19,47,0,86.84207153320312,4081.577362060547,6,6,1,24,18640,0
100102,Clothing,66.66712188720703,2022-06-20,75,0,86.84207153320312,6513.155364990234,0,6,0,25,18715,0
100102,Clothing,66.66712188720703,2022-06-21,77,134,74.99429016113281,15673.070684814453,1,6,0,25,18792,0
100102,Clothing,66.66712188720703,2022-06-22,96,87,65.06871109008789,11956.792529296876,2,6,0,25,18888,0
100102,Clothing,66.66712188720703,2022-06-23,80,85,65.21518371582032,10749.22939453125,3,6,0,25,18968,0
100102,Clothing,66.66712188720703,2022-06-24,107,83,66.70579391479492,12682.159897766112,4,6,0,25,19075,0
100102,Clothing,66.66712188720703,2022-06-25,65,65,59.36704154968262,7717.71540145874,5,6,1,25,19140,0
100102,Clothing,66.66712188720703,2022-06-26,106,150,68.42506439208984,17581.273651123047,6,6,1,25,19246,0
100102,Clothing,66.66712188720703,2022-06-27,60,71,64.21841552734375,8397.11986328125,0,6,0,26,19306,0
100102,Clothing,66.66712188720703,2022-06-28,90,88,63.801868286132816,11358.476291503906,1,6,0,26,19396,0
100102,Clothing,66.66712188720703,2022-06-29,108,136,72.19524322509766,17693.332536621092,2,6,0,26,19504,0
100102,Clothing,66.66712188720703,2022-06-30,46,0,69.42048645019531,3193.3423767089844,3,6,0,26,19550,0
100102,Clothing,66.66712188720703,2022-07-01,74,101,65.35233291625977,11391.505271606446,4,7,0,26,19624,0
100102,Clothing,66.66712188720703,2022-07-02,77,0,67.02466583251953,5160.899269104004,5,7,1,26,19701,0
100102,Clothing,66.66712188720703,2022-07-03,70,97,65.29293548583985,10888.990968017577,6,7,1,26,19771,0
100102,Clothing,66.66712188720703,2022-07-04,79,57,59.5116934967041,8164.467572479248,0,7,0,27,19850,0
100102,Clothing,66.66712188720703,2022-07-05,96,162,70.39807052612305,18278.329541015628,1,7,0,27,19946,0
100102,Clothing,66.66712188720703,2022-07-06,85,0,68.6461410522461,5834.921989440918,2,7,0,27,20031,0
100102,Clothing,66.66712188720703,2022-07-07,77,117,73.54668319702148,14316.589212341309,3,7,0,27,20108,0
100102,Clothing,66.66712188720703,2022-07-08,111,127,69.57871673583983,16545.835115356444,4,7,0,27,20219,0
100102,Clothing,66.66712188720703,2022-07-09,133,135,65.32163757324219,17502.815594482425,5,7,1,27,20352,0
100102,Clothing,66.66712188720703,2022-07-10,124,138,67.28932708740234,17631.07311767578,6,7,1,27,20476,0
100102,Clothing,66.66712188720703,2022-07-11,18,0,67.19865417480469,1209.5757751464844,0,7,0,28,20494,0
100102,Clothing,66.66712188720703,2022-07-12,105,153,68.59224212646484,17716.850846557616,1,7,0,28,20599,0
100102,Clothing,66.66712188720703,2022-07-13,179,225,71.89205703735351,29093.05641937256,2,7,0,28,20778,0
100102,Clothing,66.66712188720703,2022-07-14,48,0,70.83411407470703,3400.0374755859375,3,7,0,28,20826,0
100102,Clothing,66.66712188720703,2022-07-15,83,0,70.83411407470703,5879.231468200684,4,7,0,28,20909,0
100102,Clothing,66.66712188720703,2022-07-16,73,112,61.252346954345704,11221.222655334474,5,7,1,28,20982,0
100102,Clothing,66.66712188720703,2022-07-17,114,171,68.23727722167969,19513.89920654297,6,7,1,28,21096,0
100102,Clothing,66.66712188720703,2022-07-18,25,0,67.07455444335938,1676.8638610839844,0,7,0,29,21121,0
100102,Clothing,66.66712188720703,2022-07-19,165,162,72.05087493896485,23555.5987298584,1,7,0,29,21286,0
100102,Clothing,66.66712188720703,2022-07-20,73,0,70.37174987792969,5137.137741088867,2,7,0,29,21359,0
100102,Clothing,66.66712188720703,2022-07-21,37,50,59.118942413330075,5074.461738586426,3,7,0,29,21396,0
100102,Clothing,66.66712188720703,2022-07-22,102,240,81.80310516357422,28397.13345336914,4,7,0,29,21498,0
100102,Clothing,66.66712188720703,2022-07-23,107,0,78.75621032714844,8426.914505004883,5,7,1,29,21605,0
100102,Clothing,66.66712188720703,2022-07-24,74,125,69.87431289672853,13747.68830871582,6,7,1,29,21679,0
100102,Clothing,66.66712188720703,2022-07-25,89,103,59.635693359375,11362.05341796875,0,7,0,30,21768,0
100102,Clothing,66.66712188720703,2022-07-26,96,167,73.96596572875976,19665.625419921875,1,7,0,30,21864,0
100102,Clothing,66.66712188720703,2022-07-27,136,0,70.97193145751953,9652.182678222656,2,7,0,30,22000,0
100102,Clothing,66.66712188720703,2022-07-28,63,69,64.12855697631836,8444.818179016114,3,7,0,30,22063,0
100102,Clothing,66.66712188720703,2022-07-29,139,133,72.50709365844727,19711.59203704834,4,7,0,30,22202,0
100102,Clothing,66.66712188720703,2022-07-30,83,115,73.16696884155274,14514.996827697754,5,7,1,30,22285,0
100102,Clothing,66.66712188720703,2022-07-31,119,100,72.09839523315429,15791.228065490723,6,7,1,30,22404,0
100102,Clothing,66.66712188720703,2022-08-01,121,101,60.326054382324216,13491.905160522461,0,8,0,31,22525,0
100102,Clothing,66.66712188720703,2022-08-02,83,69,59.905604400634765,9141.710330505372,1,8,0,31,22608,0
100102,Clothing,66.66712188720703,2022-08-03,112,197,75.81798721313476,23678.679135742186,2,8,0,31,22720,0
100102,Clothing,66.66712188720703,2022-08-04,87,0,72.86597442626953,6339.339775085449,3,8,0,31,22807,0
100102,Clothing,66.66712188720703,2022-08-05,71,90,66.88039367675782,10724.605902099609,4,8,0,31,22878,0
100102,Clothing,66.66712188720703,2022-08-06,64,111,63.97296157836914,11105.82908203125,5,8,1,31,22942,0
100102,Clothing,66.66712188720703,2022-08-07,126,110,67.38105239868165,15891.225204467773,6,8,1,31,23068,0
100102,Clothing,66.66712188720703,2022-08-08,74,89,67.41653823852539,10993.897659301758,0,8,0,32,23142,0
100102,Clothing,66.66712188720703,2022-08-09,85,105,70.44283615112305,13414.682145690917,1,8,0,32,23227,0
100102,Clothing,66.66712188720703,2022-08-10,52,0,68.9156723022461,3583.614959716797,2,8,0,32,23279,0
100102,Clothing,66.66712188720703,2022-08-11,82,73,65.52682952880859,10171.750042724609,3,8,0,32,23361,0
100102,Clothing,66.66712188720703,2022-08-12,64,70,61.39213409423828,8209.4931640625,4,8,0,32,23425,0
100102,Clothing,66.66712188720703,2022-08-13,91,120,60.78191841125488,12788.09915084839,5,8,1,32,23516,0
100102,Clothing,66.66712188720703,2022-08-14,98,140,63.40967269897461,15112.935848999025,6,8,1,32,23614,0
100102,Clothing,66.66712188720703,2022-08-15,140,0,62.89934539794922,8805.90835571289,0,8,0,33,23754,0
100102,Clothing,66.66712188720703,2022-08-16,71,142,66.8998924255371,14306.48472442627,1,8,0,33,23825,0
100102,Clothing,66.66712188720703,2022-08-17,142,143,76.16920745849609,21711.56491821289,2,8,0,33,23967,0
100102,Clothing,66.66712188720703,2022-08-18,132,189,72.1234815979004,23140.609141845704,3,8,0,33,24099,0
100102,Clothing,66.66712188720703,2022-08-19,143,160,78.0102668762207,23674.33632659912,4,8,0,33,24242,0
100102,Clothing,66.66712188720703,2022-08-20,190,145,75.83416549682617,25404.18288879395,5,8,1,33,24432,0
100102,Clothing,66.66712188720703,2022-08-21,172,184,77.86976409912108,27729.438850097657,6,8,1,33,24604,0
100102,Clothing,66.66712188720703,2022-08-22,142,135,75.6614614868164,20962.64506225586,0,8,0,34,24746,0
100102,Clothing,66.66712188720703,2022-08-23,84,0,76.29292297363281,6408.605529785156,1,8,0,34,24830,0
100102,Clothing,66.66712188720703,2022-08-24,93,93,63.675731048583984,11843.68597503662,2,8,0,34,24923,0
100102,Clothing,66.66712188720703,2022-08-25,93,240,68.63732040405273,22874.26159515381,3,8,0,34,25016,0
100102,Clothing,66.66712188720703,2022-08-26,105,0,68.51464080810547,7194.037284851074,4,8,0,34,25121,0
100102,Clothing,66.66712188720703,2022-08-27,135,123,64.61999237060547,16688.517940063477,5,8,1,34,25256,0
100102,Clothing,66.66712188720703,2022-08-28,81,97,65.41642639160156,11640.501075439453,6,8,1,34,25337,0
100102,Clothing,66.66712188720703,2022-08-29,118,167,69.71370132446289,19927.023512573243,0,8,0,35,25455,0
100102,Clothing,66.66712188720703,2022-08-30,93,0,68.51740264892578,6372.118446350098,1,8,0,35,25548,0
100102,Clothing,66.66712188720703,2022-08-31,58,73,63.18283752441406,8245.409152832031,2,8,0,35,25606,0
100102,Clothing,66.66712188720703,2022-09-01,107,99,63.41728210449219,13069.298370361328,3,9,0,35,25713,0
100102,Clothing,66.66712188720703,2022-09-02,102,199,75.99937805175782,23111.583122558593,4,9,0,35,25815,0
100102,Clothing,66.66712188720703,2022-09-03,88,0,73.56875610351562,6474.050537109375,5,9,1,35,25903,0
100102,Clothing,66.66712188720703,2022-09-04,111,171,68.65422210693359,19288.23730773926,6,9,1,35,26014,0
100102,Clothing,66.66712188720703,2022-09-05,77,0,69.85844421386719,5379.100204467773,0,9,0,36,26091,0
100102,Clothing,66.66712188720703,2022-09-06,94,175,74.00262969970703,19977.774383544922,1,9,0,36,26185,0
100102,Clothing,66.66712188720703,2022-09-07,83,113,69.07678726196289,13486.04668548584,2,9,0,36,26268,0
100102,Clothing,66.66712188720703,2022-09-08,50,0,70.84357452392578,3542.178726196289,3,9,0,36,26318,0
100102,Clothing,66.66712188720703,2022-09-09,155,188,64.97349060058593,22229.362086181638,4,9,0,36,26473,0
100102,Clothing,66.66712188720703,2022-09-10,90,0,66.68698120117188,6001.828308105469,5,9,1,36,26563,0
100102,Clothing,66.66712188720703,2022-09-11,65,67,53.127648544311526,7001.394310760497,6,9,1,36,26628,0
100102,Clothing,66.66712188720703,2022-09-12,69,104,65.69826026916505,11443.559917144776,0,9,0,37,26697,0
100102,Clothing,66.66712188720703,2022-09-13,88,67,59.43717964172363,9255.333616943359,1,9,0,37,26785,0
100102,Clothing,66.66712188720703,2022-09-14,52,66,58.64604751586914,6901.948941650391,2,9,0,37,26837,0
100102,Clothing,66.66712188720703,2022-09-15,128,228,72.28655731201172,26004.358671874998,3,9,0,37,26965,0
100102,Clothing,66.66712188720703,2022-09-16,77,0,69.58311462402344,5357.899826049805,4,9,0,37,27042,0
100102,Clothing,66.66712188720703,2022-09-17,138,137,70.65807296752931,19430.58813903809,5,9,1,37,27180,0
100102,Clothing,66.66712188720703,2022-09-18,74,81,69.66420227050781,10795.891936035157,6,9,1,37,27254,0
100102,Clothing,66.66712188720703,2022-09-19,74,0,69.95840454101562,5176.921936035156,0,9,0,38,27328,0
100102,Clothing,66.66712188720703,2022-09-20,65,100,63.05474914550781,10333.167388916016,1,9,0,38,27393,0
100102,Clothing,66.66712188720703,2022-09-21,96,94,59.53721923828125,11316.346093749999,2,9,0,38,27489,0
100102,Clothing,66.66712188720703,2022-09-22,116,115,65.67033660888671,15168.50809326172,3,9,0,38,27605,0
100102,Clothing,66.66712188720703,2022-09-23,90,94,68.43300735473633,12597.901323852539,4,9,0,38,27695,0
100102,Clothing,66.66712188720703,2022-09-24,88,122,56.802377700805664,11816.218475341797,5,9,1,38,27783,0
100102,Clothing,66.66712188720703,2022-09-25,64,0,60.10475540161133,3846.704345703125,6,9,1,38,27847,0
100102,Clothing,66.66712188720703,2022-09-26,89,204,74.03538192749023,21979.247983093264,0,9,0,39,27936,0
100102,Clothing,66.66712188720703,2022-09-27,82,0,71.54076385498047,5866.342636108398,1,9,0,39,28018,0
100102,Clothing,66.66712188720703,2022-09-28,50,0,71.54076385498047,3577.0381927490234,2,9,0,39,28068,0
100102,Clothing,66.66712188720703,2022-09-29,72,79,60.10111022949219,9050.199873046875,3,9,0,39,28140,0
100102,Clothing,66.66712188720703,2022-09-30,47,57,57.98288841247559,6006.891510772704,4,9,0,39,28187,0
100102,Clothing,66.66712188720703,2022-10-01,86,118,71.1759750366211,14615.067706298829,5,10,1,39,28273,0
100102,Clothing,66.66712188720703,2022-10-02,121,173,65.80980560302734,19315.852955932616,6,10,1,39,28394,0
100102,Clothing,66.66712188720703,2022-10-03,86,116,64.8042790222168,13069.63599182129,0,10,0,40,28480,0
100102,Clothing,66.66712188720703,2022-10-04,94,0,65.4985580444336,6156.864456176758,1,10,0,40,28574,0
100102,Clothing,66.66712188720703,2022-10-05,109,124,65.48433898925782,15257.785899658204,2,10,0,40,28683,0
100102,Clothing,66.66712188720703,2022-10-06,101,109,58.312052230834965,12224.714550628662,3,10,0,40,28784,0
100102,Clothing,66.66712188720703,2022-10-07,132,116,72.47689910888673,17907.181364746095,4,10,0,40,28916,0
100102,Clothing,66.66712188720703,2022-10-08,116,313,90.73941802978516,39618.794982910156,5,10,1,40,29032,0
100102,Clothing,66.66712188720703,2022-10-09,20,0,87.22883605957031,1744.5767211914062,6,10,1,40,29052,0
100102,Clothing,66.66712188720703,2022-10-10,44,0,87.22883605957031,3838.0687866210938,0,10,0,41,29096,0
100102,Clothing,66.66712188720703,2022-10-11,138,0,87.22883605957031,12037.579376220703,1,10,0,41,29234,0
100102,Clothing,66.66712188720703,2022-10-12,111,135,67.46729705810547,16458.779946899413,2,10,0,41,29345,0
100102,Clothing,66.66712188720703,2022-10-13,71,99,65.42997909545899,11034.617031555175,3,10,0,41,29416,0
100102,Clothing,66.66712188720703,2022-10-14,112,116,59.706027526855465,13598.310166015624,4,10,0,41,29528,0
100102,Clothing,66.66712188720703,2022-10-15,94,127,60.81451263427734,13406.52837524414,5,10,1,41,29622,0
100102,Clothing,66.66712188720703,2022-10-16,142,0,61.82902526855469,8779.721588134766,6,10,1,41,29764,0
100102,Clothing,66.66712188720703,2022-10-17,58,204,80.16752777099609,21337.133221435546,0,10,0,42,29822,0
100102,Clothing,66.66712188720703,2022-10-18,90,0,77.88505554199219,7009.654998779297,1,10,0,42,29912,0
100102,Clothing,66.66712188720703,2022-10-19,76,100,64.71975967407226,11275.963470458984,2,10,0,42,29988,0
100102,Clothing,66.66712188720703,2022-10-20,41,0,69.49951934814453,2849.480293273926,3,10,0,42,30029,0
100102,Clothing,66.66712188720703,2022-10-21,97,133,72.42757080078124,16686.508735351563,4,10,0,42,30126,0
100102,Clothing,66.66712188720703,2022-10-22,107,127,71.96877578735351,16842.918018493652,5,10,1,42,30233,0
100102,Clothing,66.66712188720703,2022-10-23,153,126,73.36900588989258,20454.53580230713,6,10,1,42,30386,0
100102,Clothing,66.66712188720703,2022-10-24,42,53,59.68287399291992,5591.521415405274,0,10,0,43,30428,0
100102,Clothing,66.66712188720703,2022-10-25,105,111,66.63511672973632,14392.79451324463,1,10,0,43,30533,0
100102,Clothing,66.66712188720703,2022-10-26,105,125,68.43043640136719,15751.59164428711,2,10,0,43,30638,0
100102,Clothing,66.66712188720703,2022-10-27,124,117,68.60134490966797,16530.623537597658,3,10,0,43,30762,0
100102,Clothing,66.66712188720703,2022-10-28,70,129,68.28526260375978,13589.046764526369,4,10,0,43,30832,0
100102,Clothing,66.66712188720703,2022-10-29,100,0,68.28052520751953,6828.052520751953,5,10,1,43,30932,0
100102,Clothing,66.66712188720703,2022-10-30,82,125,64.82783233642579,13372.584503173828,6,10,1,43,31014,0
100102,Clothing,66.66712188720703,2022-10-31,79,89,61.89205551147461,10378.944770812988,0,10,0,44,31093,0
100102,Clothing,66.66712188720703,2022-11-01,110,0,63.78411102294922,7016.252212524414,1,11,0,44,31203,0
100102,Clothing,66.66712188720703,2022-11-02,58,132,67.17857696533204,12809.174927978516,2,11,0,44,31261,0
100102,Clothing,66.66712188720703,2022-11-03,84,85,61.245863876342774,10348.225131225587,3,11,0,44,31345,0
100102,Clothing,66.66712188720703,2022-11-04,79,72,58.82102348327636,8897.941710357667,4,11,0,44,31424,0
100102,Clothing,66.66712188720703,2022-11-05,87,111,62.099026184082035,12304.270556030275,5,11,1,44,31511,0
100102,Clothing,66.66712188720703,2022-11-06,150,264,78.0918927001953,32742.507810058592,6,11,1,44,31661,0
100102,Clothing,66.66712188720703,2022-11-07,76,0,74.47378540039062,5660.0076904296875,0,11,0,45,31737,0
100102,Clothing,66.66712188720703,2022-11-08,78,0,74.47378540039062,5808.955261230469,1,11,0,45,31815,0
100102,Clothing,66.66712188720703,2022-11-09,110,197,69.29934402465821,21176.645685424803,2,11,0,45,31925,0
100102,Clothing,66.66712188720703,2022-11-10,38,0,70.4286880493164,2676.2901458740234,3,11,0,45,31963,0
100102,Clothing,66.66712188720703,2022-11-11,135,156,61.151716003417974,17729.383320922854,4,11,0,45,32098,0
100102,Clothing,66.66712188720703,2022-11-12,156,177,74.90851318359375,25019.74611328125,5,11,1,45,32254,0
100102,Clothing,66.66712188720703,2022-11-13,125,0,71.3270263671875,8915.878295898438,6,11,1,45,32379,0
100102,Clothing,66.66712188720703,2022-11-14,76,111,68.71591796875,12826.56953125,0,11,0,46,32455,0
100102,Clothing,66.66712188720703,2022-11-15,108,120,68.89420806884766,15706.028942871093,1,11,0,46,32563,0
100102,Clothing,66.66712188720703,2022-11-16,119,102,73.42409912109375,16198.745590820312,2,11,0,46,32682,0
100102,Clothing,66.66712188720703,2022-11-17,102,103,58.68002151489257,12024.954389038085,3,11,0,46,32784,0
100102,Clothing,66.66712188720703,2022-11-18,95,136,60.45517501831055,13934.183253479005,4,11,0,46,32879,0
100102,Clothing,66.66712188720703,2022-11-19,139,171,72.95318603515625,22728.985717773438,5,11,1,46,33018,0
100102,Clothing,66.66712188720703,2022-11-20,109,0,69.4063720703125,7565.2945556640625,6,11,1,46,33127,0
100102,Clothing,66.66712188720703,2022-11-21,71,99,63.681126556396485,10783.4799710083,0,11,0,47,33198,0
100102,Clothing,66.66712188720703,2022-11-22,14,0,65.19225311279297,912.6915435791016,1,11,0,47,33212,0
100102,Clothing,66.66712188720703,2022-11-23,85,226,79.16784805297851,24933.114169006345,2,11,0,47,33297,0
100102,Clothing,66.66712188720703,2022-11-24,51,0,76.95569610595703,3924.7405014038086,3,11,0,47,33348,0
100102,Clothing,66.66712188720703,2022-11-25,39,0,76.95569610595703,3001.272148132324,4,11,0,47,33387,0
100102,Clothing,66.66712188720703,2022-11-26,45,0,76.95569610595703,3463.0063247680664,5,11,1,47,33432,0
100102,Clothing,66.66712188720703,2022-11-27,91,131,73.12699920654296,16194.71385559082,6,11,1,47,33523,0
100102,Clothing,66.66712188720703,2022-11-28,84,87,65.60477981567382,11207.453009033205,0,11,0,48,33607,0
100102,Clothing,66.66712188720703,2022-11-29,72,99,65.36279251098632,11134.57212158203,1,11,0,48,33679,0
100102,Clothing,66.66712188720703,2022-11-30,85,93,66.53558807373047,11841.849972534179,2,11,0,48,33764,0
100102,Clothing,66.66712188720703,2022-12-01,51,0,66.72117614746094,3402.779983520508,3,12,0,48,33815,0
100102,Clothing,66.66712188720703,2022-12-02,118,111,72.72598007202149,16639.66129699707,4,12,0,48,33933,0
100102,Clothing,66.66712188720703,2022-12-03,111,148,72.98184829711914,18925.91032196045,5,12,1,48,34044,0
100102,Clothing,66.66712188720703,2022-12-04,148,179,64.82820648193359,21130.679118652344,6,12,1,48,34192,0
100102,Clothing,66.66712188720703,2022-12-05,127,209,64.75195709228515,21700.737101440427,0,12,0,49,34319,0
100102,Clothing,66.66712188720703,2022-12-06,186,248,79.29942230224609,34712.34509643554,1,12,0,49,34505,0
100102,Clothing,66.66712188720703,2022-12-07,52,0,74.51884460449219,3874.9799194335938,2,12,0,49,34557,0
100102,Clothing,66.66712188720703,2022-12-08,171,0,74.51884460449219,12742.722427368164,3,12,0,49,34728,0
100102,Clothing,66.66712188720703,2022-12-09,100,164,84.75773544311524,22529.147088623045,4,12,0,49,34828,0
100102,Clothing,66.66712188720703,2022-12-10,63,0,82.36547088623047,5189.0246658325195,5,12,1,49,34891,0
100102,Clothing,66.66712188720703,2022-12-11,101,141,71.36967407226562,17155.474162597657,6,12,1,49,34992,0
100102,Clothing,66.66712188720703,2022-12-12,96,94,68.24280364990234,12971.29830078125,0,12,0,50,35088,0
100102,Clothing,66.66712188720703,2022-12-13,114,141,78.07612167358398,19974.04574157715,1,12,0,50,35202,0
100102,Clothing,66.66712188720703,2022-12-14,87,137,68.63045059204102,15240.198403015136,2,12,0,50,35289,0
100102,Clothing,66.66712188720703,2022-12-15,175,0,71.29090118408203,12475.907707214355,3,12,0,50,35464,0
100102,Clothing,66.66712188720703,2022-12-16,41,155,66.21312957763672,12910.156625366211,4,12,0,50,35505,0
100102,Clothing,66.66712188720703,2022-12-17,65,0,66.80625915527344,4342.406845092773,5,12,1,50,35570,0
100102,Clothing,66.66712188720703,2022-12-18,90,144,78.8035107421875,18594.27193359375,6,12,1,50,35660,0
100102,Clothing,66.66712188720703,2022-12-19,118,168,77.40315811157227,22159.145314331057,0,12,0,51,35778,0
100102,Clothing,66.66712188720703,2022-12-20,87,127,65.14084793090821,13735.307539978028,1,12,0,51,35865,0
100102,Clothing,66.66712188720703,2022-12-21,89,0,70.2616958618164,6253.29093170166,2,12,0,51,35954,0
100102,Clothing,66.66712188720703,2022-12-22,113,95,67.57353408813476,14076.238703918458,3,12,0,51,36067,0
100102,Clothing,66.66712188720703,2022-12-23,105,95,63.862787322998045,12792.08533782959,4,12,0,51,36172,0
100102,Clothing,66.66712188720703,2022-12-24,90,109,63.66210754394531,12654.469357910155,5,12,1,51,36262,0
100102,Clothing,66.66712188720703,2022-12-25,101,128,68.42017486572266,15705.745322875977,6,12,1,51,36363,0
100102,Clothing,66.66712188720703,2022-12-26,93,131,70.5573063659668,15856.238984069823,0,12,0,52,36456,0
100102,Clothing,66.66712188720703,2022-12-27,98,0,69.2046127319336,6782.052047729492,1,12,0,52,36554,0
100102,Clothing,66.66712188720703,2022-12-28,103,104,68.02926284790038,14081.668146667482,2,12,0,52,36657,0
100102,Clothing,66.66712188720703,2022-12-29,104,172,76.16233108520507,21143.044865722655,3,12,0,52,36761,0
100102,Clothing,66.66712188720703,2022-12-30,103,173,79.81142288208008,22154.553113708498,4,12,0,52,36864,0
100102,Clothing,66.66712188720703,2022-12-31,148,207,79.99506591796876,28441.60951171875,5,12,1,52,37012,0
100102,Clothing,66.66712188720703,2023-01-01,83,0,79.2601318359375,6578.5909423828125,6,1,1,52,37095,0
100102,Clothing,66.66712188720703,2023-01-02,104,0,79.2601318359375,8243.0537109375,0,1,0,1,37199,0
100102,Clothing,66.66712188720703,2023-01-03,114,171,82.5240267944336,23565.85810913086,1,1,0,1,37313,0
100102,Clothing,66.66712188720703,2023-01-04,86,131,63.0847151184082,13358.42100036621,2,1,0,1,37399,0
100102,Clothing,66.66712188720703,2023-01-05,71,0,70.4394302368164,5001.199546813965,3,1,0,1,37470,0
100102,Clothing,66.66712188720703,2023-01-06,91,134,69.5220733642578,15628.617352294923,4,1,0,1,37561,0
100102,Clothing,66.66712188720703,2023-01-07,155,155,82.2475813293457,25496.75021209717,5,1,1,1,37716,0
100102,Clothing,66.66712188720703,2023-01-08,134,135,60.638190002441405,16304.724920654297,6,1,1,1,37850,0
100102,Clothing,66.66712188720703,2023-01-09,69,0,67.58638000488281,4663.460220336914,0,1,0,2,37919,0
100102,Clothing,66.66712188720703,2023-01-10,120,202,78.32970001220704,25423.90800292969,1,1,0,2,38039,0
100102,Clothing,66.66712188720703,2023-01-11,128,141,73.63326416015624,19795.215625,2,1,0,2,38167,0
100102,Clothing,66.66712188720703,2023-01-12,60,0,74.5665283203125,4473.99169921875,3,1,0,2,38227,0
100102,Clothing,66.66712188720703,2023-01-13,99,173,75.02741333007813,20418.00783935547,4,1,0,2,38326,0
100102,Clothing,66.66712188720703,2023-01-14,156,0,74.88482666015625,11682.032958984375,5,1,1,2,38482,0
100102,Clothing,66.66712188720703,2023-01-15,73,100,66.2254963684082,11394.492469787598,6,1,1,2,38555,0
100102,Clothing,66.66712188720703,2023-01-16,100,135,69.5321258544922,16349.425170898438,0,1,0,3,38655,0
100102,Clothing,66.66712188720703,2023-01-17,135,177,80.12236267089844,25124.07792114258,1,1,0,3,38790,0
100102,Clothing,66.66712188720703,2023-01-18,34,0,77.12472534179688,2622.2406616210938,2,1,0,3,38824,0
100102,Clothing,66.66712188720703,2023-01-19,96,142,68.73850234985352,16230.572451171876,3,1,0,3,38920,0
100102,Clothing,66.66712188720703,2023-01-20,189,193,72.88139358520507,27842.446775207518,4,1,0,3,39109,0
100102,Clothing,66.66712188720703,2023-01-21,138,168,75.77447235107422,23223.454368896484,5,1,1,3,39247,0
100102,Clothing,66.66712188720703,2023-01-22,51,0,74.55894470214844,3802.5061798095703,6,1,1,3,39298,0
100102,Clothing,66.66712188720703,2023-01-23,96,141,74.78453308105469,17727.7803515625,0,1,0,4,39394,0
100102,Clothing,66.66712188720703,2023-01-24,149,0,74.69906616210938,11130.160858154297,1,1,0,4,39543,0
100102,Clothing,66.66712188720703,2023-01-25,68,176,72.7547900390625,17718.1714453125,2,1,0,4,39611,0
100102,Clothing,66.66712188720703,2023-01-26,95,122,78.87658813476563,17181.92174560547,3,1,0,4,39706,0
100102,Clothing,66.66712188720703,2023-01-27,173,155,73.45317626953124,24113.93898925781,4,1,0,4,39879,0
100102,Clothing,66.66712188720703,2023-01-28,151,129,74.73063064575194,20923.71045501709,5,1,1,4,40030,0
100102,Clothing,66.66712188720703,2023-01-29,163,234,85.41884872436523,34108.034684143066,6,1,1,4,40193,0
100102,Clothing,66.66712188720703,2023-01-30,121,0,82.64769744873047,10000.371391296387,0,1,0,5,40314,0
100102,Clothing,66.66712188720703,2023-01-31,113,168,75.36327423095703,21076.24997619629,1,1,0,5,40427,0
100102,Clothing,66.66712188720703,2023-02-01,89,0,77.19654846191406,6870.492813110352,2,2,0,5,40516,0
100102,Clothing,66.66712188720703,2023-02-02,79,259,92.05394531249999,31468.123359375,3,2,0,5,40595,0
100102,Clothing,66.66712188720703,2023-02-03,128,0,90.087890625,11531.25,4,2,0,5,40723,0
100102,Clothing,66.66712188720703,2023-02-04,44,58,70.0482911682129,6996.129622802735,5,2,1,5,40767,0
100102,Clothing,66.66712188720703,2023-02-05,145,266,79.27103744506836,32543.970859069825,6,2,1,5,40912,0
100102,Clothing,66.66712188720703,2023-02-06,159,0,79.57207489013672,12651.959907531738,0,2,0,6,41071,0
100102,Clothing,66.66712188720703,2023-02-07,51,76,64.83732604980469,8082.157257080078,1,2,0,6,41122,0
100102,Clothing,66.66712188720703,2023-02-08,91,116,67.89768829345704,14027.379269409179,2,2,0,6,41213,0
100102,Clothing,66.66712188720703,2023-02-09,157,176,70.60386352539062,23520.513146972655,3,2,0,6,41370,0
100102,Clothing,66.66712188720703,2023-02-10,137,99,70.78247146606445,16692.59718170166,4,2,0,6,41507,0
100102,Clothing,66.66712188720703,2023-02-11,138,101,68.3986637878418,16378.311205444337,5,2,1,6,41645,0
100102,Clothing,66.66712188720703,2023-02-12,101,170,67.80747055053712,18353.229051208495,6,2,1,6,41746,0
100102,Clothing,66.66712188720703,2023-02-13,127,192,77.76494537353516,24999.096124877928,0,2,0,7,41873,0
100102,Clothing,66.66712188720703,2023-02-14,235,230,74.4288429260254,34610.05617523193,1,2,0,7,42108,0
100102,Clothing,66.66712188720703,2023-02-15,215,218,72.66398132324218,31461.54196899414,2,2,0,7,42323,0
100102,Clothing,66.66712188720703,2023-02-16,127,0,73.31796264648438,9311.381256103516,3,2,0,7,42450,0
100102,Clothing,66.66712188720703,2023-02-17,97,119,60.99667510986328,13091.754971313476,4,2,0,7,42547,0
100102,Clothing,66.66712188720703,2023-02-18,128,157,70.13352569580078,20032.902578125002,5,2,1,7,42675,0
100102,Clothing,66.66712188720703,2023-02-19,137,180,64.34745910644531,20342.78379516602,6,2,1,7,42812,0
100102,Clothing,66.66712188720703,2023-02-20,111,203,72.6987158203125,23041.874912109375,0,2,0,8,42923,0
100102,Clothing,66.66712188720703,2023-02-21,85,0,70.367431640625,5981.231689453125,1,2,0,8,43008,0
100102,Clothing,66.66712188720703,2023-02-22,74,0,70.367431640625,5207.18994140625,2,2,0,8,43082,0
100102,Clothing,66.66712188720703,2023-02-23,133,149,66.1358137512207,18629.406457824705,3,2,0,8,43215,0
100102,Clothing,66.66712188720703,2023-02-24,149,232,81.38164306640624,31287.639633789062,4,2,0,8,43364,0
100102,Clothing,66.66712188720703,2023-02-25,73,0,77.9932861328125,5693.5098876953125,5,2,1,8,43437,0
100102,Clothing,66.66712188720703,2023-02-26,133,167,75.20822265625,22531.9272265625,6,2,1,8,43570,0
100102,Clothing,66.66712188720703,2023-02-27,193,170,74.54529403686524,27072.94349822998,0,2,0,9,43763,0
100102,Clothing,66.66712188720703,2023-02-28,170,162,81.09171600341797,26905.983441162112,1,2,0,9,43933,0
100102,Clothing,66.66712188720703,2023-03-01,162,185,71.98601715087891,24929.789556884767,2,3,0,9,44095,0
100102,Clothing,66.66712188720703,2023-03-02,99,0,74.13203430175781,7339.071395874023,3,3,0,9,44194,0
100102,Clothing,66.66712188720703,2023-03-03,58,63,61.65958099365234,7435.511395263672,4,3,0,9,44252,0
100102,Clothing,66.66712188720703,2023-03-04,91,105,58.74176887512207,11479.621935272216,5,3,1,9,44343,0
100102,Clothing,66.66712188720703,2023-03-05,83,147,66.5419888305664,15395.410145874022,6,3,1,9,44426,0
100102,Clothing,66.66712188720703,2023-03-06,26,0,65.12397766113281,1693.2234191894531,0,3,0,10,44452,0
100102,Clothing,66.66712188720703,2023-03-07,143,142,71.75822662353517,20448.872814331055,1,3,0,10,44595,0
100102,Clothing,66.66712188720703,2023-03-08,118,105,64.48699722290038,14407.081344604492,2,3,0,10,44713,0
100102,Clothing,66.66712188720703,2023-03-09,91,169,67.64918563842772,17613.031786193846,3,3,0,10,44804,0
100102,Clothing,66.66712188720703,2023-03-10,119,157,73.02902938842774,20241.9289944458,4,3,0,10,44923,0
100102,Clothing,66.66712188720703,2023-03-11,83,0,70.76805877685547,5873.748878479004,5,3,1,10,45006,0
100102,Clothing,66.66712188720703,2023-03-12,126,108,63.881416168212894,15001.376874389647,6,3,1,10,45132,0
100102,Clothing,66.66712188720703,2023-03-13,116,105,71.8493731689453,15856.264575195313,0,3,0,11,45248,0
100102,Clothing,66.66712188720703,2023-03-14,62,0,69.80874633789062,4328.142272949219,1,3,0,11,45310,0
100102,Clothing,66.66712188720703,2023-03-15,71,104,65.70446212768555,11463.813622131347,2,3,0,11,45381,0
100102,Clothing,66.66712188720703,2023-03-16,104,174,72.38354095458985,20213.376518554687,3,3,0,11,45485,0
100102,Clothing,66.66712188720703,2023-03-17,41,0,71.08708190917969,2914.570358276367,4,3,0,11,45526,0
100102,Clothing,66.66712188720703,2023-03-18,65,78,62.54919677734375,8893.455581054688,5,3,1,11,45591,0
100102,Clothing,66.66712188720703,2023-03-19,66,102,65.54807479858398,10998.105873413086,6,3,1,11,45657,0
100102,Clothing,66.66712188720703,2023-03-20,77,100,66.64992630004883,11804.85865020752,0,3,0,12,45734,0
100102,Clothing,66.66712188720703,2023-03-21,77,0,66.30985260009766,5105.8586502075195,1,3,0,12,45811,0
100102,Clothing,66.66712188720703,2023-03-22,95,108,64.45877243041993,13076.176761779785,2,3,0,12,45906,0
100102,Clothing,66.66712188720703,2023-03-23,76,103,67.01939453125,12017.00796875,3,3,0,12,45982,0
100102,Clothing,66.66712188720703,2023-03-24,101,116,70.23147506713867,15265.257963562013,4,3,0,12,46083,0
100102,Clothing,66.66712188720703,2023-03-25,56,0,68.56295013427734,3839.5252075195312,5,3,1,12,46139,0
100102,Clothing,66.66712188720703,2023-03-26,127,183,69.56250778198242,21578.796976623533,6,3,1,12,46266,0
100102,Clothing,66.66712188720703,2023-03-27,83,0,69.30501556396484,5752.316291809082,0,3,0,13,46349,0
100102,Clothing,66.66712188720703,2023-03-28,90,150,73.00500473022461,17576.70085144043,1,3,0,13,46439,0
100102,Clothing,66.66712188720703,2023-03-29,93,150,78.1341944885254,19106.640174865723,2,3,0,13,46532,0
100102,Clothing,66.66712188720703,2023-03-30,165,0,76.02838897705078,12544.684181213379,3,3,0,13,46697,0
100102,Clothing,66.66712188720703,2023-03-31,50,51,61.863089599609374,6243.388959960937,4,3,0,13,46747,0
100102,Clothing,66.66712188720703,2023-04-01,53,138,73.20363128662109,14071.684916381837,5,4,1,13,46800,0
100102,Clothing,66.66712188720703,2023-04-02,102,111,59.71550521850586,12676.513064575196,6,4,1,13,46902,0
100102,Clothing,66.66712188720703,2023-04-03,86,0,64.48101043701172,5545.366897583008,0,4,0,14,46988,0
100102,Clothing,66.66712188720703,2023-04-04,61,113,69.81606826782226,12206.960328674317,1,4,0,14,47049,0
100102,Clothing,66.66712188720703,2023-04-05,28,0,68.68213653564453,1923.0998229980469,2,4,0,14,47077,0
100102,Clothing,66.66712188720703,2023-04-06,85,121,56.775100555419925,11584.247094421386,3,4,0,14,47162,0
100102,Clothing,66.66712188720703,2023-04-07,102,116,57.501824111938475,12524.03211883545,4,4,0,14,47264,0
100102,Clothing,66.66712188720703,2023-04-08,98,95,52.00889617919922,10045.573651123046,5,4,1,14,47362,0
100102,Clothing,66.66712188720703,2023-04-09,112,120,65.40561126708985,15204.696923828125,6,4,1,14,47474,0
100102,Clothing,66.66712188720703,2023-04-10,132,140,66.99530639648438,18237.160888671875,0,4,0,15,47606,0
100102,Clothing,66.66712188720703,2023-04-11,28,0,65.19061279296875,1825.337158203125,1,4,0,15,47634,0
100102,Clothing,66.66712188720703,2023-04-12,120,203,72.4694303894043,23545.45329345703,2,4,0,15,47754,0
100102,Clothing,66.66712188720703,2023-04-13,123,0,70.8088607788086,8709.489875793457,3,4,0,15,47877,0
100102,Clothing,66.66712188720703,2023-04-14,80,158,70.61846450805663,16804.194321289062,4,4,0,15,47957,0
100102,Clothing,66.66712188720703,2023-04-15,145,156,75.53884490966797,22755.245023803713,5,4,1,15,48102,0
100102,Clothing,66.66712188720703,2023-04-16,169,226,81.35150665283203,32249.469248657224,6,4,1,15,48271,0
100102,Clothing,66.66712188720703,2023-04-17,117,0,79.32301330566406,9280.792556762695,0,4,0,16,48388,0
100102,Clothing,66.66712188720703,2023-04-18,109,140,70.44708679199218,17464.2249206543,1,4,0,16,48497,0
100102,Clothing,66.66712188720703,2023-04-19,105,84,66.76443145751954,12677.370606079101,2,4,0,16,48602,0
100102,Clothing,66.66712188720703,2023-04-20,119,135,59.76050079345703,15131.159188842772,3,4,0,16,48721,0
100102,Clothing,66.66712188720703,2023-04-21,93,111,69.27625,14176.7025,4,4,0,16,48814,0
100102,Clothing,66.66712188720703,2023-04-22,62,0,66.8125,4142.375,5,4,1,16,48876,0
100102,Clothing,66.66712188720703,2023-04-23,91,108,61.65790885925293,12243.949412384034,6,4,1,16,48967,0
100102,Clothing,66.66712188720703,2023-04-24,83,125,67.1301042175293,14013.037300109863,0,4,0,17,49050,0
100102,Clothing,66.66712188720703,2023-04-25,92,157,76.48207122802734,19265.55110595703,1,4,0,17,49142,0
100102,Clothing,66.66712188720703,2023-04-26,88,0,73.07414245605469,6430.5245361328125,2,4,0,17,49230,0
100102,Clothing,66.66712188720703,2023-04-27,64,89,66.1169351196289,10043.4676953125,3,4,0,17,49294,0
100102,Clothing,66.66712188720703,2023-04-28,84,103,63.234017028808594,11778.134860839844,4,4,0,17,49378,0
100102,Clothing,66.66712188720703,2023-04-29,127,138,69.50848709106445,18435.82572113037,5,4,1,17,49505,0
100102,Clothing,66.66712188720703,2023-04-30,141,166,81.17984298706054,25038.465722351073,6,4,1,17,49646,0
100102,Clothing,66.66712188720703,2023-05-01,90,0,76.5296859741211,6887.671737670898,0,5,0,18,49736,0
100102,Clothing,66.66712188720703,2023-05-02,117,247,78.86316421508789,28764.280426330566,1,5,0,18,49853,0
100102,Clothing,66.66712188720703,2023-05-03,59,0,78.41632843017578,4626.563377380371,2,5,0,18,49912,0
100102,Clothing,66.66712188720703,2023-05-04,128,177,72.6500961303711,22060.274609375003,3,5,0,18,50040,0
100102,Clothing,66.66712188720703,2023-05-05,237,247,77.34598861694336,37444.19860443115,4,5,0,18,50277,0
100102,Clothing,66.66712188720703,2023-05-06,135,0,76.47197723388672,10323.716926574707,5,5,1,18,50412,0
100102,Clothing,66.66712188720703,2023-05-07,112,120,75.49944183349609,17513.394970703124,6,5,1,18,50524,0
100102,Clothing,66.66712188720703,2023-05-08,120,272,95.99237854003906,38183.45084960938,0,5,0,19,50644,0
100102,Clothing,66.66712188720703,2023-05-09,131,0,92.34475708007812,12097.163177490234,1,5,0,19,50775,0
100102,Clothing,66.66712188720703,2023-05-10,107,145,88.8298796081543,22341.434236145018,2,5,0,19,50882,0
100102,Clothing,66.66712188720703,2023-05-11,103,160,80.44152999877929,20961.095179748532,3,5,0,19,50985,0
100102,Clothing,66.66712188720703,2023-05-12,121,0,83.8630599975586,10147.43025970459,4,5,0,19,51106,0
100102,Clothing,66.66712188720703,2023-05-13,100,131,78.86469833374024,18170.479666748048,5,5,1,19,51206,0
100102,Clothing,66.66712188720703,2023-05-14,75,97,59.49311233520508,10035.406850280762,6,5,1,19,51281,0
100102,Clothing,66.66712188720703,2023-05-15,132,132,67.39614318847657,17792.581801757813,0,5,0,20,51413,0
100102,Clothing,66.66712188720703,2023-05-16,168,164,77.25997589111327,25637.51189941406,1,5,0,20,51581,0
100102,Clothing,66.66712188720703,2023-05-17,148,143,67.22204040527345,19574.073959960937,2,5,0,20,51729,0
100102,Clothing,66.66712188720703,2023-05-18,110,133,80.03046066284179,19536.171345825198,3,5,0,20,51839,0
100102,Clothing,66.66712188720703,2023-05-19,182,171,83.970859375,29611.9128125,4,5,0,20,52021,0
100102,Clothing,66.66712188720703,2023-05-20,73,110,66.83109451293946,11996.57979888916,5,5,1,20,52094,0
100102,Clothing,66.66712188720703,2023-05-21,116,0,73.1421890258789,8484.493927001953,6,5,1,20,52210,0
100102,Clothing,66.66712188720703,2023-05-22,92,141,62.28158920288086,14380.702413330078,0,5,0,21,52302,0
100102,Clothing,66.66712188720703,2023-05-23,141,201,81.61376831054687,28171.482663574217,1,5,0,21,52443,0
100102,Clothing,66.66712188720703,2023-05-24,71,0,77.28753662109375,5487.415100097656,2,5,0,21,52514,0
100102,Clothing,66.66712188720703,2023-05-25,85,109,73.16866058349609,14157.792299194334,3,5,0,21,52599,0
100102,Clothing,66.66712188720703,2023-05-26,109,89,59.885283355712886,11994.79177154541,4,5,0,21,52708,0
100102,Clothing,66.66712188720703,2023-05-27,41,0,66.76056671142578,2737.183235168457,5,5,1,21,52749,0
100102,Clothing,66.66712188720703,2023-05-28,53,77,66.22256637573241,8604.072035827638,6,5,1,21,52802,0
100102,Clothing,66.66712188720703,2023-05-29,76,134,65.07139785766601,13641.132474365233,0,5,0,22,52878,0
100102,Clothing,66.66712188720703,2023-05-30,141,136,65.5813966369629,18165.853851623535,1,5,0,22,53019,0
100102,Clothing,66.66712188720703,2023-05-31,35,0,65.54279327392578,2293.9977645874023,2,5,0,22,53054,0
100102,Clothing,66.66712188720703,2023-06-01,109,98,63.374394531250005,13128.2280078125,3,6,0,22,53163,0
100102,Clothing,66.66712188720703,2023-06-02,76,90,63.428621215820314,10524.410424804688,4,6,0,22,53239,0
100102,Clothing,66.66712188720703,2023-06-03,17,0,63.767242431640625,1084.0431213378906,5,6,1,22,53256,0
100102,Clothing,66.66712188720703,2023-06-04,121,211,77.7288493347168,26085.981539001466,6,6,1,22,53377,0
100102,Clothing,66.66712188720703,2023-06-05,53,0,74.6176986694336,3954.7380294799805,0,6,0,23,53430,0
100102,Clothing,66.66712188720703,2023-06-06,104,158,74.82192642211913,19607.020695800784,1,6,0,23,53534,0
100102,Clothing,66.66712188720703,2023-06-07,78,0,74.75385284423828,5830.800521850586,2,6,0,23,53612,0
100102,Clothing,66.66712188720703,2023-06-08,115,103,67.52070709228516,14753.722631225586,3,6,0,23,53727,0
100102,Clothing,66.66712188720703,2023-06-09,122,142,78.8824870300293,20876.126835327148,4,6,0,23,53849,0
100102,Clothing,66.66712188720703,2023-06-10,102,117,72.32908645629882,15817.43363708496,5,6,1,23,53951,0
100102,Clothing,66.66712188720703,2023-06-11,58,0,73.83817291259766,4282.614028930664,6,6,1,23,54009,0
100102,Clothing,66.66712188720703,2023-06-12,55,72,66.35052337646485,8374.657571411131,0,6,0,24,54064,0
100102,Clothing,66.66712188720703,2023-06-13,105,159,76.89658279418946,20408.882386779784,1,6,0,24,54169,0
100102,Clothing,66.66712188720703,2023-06-14,151,209,77.82295318603516,28065.391862182616,2,6,0,24,54320,0
100102,Clothing,66.66712188720703,2023-06-15,101,0,76.97590637207031,7774.566543579102,3,6,0,24,54421,0
100102,Clothing,66.66712188720703,2023-06-16,118,168,78.7447950744629,22545.27163757324,4,6,0,24,54539,0
100102,Clothing,66.66712188720703,2023-06-17,74,0,78.25959014892578,5791.209671020508,5,6,1,24,54613,0
100102,Clothing,66.66712188720703,2023-06-18,35,0,78.25959014892578,2739.0856552124023,6,6,1,24,54648,0
100102,Clothing,66.66712188720703,2023-06-19,68,101,65.90222503662109,11034.77260498047,0,6,0,25,54716,0
100102,Clothing,66.66712188720703,2023-06-20,101,131,63.01051513671875,14568.324057617188,1,6,0,25,54817,0
100102,Clothing,66.66712188720703,2023-06-21,131,158,65.75519958496093,19011.752291259763,2,6,0,25,54948,0
100102,Clothing,66.66712188720703,2023-06-22,158,198,71.75817993164063,25617.98485839844,3,6,0,25,55106,0
100102,Clothing,66.66712188720703,2023-06-23,70,0,69.95635986328125,4896.9451904296875,4,6,0,25,55176,0
100102,Clothing,66.66712188720703,2023-06-24,72,75,62.207718200683594,9133.831420898438,5,6,1,25,55248,0
100102,Clothing,66.66712188720703,2023-06-25,57,83,66.45170974731445,9310.994911193848,6,6,1,25,55305,0
100102,Clothing,66.66712188720703,2023-06-26,157,167,68.56036666870116,22221.25513397217,0,6,0,26,55462,0
100102,Clothing,66.66712188720703,2023-06-27,40,0,67.79073333740234,2711.6293334960938,1,6,0,26,55502,0
100102,Clothing,66.66712188720703,2023-06-28,127,180,79.35441833496094,24521.632257080077,2,6,0,26,55629,0
100102,Clothing,66.66712188720703,2023-06-29,72,0,76.33883666992188,5496.396240234375,3,6,0,26,55701,0
100102,Clothing,66.66712188720703,2023-06-30,31,0,76.33883666992188,2366.503936767578,4,6,0,26,55732,0
100102,Clothing,66.66712188720703,2023-07-01,77,150,70.38586135864259,15888.832649230957,5,7,1,26,55809,0
100102,Clothing,66.66712188720703,2023-07-02,59,94,62.72803070068359,9459.557622680664,6,7,1,26,55868,0
100102,Clothing,66.66712188720703,2023-07-03,80,0,66.66606140136719,5333.284912109375,0,7,0,27,55948,0
100102,Clothing,66.66712188720703,2023-07-04,105,134,68.74482635498046,16446.9835345459,1,7,0,27,56053,0
100102,Clothing,66.66712188720703,2023-07-05,134,212,78.98126510620116,27530.219048461913,2,7,0,27,56187,0
100102,Clothing,66.66712188720703,2023-07-06,45,0,76.38253021240234,3437.2138595581055,3,7,0,27,56232,0
100102,Clothing,66.66712188720703,2023-07-07,96,0,76.38253021240234,7332.722900390625,4,7,0,27,56328,0
100102,Clothing,66.66712188720703,2023-07-08,71,171,71.26906997680663,17159.207936706545,5,7,1,27,56399,0
100102,Clothing,66.66712188720703,2023-07-09,94,96,59.62794326782226,11317.513334350586,6,7,1,27,56493,0
100102,Clothing,66.66712188720703,2023-07-10,149,167,76.38471786499024,24204.26592376709,0,7,0,28,56642,0
100102,Clothing,66.66712188720703,2023-07-11,87,0,72.67943572998047,6323.110908508301,1,7,0,28,56729,0
100102,Clothing,66.66712188720703,2023-07-12,104,211,83.87619201660156,26657.877939453127,2,7,0,28,56833,0
100102,Clothing,66.66712188720703,2023-07-13,112,0,81.66238403320312,9146.18701171875,3,7,0,28,56945,0
100102,Clothing,66.66712188720703,2023-07-14,78,121,75.29778823852538,14904.804965209962,4,7,0,28,57023,0
100102,Clothing,66.66712188720703,2023-07-15,80,113,64.96869064331055,12383.900502929688,5,7,1,28,57103,0
100102,Clothing,66.66712188720703,2023-07-16,91,0,69.6673812866211,6339.7316970825195,6,7,1,28,57194,0
100102,Clothing,66.66712188720703,2023-07-17,84,167,69.94434356689453,17560.64971923828,0,7,0,29,57278,0
100102,Clothing,66.66712188720703,2023-07-18,135,119,68.94084014892579,17517.22684020996,1,7,0,29,57413,0
100102,Clothing,66.66712188720703,2023-07-19,79,103,71.04522491455077,12947.625536499023,2,7,0,29,57492,0
100102,Clothing,66.66712188720703,2023-07-20,116,132,64.81475311279297,16038.942722167969,3,7,0,29,57608,0
100102,Clothing,66.66712188720703,2023-07-21,131,112,70.31751815795899,17058.229757385256,4,7,0,29,57739,0
100102,Clothing,66.66712188720703,2023-07-22,80,0,68.79503631591797,5503.6029052734375,5,7,1,29,57819,0
100102,Clothing,66.66712188720703,2023-07-23,89,70,59.898096618652346,9590.831198120117,6,7,1,29,57908,0
100102,Clothing,66.66712188720703,2023-07-24,73,105,62.205005950927735,11062.41086883545,0,7,0,30,57981,0
100102,Clothing,66.66712188720703,2023-07-25,105,117,70.21621780395508,15616.605738830565,1,7,0,30,58086,0
100102,Clothing,66.66712188720703,2023-07-26,107,124,72.65434417724609,16809.429653930667,2,7,0,30,58193,0
100102,Clothing,66.66712188720703,2023-07-27,103,100,65.10047790527344,13222.628448486328,3,7,0,30,58296,0
100102,Clothing,66.66712188720703,2023-07-28,89,104,67.93581848144531,13114.075689697265,4,7,0,30,58385,0
100102,Clothing,66.66712188720703,2023-07-29,68,85,63.919693298339844,9749.458288574218,5,7,1,30,58453,0
100102,Clothing,66.66712188720703,2023-07-30,163,133,69.25792282104493,20459.782839660642,6,7,1,30,58616,0
100102,Clothing,66.66712188720703,2023-07-31,63,0,67.90584564208984,4278.06827545166,0,7,0,31,58679,0
100102,Clothing,66.66712188720703,2023-08-01,70,129,73.12595092773438,14617.793129882812,1,8,0,31,58749,0
100102,Clothing,66.66712188720703,2023-08-02,109,137,75.30566757202149,18554.715530700683,2,8,0,31,58858,0
100102,Clothing,66.66712188720703,2023-08-03,74,97,71.38299255371093,12176.98289794922,3,8,0,31,58932,0
100102,Clothing,66.66712188720703,2023-08-04,95,166,76.00583251953125,19920.88817871094,4,8,0,31,59027,0
100102,Clothing,66.66712188720703,2023-08-05,112,0,74.8316650390625,8381.146484375,5,8,1,31,59139,0
100102,Clothing,66.66712188720703,2023-08-06,120,103,69.4273796081543,15519.321105957031,6,8,1,31,59259,0
100102,Clothing,66.66712188720703,2023-08-07,94,113,69.35774627685547,14342.086300048828,0,8,0,32,59353,0
100102,Clothing,66.66712188720703,2023-08-08,80,105,66.93834228515625,12351.384765625,1,8,0,32,59433,0
100102,Clothing,66.66712188720703,2023-08-09,103,112,61.95113052368164,13295.452887878419,2,8,0,32,59536,0
100102,Clothing,66.66712188720703,2023-08-10,108,119,61.403768081665035,13923.653905639649,3,8,0,32,59644,0
100102,Clothing,66.66712188720703,2023-08-11,124,178,73.66893203735351,22450.03514526367,4,8,0,32,59768,0
100102,Clothing,66.66712188720703,2023-08-12,30,0,69.92786407470703,2097.835922241211,5,8,1,32,59798,0
100102,Clothing,66.66712188720703,2023-08-13,24,0,69.92786407470703,1678.2687377929688,6,8,1,32,59822,0
100102,Clothing,66.66712188720703,2023-08-14,151,136,68.40745880126954,19642.2025579834,0,8,0,33,59973,0
100102,Clothing,66.66712188720703,2023-08-15,38,0,69.02491760253906,2622.9468688964844,1,8,0,33,60011,0
100102,Clothing,66.66712188720703,2023-08-16,122,155,61.56858352661133,16980.624380493166,2,8,0,33,60133,0
100102,Clothing,66.66712188720703,2023-08-17,109,103,70.52310348510741,14932.916559753417,3,8,0,33,60242,0
100102,Clothing,66.66712188720703,2023-08-18,116,122,68.45296493530273,16294.007864990233,4,8,0,33,60358,0
100102,Clothing,66.66712188720703,2023-08-19,96,0,68.08592987060547,6536.249267578125,5,8,1,33,60454,0
100102,Clothing,66.66712188720703,2023-08-20,70,109,68.04093612670898,12178.901057739258,6,8,1,33,60524,0
100102,Clothing,66.66712188720703,2023-08-21,58,50,57.094573440551756,6211.930519104004,0,8,0,34,60582,0
100102,Clothing,66.66712188720703,2023-08-22,101,133,58.982978668212894,13768.321690979003,1,8,0,34,60683,0
100102,Clothing,66.66712188720703,2023-08-23,102,136,64.3449486541748,15362.20952545166,2,8,0,34,60785,0
100102,Clothing,66.66712188720703,2023-08-24,125,176,71.88764358520507,21785.180896301266,3,8,0,34,60910,0
100102,Clothing,66.66712188720703,2023-08-25,136,0,69.00528717041016,9384.719055175781,4,8,0,34,61046,0
100102,Clothing,66.66712188720703,2023-08-26,82,202,78.11326141357422,22368.574871826175,5,8,1,34,61128,0
100102,Clothing,66.66712188720703,2023-08-27,124,172,73.28700271606445,21634.536673583985,6,8,1,34,61252,0
100102,Clothing,66.66712188720703,2023-08-28,112,0,74.5040054321289,8344.448608398438,0,8,0,35,61364,0
100102,Clothing,66.66712188720703,2023-08-29,55,0,74.5040054321289,4097.72029876709,1,8,0,35,61419,0
100102,Clothing,66.66712188720703,2023-08-30,83,124,68.83222778320312,14189.959812011719,2,8,0,35,61502,0
100102,Clothing,66.66712188720703,2023-08-31,124,135,77.37044876098633,20063.581292724608,3,8,0,35,61626,0
100102,Clothing,66.66712188720703,2023-09-01,135,206,68.41699493408203,23212.54863220215,4,9,0,35,61761,0
100102,Clothing,66.66712188720703,2023-09-02,140,137,68.92367538452149,19093.33910766602,5,9,1,35,61901,0
100102,Clothing,66.66712188720703,2023-09-03,152,116,65.55324935913086,17633.18780517578,6,9,1,35,62053,0
100102,Clothing,66.66712188720703,2023-09-04,98,0,67.35649871826172,6600.936874389648,0,9,0,36,62151,0
100102,Clothing,66.66712188720703,2023-09-05,69,121,54.92754837036133,10292.841675109863,1,9,0,36,62220,0
100102,Clothing,66.66712188720703,2023-09-06,106,137,65.17547737121582,15908.771202697753,2,9,0,36,62326,0
100102,Clothing,66.66712188720703,2023-09-07,67,0,62.88095474243164,4213.02396774292,3,9,0,36,62393,0
100102,Clothing,66.66712188720703,2023-09-08,84,93,64.83660278320312,11481.599267578125,4,9,0,36,62477,0
100102,Clothing,66.66712188720703,2023-09-09,94,139,73.70425109863281,17280.89920654297,5,9,1,36,62571,0
100102,Clothing,66.66712188720703,2023-09-10,85,96,61.802109985351564,11142.268697509766,6,9,1,36,62656,0
100102,Clothing,66.66712188720703,2023-09-11,75,107,66.96679458618163,12203.419187927248,0,9,0,37,62731,0
100102,Clothing,66.66712188720703,2023-09-12,84,0,66.48358917236328,5584.621490478516,1,9,0,37,62815,0
100102,Clothing,66.66712188720703,2023-09-13,98,124,68.04714309692383,15117.98004699707,2,9,0,37,62913,0
100102,Clothing,66.66712188720703,2023-09-14,80,121,65.02414627075196,13034.013403320314,3,9,0,37,62993,0
100102,Clothing,66.66712188720703,2023-09-15,126,97,61.30919418334961,13733.116934204103,4,9,0,37,63119,0
100102,Clothing,66.66712188720703,2023-09-16,70,65,59.41622024536133,8031.420834350585,5,9,1,37,63189,0
100102,Clothing,66.66712188720703,2023-09-17,131,188,66.73711471557617,21366.824055480956,6,9,1,37,63320,0
100102,Clothing,66.66712188720703,2023-09-18,79,0,65.37422943115234,5164.564125061035,0,9,0,38,63399,0
100102,Clothing,66.66712188720703,2023-09-19,109,134,64.86673294067383,15758.947781066894,1,9,0,38,63508,0
100102,Clothing,66.66712188720703,2023-09-20,121,107,59.88482292175293,13681.387147064208,2,9,0,38,63629,0
100102,Clothing,66.66712188720703,2023-09-21,109,99,68.5175749206543,14226.531332702638,3,9,0,38,63738,0
100102,Clothing,66.66712188720703,2023-09-22,69,81,62.14933578491211,9303.688338317872,4,9,0,38,63807,0
100102,Clothing,66.66712188720703,2023-09-23,93,118,68.24432708740235,14438.194838256837,5,9,1,38,63900,0
100102,Clothing,66.66712188720703,2023-09-24,147,176,74.485947265625,24125.48849609375,6,9,1,38,64047,0
100102,Clothing,66.66712188720703,2023-09-25,30,0,72.19189453125,2165.7568359375,0,9,0,39,64077,0
100102,Clothing,66.66712188720703,2023-09-26,119,126,68.4007290649414,16748.443517456057,1,9,0,39,64196,0
100102,Clothing,66.66712188720703,2023-09-27,80,100,63.086231079101566,11297.39697265625,2,9,0,39,64276,0
100102,Clothing,66.66712188720703,2023-09-28,92,0,65.99246215820312,6071.3065185546875,3,9,0,39,64368,0
100102,Clothing,66.66712188720703,2023-09-29,81,135,75.30171356201171,16381.177597045898,4,9,0,39,64449,0
100102,Clothing,66.66712188720703,2023-09-30,41,0,73.15342712402344,2999.290512084961,5,9,1,39,64490,0
100102,Clothing,66.66712188720703,2023-10-01,75,102,67.96623138427734,11985.844707641601,6,10,1,39,64565,0
100102,Clothing,66.66712188720703,2023-10-02,121,104,73.55597198486328,16525.375220336915,0,10,0,40,64686,0
100102,Clothing,66.66712188720703,2023-10-03,70,58,56.85679550170899,7364.151370239258,1,10,0,40,64756,0
100102,Clothing,66.66712188720703,2023-10-04,92,256,83.89875122070313,29692.250224609375,2,10,0,40,64848,0
100102,Clothing,66.66712188720703,2023-10-05,174,0,80.87750244140625,14072.685424804688,3,10,0,40,65022,0
100102,Clothing,66.66712188720703,2023-10-06,82,86,69.3435578918457,11634.823494262695,4,10,0,40,65104,0
100102,Clothing,66.66712188720703,2023-10-07,55,68,63.06477996826172,7706.595796508789,5,10,1,40,65159,0
100102,Clothing,66.66712188720703,2023-10-08,99,194,79.14816802978515,23426.187269897462,6,10,1,40,65258,0
100102,Clothing,66.66712188720703,2023-10-09,140,126,73.72807846069335,19629.56196899414,0,10,0,41,65398,0
100102,Clothing,66.66712188720703,2023-10-10,110,189,78.52491577148437,23568.62146972656,1,10,0,41,65508,0
100102,Clothing,66.66712188720703,2023-10-11,85,0,77.38983154296875,6578.135681152344,2,10,0,41,65593,0
100102,Clothing,66.66712188720703,2023-10-12,144,119,75.87834655761719,19971.963808593748,3,10,0,41,65737,0
100102,Clothing,66.66712188720703,2023-10-13,63,114,68.41284606933593,11945.728604736327,4,10,0,41,65800,0
100102,Clothing,66.66712188720703,2023-10-14,138,217,78.1642172241211,27911.49395385742,5,10,1,41,65938,0
100102,Clothing,66.66712188720703,2023-10-15,123,0,76.09843444824219,9360.107437133789,6,10,1,41,66061,0
100102,Clothing,66.66712188720703,2023-10-16,58,0,76.09843444824219,4413.709197998047,0,10,0,42,66119,0
100102,Clothing,66.66712188720703,2023-10-17,52,95,58.58084732055664,8355.06812133789,1,10,0,42,66171,0
100102,Clothing,66.66712188720703,2023-10-18,117,173,65.7889015197754,19099.002955627442,2,10,0,42,66288,0
100102,Clothing,66.66712188720703,2023-10-19,33,0,65.42780303955078,2159.117500305176,3,10,0,42,66321,0
100102,Clothing,66.66712188720703,2023-10-20,101,135,74.59565093994141,17722.361489868163,4,10,0,42,66422,0
100102,Clothing,66.66712188720703,2023-10-21,60,0,71.13130187988281,4267.878112792969,5,10,1,42,66482,0
100102,Clothing,66.66712188720703,2023-10-22,106,92,68.6733918762207,13612.07907775879,6,10,1,42,66588,0
100102,Clothing,66.66712188720703,2023-10-23,110,170,63.22700988769532,17599.34217529297,0,10,0,43,66698,0
100102,Clothing,66.66712188720703,2023-10-24,61,0,64.96401977539062,3962.805206298828,1,10,0,43,66759,0
100102,Clothing,66.66712188720703,2023-10-25,123,201,77.3727995300293,25295.548684387206,2,10,0,43,66882,0
100102,Clothing,66.66712188720703,2023-10-26,130,120,62.44072387695313,15664.988208007813,3,10,0,43,67012,0
100102,Clothing,66.66712188720703,2023-10-27,68,0,67.92144775390625,4618.658447265625,4,10,0,43,67080,0
100102,Clothing,66.66712188720703,2023-10-28,123,181,79.19175567626954,24240.071896362304,5,10,1,43,67203,0
100102,Clothing,66.66712188720703,2023-10-29,96,0,76.33351135253906,7328.01708984375,6,10,1,43,67299,0
100102,Clothing,66.66712188720703,2023-10-30,85,81,64.91830932617188,10792.15258544922,0,10,0,44,67384,0
100102,Clothing,66.66712188720703,2023-10-31,67,61,56.86917678833008,7307.92968963623,1,10,0,44,67451,0
100102,Clothing,66.66712188720703,2023-11-01,75,99,63.132318038940426,10994.807705841064,2,11,0,44,67526,0
100102,Clothing,66.66712188720703,2023-11-02,42,59,61.44417350769043,6195.930574645996,3,11,0,44,67568,0
100102,Clothing,66.66712188720703,2023-11-03,101,107,57.20535362243652,11888.541431732177,4,11,0,44,67669,0
100102,Clothing,66.66712188720703,2023-11-04,51,97,64.30394203186034,9612.942087249756,5,11,1,44,67720,0
100102,Clothing,66.66712188720703,2023-11-05,104,0,62.2178840637207,6470.659942626953,6,11,1,44,67824,0
100102,Clothing,66.66712188720703,2023-11-06,64,114,67.89557296752929,12147.63333984375,0,11,0,45,67888,0
100102,Clothing,66.66712188720703,2023-11-07,114,140,60.305926666259765,15269.971279907226,1,11,0,45,68002,0
100102,Clothing,66.66712188720703,2023-11-08,20,0,62.14185333251953,1242.8370666503906,2,11,0,45,68022,0
100102,Clothing,66.66712188720703,2023-11-09,101,103,65.01309982299804,13264.786164245605,3,11,0,45,68123,0
100102,Clothing,66.66712188720703,2023-11-10,104,90,64.75664428710937,12558.26201171875,4,11,0,45,68227,0
100102,Clothing,66.66712188720703,2023-11-11,108,103,57.89041549682617,12226.129747314453,5,11,1,45,68335,0
100102,Clothing,66.66712188720703,2023-11-12,103,184,68.94473129272461,19943.08464630127,6,11,1,45,68438,0
100102,Clothing,66.66712188720703,2023-11-13,91,174,74.18254287719726,19864.002803649902,0,11,0,46,68529,0
100102,Clothing,66.66712188720703,2023-11-14,109,0,71.70508575439453,7815.854347229004,1,11,0,46,68638,0
100102,Clothing,66.66712188720703,2023-11-15,117,96,58.81083404541016,12648.945166625977,2,11,0,46,68755,0
100102,Clothing,66.66712188720703,2023-11-16,45,0,64.63166809082031,2908.425064086914,3,11,0,46,68800,0
100102,Clothing,66.66712188720703,2023-11-17,92,115,72.60259384155273,15081.117266845702,4,11,0,46,68892,0
100102,Clothing,66.66712188720703,2023-11-18,95,131,61.90001205444336,13896.882290344238,5,11,1,46,68987,0
100102,Clothing,66.66712188720703,2023-11-19,72,87,64.55193893432617,10264.329206542969,6,11,1,46,69059,0
100102,Clothing,66.66712188720703,2023-11-20,17,0,64.51387786865234,1096.7359237670898,0,11,0,47,69076,0
100102,Clothing,66.66712188720703,2023-11-21,132,187,76.02931335449219,24433.78872558594,1,11,0,47,69208,0
100102,Clothing,66.66712188720703,2023-11-22,133,0,72.74862670898438,9675.567352294922,2,11,0,47,69341,0
100102,Clothing,66.66712188720703,2023-11-23,46,54,63.105091705322266,6279.908436889648,3,11,0,47,69387,0
100102,Clothing,66.66712188720703,2023-11-24,58,79,56.73754493713379,7701.69521270752,4,11,0,47,69445,0
100102,Clothing,66.66712188720703,2023-11-25,86,88,58.2742259979248,10138.366871643066,5,11,1,47,69531,0
100102,Clothing,66.66712188720703,2023-11-26,102,131,73.04880142211914,17134.955490112305,6,11,1,47,69633,0
100102,Clothing,66.66712188720703,2023-11-27,96,118,70.40376907348633,15076.663662109375,0,11,0,48,69729,0
100102,Clothing,66.66712188720703,2023-11-28,66,0,69.93753814697266,4615.877517700195,1,11,0,48,69795,0
100102,Clothing,66.66712188720703,2023-11-29,44,64,59.488297348022456,6340.170166625976,2,11,0,48,69839,0
100102,Clothing,66.66712188720703,2023-11-30,107,189,77.52386108398437,23196.846271972656,3,11,0,48,69946,0
100102,Clothing,66.66712188720703,2023-12-01,97,184,62.89143417358399,17330.458229675292,4,12,0,48,70043,0
100102,Clothing,66.66712188720703,2023-12-02,63,0,66.82286834716797,4209.840705871582,5,12,1,48,70106,0
100102,Clothing,66.66712188720703,2023-12-03,71,0,66.82286834716797,4744.423652648926,6,12,1,48,70177,0
100102,Clothing,66.66712188720703,2023-12-04,142,161,78.18331344604492,23755.60101867676,0,12,0,49,70319,0
100102,Clothing,66.66712188720703,2023-12-05,104,121,72.97270645141602,16407.082941894532,1,12,0,49,70423,0
100102,Clothing,66.66712188720703,2023-12-06,130,113,70.68371826171875,17198.476748046876,2,12,0,49,70553,0
100102,Clothing,66.66712188720703,2023-12-07,151,154,73.57012145996094,22440.506680908205,3,12,0,49,70704,0
100102,Clothing,66.66712188720703,2023-12-08,123,149,72.77913543701172,19793.60731750488,4,12,0,49,70827,0
100102,Clothing,66.66712188720703,2023-12-09,109,0,72.86827087402344,7942.641525268555,5,12,1,49,70936,0
100102,Clothing,66.66712188720703,2023-12-10,81,166,72.06712539672851,17787.224314270017,6,12,1,49,71017,0
100102,Clothing,66.66712188720703,2023-12-11,41,0,72.22425079345703,2961.1942825317383,0,12,0,50,71058,0
100102,Clothing,66.66712188720703,2023-12-12,99,126,69.84039916992188,15692.74903564453,1,12,0,50,71157,0
100102,Clothing,66.66712188720703,2023-12-13,146,152,76.69020126342772,22865.798768920897,2,12,0,50,71303,0
100102,Clothing,66.66712188720703,2023-12-14,78,95,68.20530487060546,11749.617559814453,3,12,0,50,71381,0
100102,Clothing,66.66712188720703,2023-12-15,175,193,82.07812225341797,30266.16278869629,4,12,0,50,71556,0
100102,Clothing,66.66712188720703,2023-12-16,64,0,78.66624450683594,5034.6396484375,5,12,1,50,71620,0
100102,Clothing,66.66712188720703,2023-12-17,88,110,70.7836328125,13951.059375,6,12,1,50,71708,0
100102,Clothing,66.66712188720703,2023-12-18,105,167,79.76947601318359,21814.509962768556,0,12,0,51,71813,0
100102,Clothing,66.66712188720703,2023-12-19,145,0,77.87895202636719,11292.448043823242,1,12,0,51,71958,0
100102,Clothing,66.66712188720703,2023-12-20,68,213,79.67304321289063,22423.933876953124,2,12,0,51,72026,0
100102,Clothing,66.66712188720703,2023-12-21,171,197,80.05079055786132,29464.390370788573,3,12,0,51,72197,0
100102,Clothing,66.66712188720703,2023-12-22,139,0,79.83158111572266,11096.58977508545,4,12,0,51,72336,0
100102,Clothing,66.66712188720703,2023-12-23,88,120,66.13763397216798,13627.743579101563,5,12,1,51,72424,0
100102,Clothing,66.66712188720703,2023-12-24,132,113,63.78317245483399,15671.587528076172,6,12,1,51,72556,0
100102,Clothing,66.66712188720703,2023-12-25,76,69,62.95309616088868,9138.23061645508,0,12,0,52,72632,0
100102,Clothing,66.66712188720703,2023-12-26,106,170,72.1781088256836,20039.67907104492,1,12,0,52,72738,0
100102,Clothing,66.66712188720703,2023-12-27,92,0,70.32621765136719,6470.012023925781,2,12,0,52,72830,0
100102,Clothing,66.66712188720703,2023-12-28,78,177,63.05318557739258,15948.556950073242,3,12,0,52,72908,0
100102,Clothing,66.66712188720703,2023-12-29,177,210,91.58897598266601,35711.27749786377,4,12,0,52,73085,0
100102,Clothing,66.66712188720703,2023-12-30,89,0,83.51795196533203,7433.097724914551,5,12,1,52,73174,0
100102,Clothing,66.66712188720703,2023-12-31,121,149,77.07159851074218,20757.20683959961,6,12,1,52,73295,0
100102,Clothing,66.66712188720703,2024-01-01,108,104,63.670248413085936,13523.573657226563,0,1,0,1,73403,0
100102,Clothing,66.66712188720703,2024-01-02,104,162,76.00573806762695,20324.493518066403,1,1,0,1,73507,0
100102,Clothing,66.66712188720703,2024-01-03,165,127,71.68157485961913,20972.879703674316,2,1,0,1,73672,0
100102,Clothing,66.66712188720703,2024-01-04,120,111,68.16779098510742,15764.469836425782,3,1,0,1,73792,0
100102,Clothing,66.66712188720703,2024-01-05,46,0,70.13558197021484,3226.236770629883,4,1,0,1,73838,0
100102,Clothing,66.66712188720703,2024-01-06,110,157,73.65654388427734,19709.229654541014,5,1,1,1,73948,0
100102,Clothing,66.66712188720703,2024-01-07,142,116,65.3669856262207,16942.083917846678,6,1,1,1,74090,0
100102,Clothing,66.66712188720703,2024-01-08,131,158,75.55631729125977,21892.84513031006,0,1,0,2,74221,0
100102,Clothing,66.66712188720703,2024-01-09,72,0,73.44263458251953,5287.869689941406,1,1,0,2,74293,0
100102,Clothing,66.66712188720703,2024-01-10,86,147,75.92760955810547,17725.43884399414,2,1,0,2,74379,0
100102,Clothing,66.66712188720703,2024-01-11,70,92,68.36074829101562,11006.004760742188,3,1,0,2,74449,0
100102,Clothing,66.66712188720703,2024-01-12,93,115,72.61546401977539,15114.676307678223,4,1,0,2,74542,0
100102,Clothing,66.66712188720703,2024-01-13,89,0,72.13092803955078,6419.6525955200195,5,1,1,2,74631,0
100102,Clothing,66.66712188720703,2024-01-14,102,111,68.24374557495116,14524.904097290038,6,1,1,2,74733,0
100102,Clothing,66.66712188720703,2024-01-15,111,104,59.736141967773435,12866.973516845705,0,1,0,3,74844,0
100102,Clothing,66.66712188720703,2024-01-16,104,179,65.17737991333007,18479.895021972654,1,1,0,3,74948,0
100102,Clothing,66.66712188720703,2024-01-17,74,95,65.54651794433593,11085.834655761719,2,1,0,3,75022,0
100102,Clothing,66.66712188720703,2024-01-18,149,136,71.23756805419922,20269.135280151364,3,1,0,3,75171,0
100102,Clothing,66.66712188720703,2024-01-19,42,0,68.65513610839844,2883.5157165527344,4,1,0,3,75213,0
100102,Clothing,66.66712188720703,2024-01-20,139,139,62.22439361572266,17298.381425170897,5,1,1,3,75352,0
100102,Clothing,66.66712188720703,2024-01-21,84,137,69.191728515625,15378.730390625,6,1,1,3,75436,0
100102,Clothing,66.66712188720703,2024-01-22,137,165,74.04276107788087,22429.156535339356,0,1,0,4,75573,0
100102,Clothing,66.66712188720703,2024-01-23,84,0,71.60552215576172,6014.863861083984,1,1,0,4,75657,0
100102,Clothing,66.66712188720703,2024-01-24,135,157,67.12519287109376,19569.862075195313,2,1,0,4,75792,0
100102,Clothing,66.66712188720703,2024-01-25,97,0,68.5203857421875,6646.4774169921875,3,1,0,4,75889,0
100102,Clothing,66.66712188720703,2024-01-26,67,156,71.34981231689453,15955.524850463866,4,1,0,4,75956,0
100102,Clothing,66.66712188720703,2024-01-27,78,132,60.539482574462895,12506.499281616212,5,1,1,4,76034,0
100102,Clothing,66.66712188720703,2024-01-28,99,0,64.36896514892578,6372.527549743652,6,1,1,4,76133,0
100102,Clothing,66.66712188720703,2024-01-29,42,67,62.46335678100586,6786.921969604492,0,1,0,5,76175,0
100102,Clothing,66.66712188720703,2024-01-30,77,117,68.60856094360352,13387.718385314942,1,1,0,5,76252,0
100103,Clothing,62.73246383666992,2022-01-01,114,859,62.940001220703124,61240.62027832031,5,1,1,52,114,0
100103,Clothing,62.73246383666992,2022-01-02,130,0,62.94000244140625,8182.2003173828125,6,1,1,52,244,0
100103,Clothing,62.73246383666992,2022-01-03,3,0,62.94000244140625,188.82000732421875,0,1,0,1,247,0
100103,Clothing,62.73246383666992,2022-01-05,156,0,62.94000244140625,9818.640380859375,2,1,0,1,403,0
100103,Clothing,62.73246383666992,2022-01-06,97,442,62.87285118103027,33880.58312911987,3,1,0,1,500,0
100103,Clothing,62.73246383666992,2022-01-07,51,0,62.89570236206055,3207.680820465088,4,1,0,1,551,0
100103,Clothing,62.73246383666992,2022-01-08,109,0,62.89570236206055,6855.6315574646,5,1,1,1,660,0
100103,Clothing,62.73246383666992,2022-01-09,165,526,65.44484909057617,45570.81019989013,6,1,1,1,825,0
100103,Clothing,62.73246383666992,2022-01-10,109,0,64.47969818115234,7028.2871017456055,0,1,0,2,934,0
100103,Clothing,62.73246383666992,2022-01-11,89,0,64.47969818115234,5738.693138122559,1,1,0,2,1023,0
100103,Clothing,62.73246383666992,2022-01-12,149,0,64.47969818115234,9607.4750289917,2,1,0,2,1172,0
100103,Clothing,62.73246383666992,2022-01-13,200,895,59.17980659484863,63815.12263793945,3,1,0,2,1372,0
100103,Clothing,62.73246383666992,2022-01-14,90,0,60.599613189697266,5453.965187072754,4,1,0,2,1462,0
100103,Clothing,62.73246383666992,2022-01-15,190,0,60.599613189697266,11513.92650604248,5,1,1,2,1652,0
100103,Clothing,62.73246383666992,2022-01-16,81,0,60.599613189697266,4908.5686683654785,6,1,1,2,1733,0
100103,Clothing,62.73246383666992,2022-01-17,236,0,60.599613189697266,14301.508712768555,0,1,0,3,1969,0
100103,Clothing,62.73246383666992,2022-01-18,146,0,60.599613189697266,8847.5435256958,1,1,0,3,2115,0
100103,Clothing,62.73246383666992,2022-01-19,103,577,65.03958526611328,44952.334564819335,2,1,0,3,2218,0
100103,Clothing,62.73246383666992,2022-01-20,76,0,63.50917053222656,4826.696960449219,3,1,0,3,2294,0
100103,Clothing,62.73246383666992,2022-01-21,153,0,63.50917053222656,9716.903091430664,4,1,0,3,2447,0
100103,Clothing,62.73246383666992,2022-01-22,133,1005,61.49084312438965,69452.64427108764,5,1,1,3,2580,0
100103,Clothing,62.73246383666992,2022-01-23,151,0,62.0916862487793,9375.844623565674,6,1,1,3,2731,0
100103,Clothing,62.73246383666992,2022-01-24,77,0,62.0916862487793,4781.059841156006,0,1,0,4,2808,0
100103,Clothing,62.73246383666992,2022-01-25,96,0,62.0916862487793,5960.8018798828125,1,1,0,4,2904,0
100103,Clothing,62.73246383666992,2022-01-26,151,0,62.0916862487793,9375.844623565674,2,1,0,4,3055,0
100103,Clothing,62.73246383666992,2022-01-27,115,0,62.0916862487793,7140.543918609619,3,1,0,4,3170,0
100103,Clothing,62.73246383666992,2022-01-28,141,0,62.0916862487793,8754.92776107788,4,1,0,4,3311,0
100103,Clothing,62.73246383666992,2022-01-29,108,0,62.0916862487793,6705.902114868164,5,1,1,4,3419,0
100103,Clothing,62.73246383666992,2022-01-30,83,0,62.0916862487793,5153.609958648682,6,1,1,4,3502,0
100103,Clothing,62.73246383666992,2022-01-31,107,0,62.0916862487793,6643.810428619385,0,1,0,5,3609,0
100103,Clothing,62.73246383666992,2022-02-01,184,674,67.78366790771484,59107.18979003906,1,2,0,5,3793,0
100103,Clothing,62.73246383666992,2022-02-02,80,0,65.84733581542969,5267.786865234375,2,2,0,5,3873,0
100103,Clothing,62.73246383666992,2022-02-03,49,0,65.84733581542969,3226.5194549560547,3,2,0,5,3922,0
100103,Clothing,62.73246383666992,2022-02-04,103,0,65.84733581542969,6782.275588989258,4,2,0,5,4025,0
100103,Clothing,62.73246383666992,2022-02-05,149,0,65.84733581542969,9811.253036499023,5,2,1,5,4174,0
100103,Clothing,62.73246383666992,2022-02-06,141,0,65.84733581542969,9284.474349975586,6,2,1,5,4315,0
100103,Clothing,62.73246383666992,2022-02-07,166,587,66.67227111816406,50329.56401123047,0,2,0,6,4481,0
100103,Clothing,62.73246383666992,2022-02-08,170,0,66.37454223632812,11283.672180175781,1,2,0,6,4651,0
100103,Clothing,62.73246383666992,2022-02-09,316,1035,70.59674102783202,96306.05032958984,2,2,0,6,4967,0
100103,Clothing,62.73246383666992,2022-02-10,11,0,69.30348205566406,762.3383026123047,3,2,0,6,4978,0
100103,Clothing,62.73246383666992,2022-02-11,107,0,69.30348205566406,7415.472579956055,4,2,0,6,5085,0
100103,Clothing,62.73246383666992,2022-02-12,84,0,69.30348205566406,5821.492492675781,5,2,1,6,5169,0
100103,Clothing,62.73246383666992,2022-02-13,131,0,69.30348205566406,9078.756149291992,6,2,1,6,5300,0
100103,Clothing,62.73246383666992,2022-02-14,52,0,69.30348205566406,3603.7810668945312,0,2,0,7,5352,0
100103,Clothing,62.73246383666992,2022-02-15,210,0,69.30348205566406,14553.731231689453,1,2,0,7,5562,0
100103,Clothing,62.73246383666992,2022-02-16,106,0,69.30348205566406,7346.169097900391,2,2,0,7,5668,0
100103,Clothing,62.73246383666992,2022-02-17,126,0,69.30348205566406,8732.238739013672,3,2,0,7,5794,0
100103,Clothing,62.73246383666992,2022-02-18,87,0,69.30348205566406,6029.402938842773,4,2,0,7,5881,0
100103,Clothing,62.73246383666992,2022-02-19,89,0,69.30348205566406,6168.009902954102,5,2,1,7,5970,0
100103,Clothing,62.73246383666992,2022-02-20,220,763,66.92500900268556,65409.893961181646,6,2,1,7,6190,0
100103,Clothing,62.73246383666992,2022-02-21,93,0,67.6200180053711,6288.661674499512,0,2,0,8,6283,0
100103,Clothing,62.73246383666992,2022-02-22,76,0,67.6200180053711,5139.121368408203,1,2,0,8,6359,0
100103,Clothing,62.73246383666992,2022-02-23,134,0,67.6200180053711,9061.082412719727,2,2,0,8,6493,0
100103,Clothing,62.73246383666992,2022-02-24,45,0,67.6200180053711,3042.900810241699,3,2,0,8,6538,0
100103,Clothing,62.73246383666992,2022-02-25,141,0,67.6200180053711,9534.422538757324,4,2,0,8,6679,0
100103,Clothing,62.73246383666992,2022-02-26,104,0,67.6200180053711,7032.481872558594,5,2,1,8,6783,0
100103,Clothing,62.73246383666992,2022-02-27,107,0,67.6200180053711,7235.341926574707,6,2,1,8,6890,0
100103,Clothing,62.73246383666992,2022-02-28,95,615,57.68061920166016,39517.71764831543,0,2,0,9,6985,0
100103,Clothing,62.73246383666992,2022-03-01,97,0,60.44123840332031,5862.80012512207,1,3,0,9,7082,0
100103,Clothing,62.73246383666992,2022-03-02,100,0,60.44123840332031,6044.123840332031,2,3,0,9,7182,0
100103,Clothing,62.73246383666992,2022-03-03,181,0,60.44123840332031,10939.864151000977,3,3,0,9,7363,0
100103,Clothing,62.73246383666992,2022-03-04,32,0,60.44123840332031,1934.11962890625,4,3,0,9,7395,0
100103,Clothing,62.73246383666992,2022-03-05,57,0,60.44123840332031,3445.150588989258,5,3,1,9,7452,0
100103,Clothing,62.73246383666992,2022-03-06,92,615,63.20279182434082,45117.00369567871,6,3,1,9,7544,0
100103,Clothing,62.73246383666992,2022-03-07,162,0,62.37558364868164,10104.844551086426,0,3,0,10,7706,0
100103,Clothing,62.73246383666992,2022-03-08,171,0,62.37558364868164,10666.22480392456,1,3,0,10,7877,0
100103,Clothing,62.73246383666992,2022-03-09,38,0,62.37558364868164,2370.2721786499023,2,3,0,10,7915,0
100103,Clothing,62.73246383666992,2022-03-10,149,1075,66.42029983520507,82196.38935089111,3,3,0,10,8064,0
100103,Clothing,62.73246383666992,2022-03-11,103,0,65.45059967041016,6741.411766052246,4,3,0,10,8167,0
100103,Clothing,62.73246383666992,2022-03-12,169,0,65.45059967041016,11061.151344299316,5,3,1,10,8336,0
100103,Clothing,62.73246383666992,2022-03-13,98,0,65.45059967041016,6414.158767700195,6,3,1,10,8434,0
100103,Clothing,62.73246383666992,2022-03-14,132,0,65.45059967041016,8639.47915649414,0,3,0,11,8566,0
100103,Clothing,62.73246383666992,2022-03-15,159,0,65.45059967041016,10406.645347595215,1,3,0,11,8725,0
100103,Clothing,62.73246383666992,2022-03-16,131,0,65.45059967041016,8574.02855682373,2,3,0,11,8856,0
100103,Clothing,62.73246383666992,2022-03-17,123,0,65.45059967041016,8050.423759460449,3,3,0,11,8979,0
100103,Clothing,62.73246383666992,2022-03-18,73,0,65.45059967041016,4777.893775939941,4,3,0,11,9052,0
100103,Clothing,62.73246383666992,2022-03-19,84,0,65.45059967041016,5497.850372314453,5,3,1,11,9136,0
100103,Clothing,62.73246383666992,2022-03-20,215,889,61.56489082336426,67364.48305404664,6,3,1,11,9351,0
100103,Clothing,62.73246383666992,2022-03-21,155,0,62.459781646728516,9681.26615524292,0,3,0,12,9506,0
100103,Clothing,62.73246383666992,2022-03-22,69,0,62.459781646728516,4309.724933624268,1,3,0,12,9575,0
100103,Clothing,62.73246383666992,2022-03-23,93,0,62.459781646728516,5808.759693145752,2,3,0,12,9668,0
100103,Clothing,62.73246383666992,2022-03-24,125,0,62.459781646728516,7807.472705841064,3,3,0,12,9793,0
100103,Clothing,62.73246383666992,2022-03-25,85,0,62.459781646728516,5309.081439971924,4,3,0,12,9878,0
100103,Clothing,62.73246383666992,2022-03-26,93,0,62.459781646728516,5808.759693145752,5,3,1,12,9971,0
100103,Clothing,62.73246383666992,2022-03-27,63,0,62.459781646728516,3934.9662437438965,6,3,1,12,10034,0
100103,Clothing,62.73246383666992,2022-03-28,125,491,56.50821754455566,34052.09438613891,0,3,0,13,10159,0
100103,Clothing,62.73246383666992,2022-03-29,165,0,58.57643508911133,9665.11178970337,1,3,0,13,10324,0
100103,Clothing,62.73246383666992,2022-03-30,115,711,65.7872689819336,55790.191865844725,2,3,0,13,10439,0
100103,Clothing,62.73246383666992,2022-03-31,59,0,63.35453796386719,3737.917739868164,3,3,0,13,10498,0
100103,Clothing,62.73246383666992,2022-04-01,63,0,63.35453796386719,3991.335891723633,4,4,0,13,10561,0
100103,Clothing,62.73246383666992,2022-04-02,90,0,63.35453796386719,5701.908416748047,5,4,1,13,10651,0
100103,Clothing,62.73246383666992,2022-04-03,160,0,63.35453796386719,10136.72607421875,6,4,1,13,10811,0
100103,Clothing,62.73246383666992,2022-04-04,143,0,63.35453796386719,9059.698928833008,0,4,0,14,10954,0
100103,Clothing,62.73246383666992,2022-04-05,52,0,63.35453796386719,3294.4359741210938,1,4,0,14,11006,0
100103,Clothing,62.73246383666992,2022-04-06,96,0,63.35453796386719,6082.03564453125,2,4,0,14,11102,0
100103,Clothing,62.73246383666992,2022-04-07,224,865,76.20345413208008,85252.48745117187,3,4,0,14,11326,0
100103,Clothing,62.73246383666992,2022-04-08,101,0,72.66690826416016,7339.357734680176,4,4,0,14,11427,0
100103,Clothing,62.73246383666992,2022-04-09,166,0,72.66690826416016,12062.706771850586,5,4,1,14,11593,0
100103,Clothing,62.73246383666992,2022-04-10,121,0,72.66690826416016,8792.695899963379,6,4,1,14,11714,0
100103,Clothing,62.73246383666992,2022-04-11,116,0,72.66690826416016,8429.361358642578,0,4,0,15,11830,0
100103,Clothing,62.73246383666992,2022-04-12,140,0,72.66690826416016,10173.367156982422,1,4,0,15,11970,0
100103,Clothing,62.73246383666992,2022-04-13,158,537,65.66864562988282,44635.872019042974,2,4,0,15,12128,0
100103,Clothing,62.73246383666992,2022-04-14,110,0,68.31729125976562,7514.902038574219,3,4,0,15,12238,0
100103,Clothing,62.73246383666992,2022-04-15,91,0,68.31729125976562,6216.873504638672,4,4,0,15,12329,0
100103,Clothing,62.73246383666992,2022-04-16,89,0,68.31729125976562,6080.238922119141,5,4,1,15,12418,0
100103,Clothing,62.73246383666992,2022-04-17,134,0,68.31729125976562,9154.517028808594,6,4,1,15,12552,0
100103,Clothing,62.73246383666992,2022-04-18,121,0,68.31729125976562,8266.39224243164,0,4,0,16,12673,0
100103,Clothing,62.73246383666992,2022-04-19,82,0,68.31729125976562,5602.017883300781,1,4,0,16,12755,0
100103,Clothing,62.73246383666992,2022-04-20,147,663,67.1691390991211,54268.126895141606,2,4,0,16,12902,0
100103,Clothing,62.73246383666992,2022-04-21,100,0,67.43827819824219,6743.827819824219,3,4,0,16,13002,0
100103,Clothing,62.73246383666992,2022-04-22,106,0,67.43827819824219,7148.457489013672,4,4,0,16,13108,0
100103,Clothing,62.73246383666992,2022-04-23,53,622,57.126834564208984,36417.28446380615,5,4,1,16,13161,0
100103,Clothing,62.73246383666992,2022-04-24,49,0,60.89366912841797,2983.7897872924805,6,4,1,16,13210,0
100103,Clothing,62.73246383666992,2022-04-25,80,0,60.89366912841797,4871.4935302734375,0,4,0,17,13290,0
100103,Clothing,62.73246383666992,2022-04-26,133,0,60.89366912841797,8098.85799407959,1,4,0,17,13423,0
100103,Clothing,62.73246383666992,2022-04-27,47,0,60.89366912841797,2862.0024490356445,2,4,0,17,13470,0
100103,Clothing,62.73246383666992,2022-04-28,171,0,60.89366912841797,10412.817420959473,3,4,0,17,13641,0
100103,Clothing,62.73246383666992,2022-04-29,113,0,60.89366912841797,6880.9846115112305,4,4,0,17,13754,0
100103,Clothing,62.73246383666992,2022-04-30,100,0,60.89366912841797,6089.366912841797,5,4,1,17,13854,0
100103,Clothing,62.73246383666992,2022-05-01,88,0,60.89366912841797,5358.642883300781,6,5,1,17,13942,0
100103,Clothing,62.73246383666992,2022-05-02,108,590,60.39826774597168,42086.52583312988,0,5,0,18,14050,0
100103,Clothing,62.73246383666992,2022-05-03,56,0,60.54653549194336,3390.605987548828,1,5,0,18,14106,0
100103,Clothing,62.73246383666992,2022-05-04,158,0,60.54653549194336,9566.35260772705,2,5,0,18,14264,0
100103,Clothing,62.73246383666992,2022-05-05,88,0,60.54653549194336,5328.095123291016,3,5,0,18,14352,0
100103,Clothing,62.73246383666992,2022-05-06,92,0,60.54653549194336,5570.281265258789,4,5,0,18,14444,0
100103,Clothing,62.73246383666992,2022-05-07,141,0,60.54653549194336,8537.061504364014,5,5,1,18,14585,0
100103,Clothing,62.73246383666992,2022-05-08,91,0,60.54653549194336,5509.734729766846,6,5,1,18,14676,0
100103,Clothing,62.73246383666992,2022-05-09,105,513,57.080316390991214,34908.30644210815,0,5,0,19,14781,0
100103,Clothing,62.73246383666992,2022-05-10,122,0,57.98063278198242,7073.6371994018555,1,5,0,19,14903,0
100103,Clothing,62.73246383666992,2022-05-11,133,505,57.93701454162598,36957.485868072516,2,5,0,19,15036,0
100103,Clothing,62.73246383666992,2022-05-13,74,0,57.95402908325195,4288.5981521606445,4,5,0,19,15110,0
100103,Clothing,62.73246383666992,2022-05-14,127,0,57.95402908325195,7360.161693572998,5,5,1,19,15237,0
100103,Clothing,62.73246383666992,2022-05-15,220,646,56.069890899658205,48245.59199584961,6,5,1,19,15457,0
100103,Clothing,62.73246383666992,2022-05-16,105,0,56.799781799316406,5963.977088928223,0,5,0,20,15562,0
100103,Clothing,62.73246383666992,2022-05-17,116,0,56.799781799316406,6588.774688720703,1,5,0,20,15678,0
100103,Clothing,62.73246383666992,2022-05-18,75,0,56.799781799316406,4259.9836349487305,2,5,0,20,15753,0
100103,Clothing,62.73246383666992,2022-05-19,132,0,56.799781799316406,7497.571197509766,3,5,0,20,15885,0
100103,Clothing,62.73246383666992,2022-05-20,74,0,56.799781799316406,4203.183853149414,4,5,0,20,15959,0
100103,Clothing,62.73246383666992,2022-05-21,51,0,56.799781799316406,2896.7888717651367,5,5,1,20,16010,0
100103,Clothing,62.73246383666992,2022-05-22,161,703,61.73525016784668,54219.87055404663,6,5,1,20,16171,0
100103,Clothing,62.73246383666992,2022-05-23,58,0,60.11050033569336,3486.409019470215,0,5,0,21,16229,0
100103,Clothing,62.73246383666992,2022-05-24,67,0,60.11050033569336,4027.403522491455,1,5,0,21,16296,0
100103,Clothing,62.73246383666992,2022-05-25,56,0,60.11050033569336,3366.188018798828,2,5,0,21,16352,0
100103,Clothing,62.73246383666992,2022-05-26,61,0,60.11050033569336,3666.740520477295,3,5,0,21,16413,0
100103,Clothing,62.73246383666992,2022-05-27,131,0,60.11050033569336,7874.47554397583,4,5,0,21,16544,0
100103,Clothing,62.73246383666992,2022-05-28,88,0,60.11050033569336,5289.724029541016,5,5,1,21,16632,0
100103,Clothing,62.73246383666992,2022-05-29,121,0,60.11050033569336,7273.3705406188965,6,5,1,21,16753,0
100103,Clothing,62.73246383666992,2022-05-30,113,0,60.11050033569336,6792.48653793335,0,5,0,22,16866,0
100103,Clothing,62.73246383666992,2022-05-31,97,498,61.287650680541994,36631.50423202515,1,5,0,22,16963,0
100103,Clothing,62.73246383666992,2022-06-01,57,0,60.875301361083984,3469.892177581787,2,6,0,22,17020,0
100103,Clothing,62.73246383666992,2022-06-02,155,0,60.875301361083984,9435.671710968018,3,6,0,22,17175,0
100103,Clothing,62.73246383666992,2022-06-03,70,0,60.875301361083984,4261.271095275879,4,6,0,22,17245,0
100103,Clothing,62.73246383666992,2022-06-04,74,0,60.875301361083984,4504.772300720215,5,6,1,22,17319,0
100103,Clothing,62.73246383666992,2022-06-05,63,0,60.875301361083984,3835.143985748291,6,6,1,22,17382,0
100103,Clothing,62.73246383666992,2022-06-06,115,0,60.875301361083984,7000.659656524658,0,6,0,23,17497,0
100103,Clothing,62.73246383666992,2022-06-07,91,470,61.43250732421875,34527.11633300781,1,6,0,23,17588,0
100103,Clothing,62.73246383666992,2022-06-08,151,0,61.2650146484375,9251.017211914062,2,6,0,23,17739,0
100103,Clothing,62.73246383666992,2022-06-09,104,0,61.2650146484375,6371.5615234375,3,6,0,23,17843,0
100103,Clothing,62.73246383666992,2022-06-10,58,0,61.2650146484375,3553.370849609375,4,6,0,23,17901,0
100103,Clothing,62.73246383666992,2022-06-11,163,601,51.74584403991699,38361.80515701294,5,6,1,23,18064,0
100103,Clothing,62.73246383666992,2022-06-12,110,0,54.421688079833984,5986.385688781738,6,6,1,23,18174,0
100103,Clothing,62.73246383666992,2022-06-13,105,0,54.421688079833984,5714.277248382568,0,6,0,24,18279,0
100103,Clothing,62.73246383666992,2022-06-14,92,0,54.421688079833984,5006.795303344727,1,6,0,24,18371,0
100103,Clothing,62.73246383666992,2022-06-15,59,0,54.421688079833984,3210.879596710205,2,6,0,24,18430,0
100103,Clothing,62.73246383666992,2022-06-16,99,628,52.46103149414063,37826.514235839844,3,6,0,24,18529,0
100103,Clothing,62.73246383666992,2022-06-17,64,0,53.05206298828125,3395.33203125,4,6,0,24,18593,0
100103,Clothing,62.73246383666992,2022-06-18,138,0,53.05206298828125,7321.1846923828125,5,6,1,24,18731,0
100103,Clothing,62.73246383666992,2022-06-19,108,0,53.05206298828125,5729.622802734375,6,6,1,24,18839,0
100103,Clothing,62.73246383666992,2022-06-20,155,0,53.05206298828125,8223.069763183594,0,6,0,25,18994,0
100103,Clothing,62.73246383666992,2022-06-21,102,0,53.05206298828125,5411.3104248046875,1,6,0,25,19096,0
100103,Clothing,62.73246383666992,2022-06-22,75,433,54.79777976989746,28067.18696548462,2,6,0,25,19171,0
100103,Clothing,62.73246383666992,2022-06-23,111,0,54.15555953979492,6011.267108917236,3,6,0,25,19282,0
100103,Clothing,62.73246383666992,2022-06-24,102,0,54.15555953979492,5523.867073059082,4,6,0,25,19384,0
100103,Clothing,62.73246383666992,2022-06-25,44,0,54.15555953979492,2382.8446197509766,5,6,1,25,19428,0
100103,Clothing,62.73246383666992,2022-06-26,258,1082,68.7756494140625,94791.51509765624,6,6,1,25,19686,0
100103,Clothing,62.73246383666992,2022-06-27,68,0,65.581298828125,4459.5283203125,0,6,0,26,19754,0
100103,Clothing,62.73246383666992,2022-06-28,130,0,65.581298828125,8525.56884765625,1,6,0,26,19884,0
100103,Clothing,62.73246383666992,2022-06-29,54,0,65.581298828125,3541.39013671875,2,6,0,26,19938,0
100103,Clothing,62.73246383666992,2022-06-30,106,0,65.581298828125,6951.61767578125,3,6,0,26,20044,0
100103,Clothing,62.73246383666992,2022-07-01,77,0,65.581298828125,5049.760009765625,4,7,0,26,20121,0
100103,Clothing,62.73246383666992,2022-07-02,36,0,65.581298828125,2360.9267578125,5,7,1,26,20157,0
100103,Clothing,62.73246383666992,2022-07-03,27,0,65.581298828125,1770.695068359375,6,7,1,26,20184,0
100103,Clothing,62.73246383666992,2022-07-04,62,0,65.581298828125,4066.04052734375,0,7,0,27,20246,0
100103,Clothing,62.73246383666992,2022-07-05,85,0,65.581298828125,5574.410400390625,1,7,0,27,20331,0
100103,Clothing,62.73246383666992,2022-07-06,73,0,65.581298828125,4787.434814453125,2,7,0,27,20404,0
100103,Clothing,62.73246383666992,2022-07-07,91,0,65.581298828125,5967.898193359375,3,7,0,27,20495,0
100103,Clothing,62.73246383666992,2022-07-08,83,535,61.1248942565918,37036.21244659424,4,7,0,27,20578,0
100103,Clothing,62.73246383666992,2022-07-09,75,0,62.759788513183594,4706.9841384887695,5,7,1,27,20653,0
100103,Clothing,62.73246383666992,2022-07-10,101,0,62.759788513183594,6338.738639831543,6,7,1,27,20754,0
100103,Clothing,62.73246383666992,2022-07-11,120,0,62.759788513183594,7531.174621582031,0,7,0,28,20874,0
100103,Clothing,62.73246383666992,2022-07-12,52,0,62.759788513183594,3263.509002685547,1,7,0,28,20926,0
100103,Clothing,62.73246383666992,2022-07-13,90,0,62.759788513183594,5648.380966186523,2,7,0,28,21016,0
100103,Clothing,62.73246383666992,2022-07-14,142,524,61.786765060424806,41009.881277160646,3,7,0,28,21158,0
100103,Clothing,62.73246383666992,2022-07-15,111,0,62.15353012084961,6899.041843414307,4,7,0,28,21269,0
100103,Clothing,62.73246383666992,2022-07-16,141,0,62.15353012084961,8763.647747039795,5,7,1,28,21410,0
100103,Clothing,62.73246383666992,2022-07-17,78,0,62.15353012084961,4847.9753494262695,6,7,1,28,21488,0
100103,Clothing,62.73246383666992,2022-07-18,62,0,62.15353012084961,3853.518867492676,0,7,0,29,21550,0
100103,Clothing,62.73246383666992,2022-07-19,161,669,58.835329666137696,48297.21615249634,1,7,0,29,21711,0
100103,Clothing,62.73246383666992,2022-07-20,148,0,59.89065933227539,8863.817581176758,2,7,0,29,21859,0
100103,Clothing,62.73246383666992,2022-07-21,137,0,59.89065933227539,8205.020328521729,3,7,0,29,21996,0
100103,Clothing,62.73246383666992,2022-07-22,91,0,59.89065933227539,5450.049999237061,4,7,0,29,22087,0
100103,Clothing,62.73246383666992,2022-07-23,184,590,63.72334991455078,49929.51276855469,5,7,1,29,22271,0
100103,Clothing,62.73246383666992,2022-07-24,120,0,62.22669982910156,7467.2039794921875,6,7,1,29,22391,0
100103,Clothing,62.73246383666992,2022-07-25,99,0,62.22669982910156,6160.443283081055,0,7,0,30,22490,0
100103,Clothing,62.73246383666992,2022-07-26,104,0,62.22669982910156,6471.5767822265625,1,7,0,30,22594,0
100103,Clothing,62.73246383666992,2022-07-27,69,0,62.22669982910156,4293.642288208008,2,7,0,30,22663,0
100103,Clothing,62.73246383666992,2022-07-28,84,0,62.22669982910156,5227.042785644531,3,7,0,30,22747,0
100103,Clothing,62.73246383666992,2022-07-29,63,0,62.22669982910156,3920.2820892333984,4,7,0,30,22810,0
100103,Clothing,62.73246383666992,2022-07-30,72,0,62.22669982910156,4480.3223876953125,5,7,1,30,22882,0
100103,Clothing,62.73246383666992,2022-07-31,154,508,61.82222351074219,40875.964841308596,6,7,1,30,23036,0
100103,Clothing,62.73246383666992,2022-08-01,67,0,61.964447021484375,4151.617950439453,0,8,0,31,23103,0
100103,Clothing,62.73246383666992,2022-08-02,133,0,61.964447021484375,8241.271453857422,1,8,0,31,23236,0
100103,Clothing,62.73246383666992,2022-08-03,97,0,61.964447021484375,6010.551361083984,2,8,0,31,23333,0
100103,Clothing,62.73246383666992,2022-08-04,145,587,62.22954956054687,45592.0093725586,3,8,0,31,23478,0
100103,Clothing,62.73246383666992,2022-08-05,210,0,62.13909912109375,13049.210815429688,4,8,0,31,23688,0
100103,Clothing,62.73246383666992,2022-08-06,125,0,62.13909912109375,7767.387390136719,5,8,1,31,23813,0
100103,Clothing,62.73246383666992,2022-08-07,122,0,62.13909912109375,7580.9700927734375,6,8,1,31,23935,0
100103,Clothing,62.73246383666992,2022-08-08,68,0,62.13909912109375,4225.458740234375,0,8,0,32,24003,0
100103,Clothing,62.73246383666992,2022-08-09,94,457,59.179697799682614,32216.083186340333,1,8,0,32,24097,0
100103,Clothing,62.73246383666992,2022-08-10,96,0,60.259395599365234,5784.9019775390625,2,8,0,32,24193,0
100103,Clothing,62.73246383666992,2022-08-11,60,0,60.259395599365234,3615.563735961914,3,8,0,32,24253,0
100103,Clothing,62.73246383666992,2022-08-12,98,0,60.259395599365234,5905.420768737793,4,8,0,32,24351,0
100103,Clothing,62.73246383666992,2022-08-13,101,0,60.259395599365234,6086.198955535889,5,8,1,32,24452,0
100103,Clothing,62.73246383666992,2022-08-14,95,446,54.568569869995116,28774.46827529907,6,8,1,32,24547,0
100103,Clothing,62.73246383666992,2022-08-15,77,0,56.697139739990234,4365.679759979248,0,8,0,33,24624,0
100103,Clothing,62.73246383666992,2022-08-16,136,0,56.697139739990234,7710.811004638672,1,8,0,33,24760,0
100103,Clothing,62.73246383666992,2022-08-17,106,533,54.001369934082035,34062.21042602539,2,8,0,33,24866,0
100103,Clothing,62.73246383666992,2022-08-18,118,0,55.04273986816406,6495.043304443359,3,8,0,33,24984,0
100103,Clothing,62.73246383666992,2022-08-19,72,0,55.04273986816406,3963.0772705078125,4,8,0,33,25056,0
100103,Clothing,62.73246383666992,2022-08-20,103,0,55.04273986816406,5669.402206420898,5,8,1,33,25159,0
100103,Clothing,62.73246383666992,2022-08-21,55,0,55.04273986816406,3027.3506927490234,6,8,1,33,25214,0
100103,Clothing,62.73246383666992,2022-08-22,110,0,55.04273986816406,6054.701385498047,0,8,0,34,25324,0
100103,Clothing,62.73246383666992,2022-08-23,70,0,55.04273986816406,3852.9917907714844,1,8,0,34,25394,0
100103,Clothing,62.73246383666992,2022-08-24,70,0,55.04273986816406,3852.9917907714844,2,8,0,34,25464,0
100103,Clothing,62.73246383666992,2022-08-25,118,506,53.958533096313474,33531.013810729986,3,8,0,34,25582,0
100103,Clothing,62.73246383666992,2022-08-26,80,0,54.31706619262695,4345.365295410156,4,8,0,34,25662,0
100103,Clothing,62.73246383666992,2022-08-27,144,0,54.31706619262695,7821.657531738281,5,8,1,34,25806,0
100103,Clothing,62.73246383666992,2022-08-28,158,671,55.378618469238276,46089.13343627929,6,8,1,34,25964,0
100103,Clothing,62.73246383666992,2022-08-29,65,0,55.02723693847656,3576.7704010009766,0,8,0,35,26029,0
100103,Clothing,62.73246383666992,2022-08-30,95,0,55.02723693847656,5227.587509155273,1,8,0,35,26124,0
100103,Clothing,62.73246383666992,2022-08-31,196,0,55.02723693847656,10785.338439941406,2,8,0,35,26320,0
100103,Clothing,62.73246383666992,2022-09-01,88,0,55.02723693847656,4842.3968505859375,3,9,0,35,26408,0
100103,Clothing,62.73246383666992,2022-09-02,150,0,55.02723693847656,8254.085540771484,4,9,0,35,26558,0
100103,Clothing,62.73246383666992,2022-09-03,341,1301,66.00970817565917,110317.82097579955,5,9,1,35,26899,0
100103,Clothing,62.73246383666992,2022-09-04,88,0,63.99941635131836,5631.948638916016,6,9,1,35,26987,0
100103,Clothing,62.73246383666992,2022-09-05,63,0,63.99941635131836,4031.9632301330566,0,9,0,36,27050,0
100103,Clothing,62.73246383666992,2022-09-06,58,0,63.99941635131836,3711.966148376465,1,9,0,36,27108,0
100103,Clothing,62.73246383666992,2022-09-07,85,0,63.99941635131836,5439.950389862061,2,9,0,36,27193,0
100103,Clothing,62.73246383666992,2022-09-08,239,0,63.99941635131836,15295.860507965088,3,9,0,36,27432,0
100103,Clothing,62.73246383666992,2022-09-09,134,0,63.99941635131836,8575.92179107666,4,9,0,36,27566,0
100103,Clothing,62.73246383666992,2022-09-10,133,0,63.99941635131836,8511.922374725342,5,9,1,36,27699,0
100103,Clothing,62.73246383666992,2022-09-11,128,0,63.99941635131836,8191.92529296875,6,9,1,36,27827,0
100103,Clothing,62.73246383666992,2022-09-12,96,0,63.99941635131836,6143.9439697265625,0,9,0,37,27923,0
100103,Clothing,62.73246383666992,2022-09-13,96,0,63.99941635131836,6143.9439697265625,1,9,0,37,28019,0
100103,Clothing,62.73246383666992,2022-09-14,55,0,63.99941635131836,3519.9678993225098,2,9,0,37,28074,0
100103,Clothing,62.73246383666992,2022-09-15,98,282,55.86992652893066,20639.94559967041,3,9,0,37,28172,0
100103,Clothing,62.73246383666992,2022-09-16,125,0,59.07985305786133,7384.981632232666,4,9,0,37,28297,0
100103,Clothing,62.73246383666992,2022-09-17,145,478,60.615783615112306,37921.54724838257,5,9,1,37,28442,0
100103,Clothing,62.73246383666992,2022-09-18,0,638,58.98,37629.24,6,9,1,37,28442,0
100103,Clothing,62.73246383666992,2022-09-19,35,0,59.61146545410156,2086.4012908935547,0,9,0,38,28477,0
100103,Clothing,62.73246383666992,2022-09-20,68,0,59.61146545410156,4053.5796508789062,1,9,0,38,28545,0
100103,Clothing,62.73246383666992,2022-09-21,55,0,59.61146545410156,3278.630599975586,2,9,0,38,28600,0
100103,Clothing,62.73246383666992,2022-09-22,122,0,59.61146545410156,7272.598785400391,3,9,0,38,28722,0
100103,Clothing,62.73246383666992,2022-09-23,251,0,59.61146545410156,14962.477828979492,4,9,0,38,28973,0
100103,Clothing,62.73246383666992,2022-09-24,150,0,59.61146545410156,8941.719818115234,5,9,1,38,29123,0
100103,Clothing,62.73246383666992,2022-09-25,106,0,59.61146545410156,6318.815338134766,6,9,1,38,29229,0
100103,Clothing,62.73246383666992,2022-09-26,67,0,59.61146545410156,3993.9681854248047,0,9,0,39,29296,0
100103,Clothing,62.73246383666992,2022-09-27,180,899,55.02527854919434,58606.34027770996,1,9,0,39,29476,0
100103,Clothing,62.73246383666992,2022-09-28,43,0,56.09055709838867,2411.893955230713,2,9,0,39,29519,0
100103,Clothing,62.73246383666992,2022-09-29,83,0,56.09055709838867,4655.51623916626,3,9,0,39,29602,0
100103,Clothing,62.73246383666992,2022-09-30,93,0,56.09055709838867,5216.4218101501465,4,9,0,39,29695,0
100103,Clothing,62.73246383666992,2022-10-01,194,0,56.09055709838867,10881.568077087402,5,10,1,39,29889,0
100103,Clothing,62.73246383666992,2022-10-02,274,1135,66.22029518127442,95680.50175933838,6,10,1,39,30163,0
100103,Clothing,62.73246383666992,2022-10-03,65,0,63.46059036254883,4124.938373565674,0,10,0,40,30228,0
100103,Clothing,62.73246383666992,2022-10-04,34,0,63.46059036254883,2157.66007232666,1,10,0,40,30262,0
100103,Clothing,62.73246383666992,2022-10-05,91,0,63.46059036254883,5774.913722991943,2,10,0,40,30353,0
100103,Clothing,62.73246383666992,2022-10-06,62,0,63.46059036254883,3934.5566024780273,3,10,0,40,30415,0
100103,Clothing,62.73246383666992,2022-10-07,177,0,63.46059036254883,11232.524494171143,4,10,0,40,30592,0
100103,Clothing,62.73246383666992,2022-10-08,90,0,63.46059036254883,5711.4531326293945,5,10,1,40,30682,0
100103,Clothing,62.73246383666992,2022-10-09,106,0,63.46059036254883,6726.822578430176,6,10,1,40,30788,0
100103,Clothing,62.73246383666992,2022-10-10,65,0,63.46059036254883,4124.938373565674,0,10,0,41,30853,0
100103,Clothing,62.73246383666992,2022-10-11,51,0,63.46059036254883,3236.4901084899902,1,10,0,41,30904,0
100103,Clothing,62.73246383666992,2022-10-12,41,0,63.46059036254883,2601.884204864502,2,10,0,41,30945,0
100103,Clothing,62.73246383666992,2022-10-13,131,0,63.46059036254883,8313.337337493896,3,10,0,41,31076,0
100103,Clothing,62.73246383666992,2022-10-14,120,0,63.46059036254883,7615.270843505859,4,10,0,41,31196,0
100103,Clothing,62.73246383666992,2022-10-15,75,0,63.46059036254883,4759.544277191162,5,10,1,41,31271,0
100103,Clothing,62.73246383666992,2022-10-16,59,0,63.46059036254883,3744.174831390381,6,10,1,41,31330,0
100103,Clothing,62.73246383666992,2022-10-17,88,0,63.46059036254883,5584.531951904297,0,10,0,42,31418,0
100103,Clothing,62.73246383666992,2022-10-18,97,450,54.15822853088379,28520.286334991455,1,10,0,42,31515,0
100103,Clothing,62.73246383666992,2022-10-19,112,0,57.28645706176758,6416.083190917969,2,10,0,42,31627,0
100103,Clothing,62.73246383666992,2022-10-20,38,0,57.28645706176758,2176.885368347168,3,10,0,42,31665,0
100103,Clothing,62.73246383666992,2022-10-21,92,0,57.28645706176758,5270.354049682617,4,10,0,42,31757,0
100103,Clothing,62.73246383666992,2022-10-22,119,0,57.28645706176758,6817.088390350342,5,10,1,42,31876,0
100103,Clothing,62.73246383666992,2022-10-23,101,408,56.54337181091309,28699.721105804445,6,10,1,42,31977,0
100103,Clothing,62.73246383666992,2022-10-24,91,0,56.80674362182617,5169.413669586182,0,10,0,43,32068,0
100103,Clothing,62.73246383666992,2022-10-25,44,0,56.80674362182617,2499.4967193603516,1,10,0,43,32112,0
100103,Clothing,62.73246383666992,2022-10-26,125,0,56.80674362182617,7100.8429527282715,2,10,0,43,32237,0
100103,Clothing,62.73246383666992,2022-10-27,108,557,58.4304712677002,39080.551793823244,3,10,0,43,32345,0
100103,Clothing,62.73246383666992,2022-10-28,141,0,57.93094253540039,8168.262897491455,4,10,0,43,32486,0
100103,Clothing,62.73246383666992,2022-10-29,32,0,57.93094253540039,1853.7901611328125,5,10,1,43,32518,0
100103,Clothing,62.73246383666992,2022-10-30,46,0,57.93094253540039,2664.823356628418,6,10,1,43,32564,0
100103,Clothing,62.73246383666992,2022-10-31,140,0,57.93094253540039,8110.331954956055,0,10,0,44,32704,0
100103,Clothing,62.73246383666992,2022-11-01,179,639,61.073275833129884,50411.8327482605,1,11,0,44,32883,0
100103,Clothing,62.73246383666992,2022-11-02,142,0,60.086551666259766,8532.290336608887,2,11,0,44,33025,0
100103,Clothing,62.73246383666992,2022-11-03,86,0,60.086551666259766,5167.44344329834,3,11,0,44,33111,0
100103,Clothing,62.73246383666992,2022-11-04,72,0,60.086551666259766,4326.231719970703,4,11,0,44,33183,0
100103,Clothing,62.73246383666992,2022-11-05,182,657,65.77262786865234,56160.48654418945,5,11,1,44,33365,0
100103,Clothing,62.73246383666992,2022-11-06,108,0,63.71525573730469,6881.247619628906,6,11,1,44,33473,0
100103,Clothing,62.73246383666992,2022-11-07,98,0,63.71525573730469,6244.095062255859,0,11,0,45,33571,0
100103,Clothing,62.73246383666992,2022-11-08,37,0,63.71525573730469,2357.4644622802734,1,11,0,45,33608,0
100103,Clothing,62.73246383666992,2022-11-09,61,0,63.71525573730469,3886.630599975586,2,11,0,45,33669,0
100103,Clothing,62.73246383666992,2022-11-10,60,0,63.71525573730469,3822.9153442382812,3,11,0,45,33729,0
100103,Clothing,62.73246383666992,2022-11-11,81,0,63.71525573730469,5160.93571472168,4,11,0,45,33810,0
100103,Clothing,62.73246383666992,2022-11-12,185,984,60.36622711181641,69812.08403137207,5,11,1,45,33995,0
100103,Clothing,62.73246383666992,2022-11-13,41,0,61.31245422363281,2513.8106231689453,6,11,1,45,34036,0
100103,Clothing,62.73246383666992,2022-11-14,93,0,61.31245422363281,5702.058242797852,0,11,0,46,34129,0
100103,Clothing,62.73246383666992,2022-11-15,113,0,61.31245422363281,6928.307327270508,1,11,0,46,34242,0
100103,Clothing,62.73246383666992,2022-11-16,114,0,61.31245422363281,6989.619781494141,2,11,0,46,34356,0
100103,Clothing,62.73246383666992,2022-11-17,99,0,61.31245422363281,6069.932968139648,3,11,0,46,34455,0
100103,Clothing,62.73246383666992,2022-11-18,104,0,61.31245422363281,6376.4952392578125,4,11,0,46,34559,0
100103,Clothing,62.73246383666992,2022-11-19,65,0,61.31245422363281,3985.309524536133,5,11,1,46,34624,0
100103,Clothing,62.73246383666992,2022-11-20,151,0,61.31245422363281,9258.180587768555,6,11,1,46,34775,0
100103,Clothing,62.73246383666992,2022-11-21,112,0,61.31245422363281,6866.994873046875,0,11,0,47,34887,0
100103,Clothing,62.73246383666992,2022-11-22,58,0,61.31245422363281,3556.122344970703,1,11,0,47,34945,0
100103,Clothing,62.73246383666992,2022-11-23,66,0,61.31245422363281,4046.6219787597656,2,11,0,47,35011,0
100103,Clothing,62.73246383666992,2022-11-24,88,0,61.31245422363281,5395.4959716796875,3,11,0,47,35099,0
100103,Clothing,62.73246383666992,2022-11-25,87,499,57.40198822021485,33121.74595031738,4,11,0,47,35186,0
100103,Clothing,62.73246383666992,2022-11-26,105,0,58.65397644042969,6158.667526245117,5,11,1,47,35291,0
100103,Clothing,62.73246383666992,2022-11-27,97,0,58.65397644042969,5689.43571472168,6,11,1,47,35388,0
100103,Clothing,62.73246383666992,2022-11-28,67,0,58.65397644042969,3929.816421508789,0,11,0,48,35455,0
100103,Clothing,62.73246383666992,2022-11-29,180,727,59.537868881225585,54144.23279724121,1,11,0,48,35635,0
100103,Clothing,62.73246383666992,2022-11-30,147,0,59.27573776245117,8713.533451080322,2,11,0,48,35782,0
100103,Clothing,62.73246383666992,2022-12-01,123,0,59.27573776245117,7290.915744781494,3,12,0,48,35905,0
100103,Clothing,62.73246383666992,2022-12-02,93,0,59.27573776245117,5512.643611907959,4,12,0,48,35998,0
100103,Clothing,62.73246383666992,2022-12-03,106,0,59.27573776245117,6283.228202819824,5,12,1,48,36104,0
100103,Clothing,62.73246383666992,2022-12-04,230,965,72.47907302856444,89170.97359313964,6,12,1,48,36334,0
100103,Clothing,62.73246383666992,2022-12-05,88,0,68.9981460571289,6071.836853027344,0,12,0,49,36422,0
100103,Clothing,62.73246383666992,2022-12-06,189,0,68.9981460571289,13040.649604797363,1,12,0,49,36611,0
100103,Clothing,62.73246383666992,2022-12-07,65,0,68.9981460571289,4484.879493713379,2,12,0,49,36676,0
100103,Clothing,62.73246383666992,2022-12-08,102,0,68.9981460571289,7037.810897827148,3,12,0,49,36778,0
100103,Clothing,62.73246383666992,2022-12-09,242,0,68.9981460571289,16697.551345825195,4,12,0,49,37020,0
100103,Clothing,62.73246383666992,2022-12-10,159,0,68.9981460571289,10970.705223083496,5,12,1,49,37179,0
100103,Clothing,62.73246383666992,2022-12-11,136,471,63.41853286743164,37781.9909399414,6,12,1,49,37315,0
100103,Clothing,62.73246383666992,2022-12-12,130,0,65.54706573486328,8521.118545532227,0,12,0,50,37445,0
100103,Clothing,62.73246383666992,2022-12-13,162,0,65.54706573486328,10618.624649047852,1,12,0,50,37607,0
100103,Clothing,62.73246383666992,2022-12-14,153,802,64.5572248840332,61472.23081451416,2,12,0,50,37760,0
100103,Clothing,62.73246383666992,2022-12-15,94,0,64.8344497680664,6094.438278198242,3,12,0,50,37854,0
100103,Clothing,62.73246383666992,2022-12-16,56,0,64.8344497680664,3630.7291870117188,4,12,0,50,37910,0
100103,Clothing,62.73246383666992,2022-12-17,152,0,64.8344497680664,9854.836364746094,5,12,1,50,38062,0
100103,Clothing,62.73246383666992,2022-12-18,180,0,64.8344497680664,11670.200958251953,6,12,1,50,38242,0
100103,Clothing,62.73246383666992,2022-12-19,165,0,64.8344497680664,10697.684211730957,0,12,0,51,38407,0
100103,Clothing,62.73246383666992,2022-12-20,64,0,64.8344497680664,4149.40478515625,1,12,0,51,38471,0
100103,Clothing,62.73246383666992,2022-12-21,67,0,64.8344497680664,4343.908134460449,2,12,0,51,38538,0
100103,Clothing,62.73246383666992,2022-12-22,106,0,64.8344497680664,6872.451675415039,3,12,0,51,38644,0
100103,Clothing,62.73246383666992,2022-12-23,84,362,51.95977447509766,21923.122111816407,4,12,0,51,38728,0
100103,Clothing,62.73246383666992,2022-12-24,115,614,58.671455001831056,43159.984650421145,5,12,1,51,38843,0
100103,Clothing,62.73246383666992,2022-12-25,182,0,57.89291000366211,10536.509620666504,6,12,1,51,39025,0
100103,Clothing,62.73246383666992,2022-12-26,8,0,57.89291000366211,463.1432800292969,0,12,0,52,39033,0
100103,Clothing,62.73246383666992,2022-12-27,93,0,57.89291000366211,5384.040630340576,1,12,0,52,39126,0
100103,Clothing,62.73246383666992,2022-12-28,150,0,57.89291000366211,8683.936500549316,2,12,0,52,39276,0
100103,Clothing,62.73246383666992,2022-12-29,116,660,70.01275054931641,56683.91812744141,3,12,0,52,39392,0
100103,Clothing,62.73246383666992,2022-12-30,177,0,65.68550109863281,11626.333694458008,4,12,0,52,39569,0
100103,Clothing,62.73246383666992,2022-12-31,91,0,65.68550109863281,5977.380599975586,5,12,1,52,39660,0
100103,Clothing,62.73246383666992,2023-01-01,54,0,65.68550109863281,3547.017059326172,6,1,1,52,39714,0
100103,Clothing,62.73246383666992,2023-01-02,125,0,65.68550109863281,8210.687637329102,0,1,0,1,39839,0
100103,Clothing,62.73246383666992,2023-01-03,120,0,65.68550109863281,7882.2601318359375,1,1,0,1,39959,0
100103,Clothing,62.73246383666992,2023-01-04,168,799,67.9908233642578,66194.61665039063,2,1,0,1,40127,0
100103,Clothing,62.73246383666992,2023-01-05,129,0,67.28164672851562,8679.332427978516,3,1,0,1,40256,0
100103,Clothing,62.73246383666992,2023-01-06,50,0,67.28164672851562,3364.0823364257812,4,1,0,1,40306,0
100103,Clothing,62.73246383666992,2023-01-07,128,0,67.28164672851562,8612.05078125,5,1,1,1,40434,0
100103,Clothing,62.73246383666992,2023-01-08,208,0,67.28164672851562,13994.58251953125,6,1,1,1,40642,0
100103,Clothing,62.73246383666992,2023-01-09,147,0,67.28164672851562,9890.402069091797,0,1,0,2,40789,0
100103,Clothing,62.73246383666992,2023-01-10,114,0,67.28164672851562,7670.107727050781,1,1,0,2,40903,0
100103,Clothing,62.73246383666992,2023-01-11,165,555,64.1248371887207,45754.596272277835,2,1,0,2,41068,0
100103,Clothing,62.73246383666992,2023-01-12,118,0,65.1896743774414,7692.381576538086,3,1,0,2,41186,0
100103,Clothing,62.73246383666992,2023-01-13,190,736,65.52019149780273,60737.11276916504,4,1,0,2,41376,0
100103,Clothing,62.73246383666992,2023-01-14,92,0,65.40038299560547,6016.835235595703,5,1,1,2,41468,0
100103,Clothing,62.73246383666992,2023-01-15,162,0,65.40038299560547,10594.862045288086,6,1,1,2,41630,0
100103,Clothing,62.73246383666992,2023-01-16,129,0,65.40038299560547,8436.649406433105,0,1,0,3,41759,0
100103,Clothing,62.73246383666992,2023-01-17,200,0,65.40038299560547,13080.076599121094,1,1,0,3,41959,0
100103,Clothing,62.73246383666992,2023-01-18,107,0,65.40038299560547,6997.840980529785,2,1,0,3,42066,0
100103,Clothing,62.73246383666992,2023-01-19,121,659,67.5866145324707,53122.880716857915,3,1,0,3,42187,0
100103,Clothing,62.73246383666992,2023-01-20,120,0,66.8332290649414,8019.987487792969,4,1,0,3,42307,0
100103,Clothing,62.73246383666992,2023-01-21,49,0,66.8332290649414,3274.828224182129,5,1,1,3,42356,0
100103,Clothing,62.73246383666992,2023-01-22,352,1251,71.23758926391602,115373.71284179688,6,1,1,3,42708,0
100103,Clothing,62.73246383666992,2023-01-23,108,0,69.92517852783203,7551.919281005859,0,1,0,4,42816,0
100103,Clothing,62.73246383666992,2023-01-24,156,0,69.92517852783203,10908.327850341797,1,1,0,4,42972,0
100103,Clothing,62.73246383666992,2023-01-25,245,0,69.92517852783203,17131.668739318848,2,1,0,4,43217,0
100103,Clothing,62.73246383666992,2023-01-26,110,0,69.92517852783203,7691.769638061523,3,1,0,4,43327,0
100103,Clothing,62.73246383666992,2023-01-27,169,0,69.92517852783203,11817.355171203613,4,1,0,4,43496,0
100103,Clothing,62.73246383666992,2023-01-28,184,0,69.92517852783203,12866.232849121094,5,1,1,4,43680,0
100103,Clothing,62.73246383666992,2023-01-29,128,0,69.92517852783203,8950.4228515625,6,1,1,4,43808,0
100103,Clothing,62.73246383666992,2023-01-30,134,0,69.92517852783203,9369.973922729492,0,1,0,5,43942,0
100103,Clothing,62.73246383666992,2023-01-31,55,0,69.92517852783203,3845.8848190307617,1,1,0,5,43997,0
100103,Clothing,62.73246383666992,2023-02-01,63,0,69.92517852783203,4405.286247253418,2,2,0,5,44060,0
100103,Clothing,62.73246383666992,2023-02-02,144,0,69.92517852783203,10069.225708007812,3,2,0,5,44204,0
100103,Clothing,62.73246383666992,2023-02-03,88,401,51.50892448425293,23072.320709228516,4,2,0,5,44292,0
100103,Clothing,62.73246383666992,2023-02-04,230,909,70.79554977416993,83185.40289611816,5,2,1,5,44522,0
100103,Clothing,62.73246383666992,2023-02-05,147,0,67.04109954833984,9855.041633605957,6,2,1,5,44669,0
100103,Clothing,62.73246383666992,2023-02-07,82,0,67.04109954833984,5497.370162963867,1,2,0,6,44751,0
100103,Clothing,62.73246383666992,2023-02-08,69,0,67.04109954833984,4625.835868835449,2,2,0,6,44820,0
100103,Clothing,62.73246383666992,2023-02-09,136,0,67.04109954833984,9117.589538574219,3,2,0,6,44956,0
100103,Clothing,62.73246383666992,2023-02-10,217,0,67.04109954833984,14547.918601989746,4,2,0,6,45173,0
100103,Clothing,62.73246383666992,2023-02-11,90,0,67.04109954833984,6033.698959350586,5,2,1,6,45263,0
100103,Clothing,62.73246383666992,2023-02-12,80,0,67.04109954833984,5363.2879638671875,6,2,1,6,45343,0
100103,Clothing,62.73246383666992,2023-02-13,160,975,67.07232192993163,76133.34301757812,0,2,0,7,45503,0
100103,Clothing,62.73246383666992,2023-02-14,99,0,67.06464385986328,6639.399742126465,1,2,0,7,45602,0
100103,Clothing,62.73246383666992,2023-02-15,157,0,67.06464385986328,10529.149085998535,2,2,0,7,45759,0
100103,Clothing,62.73246383666992,2023-02-16,101,0,67.06464385986328,6773.529029846191,3,2,0,7,45860,0
100103,Clothing,62.73246383666992,2023-02-17,145,0,67.06464385986328,9724.373359680176,4,2,0,7,46005,0
100103,Clothing,62.73246383666992,2023-02-18,80,0,67.06464385986328,5365.1715087890625,5,2,1,7,46085,0
100103,Clothing,62.73246383666992,2023-02-19,101,0,67.06464385986328,6773.529029846191,6,2,1,7,46186,0
100103,Clothing,62.73246383666992,2023-02-20,156,0,67.06464385986328,10462.084442138672,0,2,0,8,46342,0
100103,Clothing,62.73246383666992,2023-02-21,99,0,67.06464385986328,6639.399742126465,1,2,0,8,46441,0
100103,Clothing,62.73246383666992,2023-02-22,102,0,67.06464385986328,6840.593673706055,2,2,0,8,46543,0
100103,Clothing,62.73246383666992,2023-02-23,69,407,57.95603294372559,26554.13254623413,3,2,0,8,46612,0
100103,Clothing,62.73246383666992,2023-02-24,111,0,61.01206588745117,6772.33931350708,4,2,0,8,46723,0
100103,Clothing,62.73246383666992,2023-02-25,133,0,61.01206588745117,8114.604763031006,5,2,1,8,46856,0
100103,Clothing,62.73246383666992,2023-02-26,98,0,61.01206588745117,5979.182456970215,6,2,1,8,46954,0
100103,Clothing,62.73246383666992,2023-02-27,170,770,64.45110412597657,61015.37540283203,0,2,0,9,47124,0
100103,Clothing,62.73246383666992,2023-02-28,76,0,63.732208251953125,4843.6478271484375,1,2,0,9,47200,0
100103,Clothing,62.73246383666992,2023-03-01,80,0,63.732208251953125,5098.57666015625,2,3,0,9,47280,0
100103,Clothing,62.73246383666992,2023-03-02,79,0,63.732208251953125,5034.844451904297,3,3,0,9,47359,0
100103,Clothing,62.73246383666992,2023-03-03,110,0,63.732208251953125,7010.542907714844,4,3,0,9,47469,0
100103,Clothing,62.73246383666992,2023-03-04,172,751,63.30935653686524,58359.63864868164,5,3,1,9,47641,0
100103,Clothing,62.73246383666992,2023-03-05,90,0,63.43871307373047,5709.484176635742,6,3,1,9,47731,0
100103,Clothing,62.73246383666992,2023-03-06,66,0,63.43871307373047,4186.955062866211,0,3,0,10,47797,0
100103,Clothing,62.73246383666992,2023-03-07,103,0,63.43871307373047,6534.187446594238,1,3,0,10,47900,0
100103,Clothing,62.73246383666992,2023-03-08,160,0,63.43871307373047,10150.194091796875,2,3,0,10,48060,0
100103,Clothing,62.73246383666992,2023-03-09,188,0,63.43871307373047,11926.478057861328,3,3,0,10,48248,0
100103,Clothing,62.73246383666992,2023-03-10,213,792,56.19155174255371,55273.08104232788,4,3,0,10,48461,0
100103,Clothing,62.73246383666992,2023-03-11,82,0,58.26310348510742,4777.574485778809,5,3,1,10,48543,0
100103,Clothing,62.73246383666992,2023-03-12,45,0,58.26310348510742,2621.839656829834,6,3,1,10,48588,0
100103,Clothing,62.73246383666992,2023-03-13,68,0,58.26310348510742,3961.8910369873047,0,3,0,11,48656,0
100103,Clothing,62.73246383666992,2023-03-14,69,0,58.26310348510742,4020.154140472412,1,3,0,11,48725,0
100103,Clothing,62.73246383666992,2023-03-15,150,0,58.26310348510742,8739.465522766113,2,3,0,11,48875,0
100103,Clothing,62.73246383666992,2023-03-16,104,0,58.26310348510742,6059.362762451172,3,3,0,11,48979,0
100103,Clothing,62.73246383666992,2023-03-17,142,794,55.60054733276367,51513.635442504885,4,3,0,11,49121,0
100103,Clothing,62.73246383666992,2023-03-18,137,0,56.411094665527344,7728.319969177246,5,3,1,11,49258,0
100103,Clothing,62.73246383666992,2023-03-19,119,0,56.411094665527344,6712.920265197754,6,3,1,11,49377,0
100103,Clothing,62.73246383666992,2023-03-20,102,0,56.411094665527344,5753.931655883789,0,3,0,12,49479,0
100103,Clothing,62.73246383666992,2023-03-21,135,0,56.411094665527344,7615.497779846191,1,3,0,12,49614,0
100103,Clothing,62.73246383666992,2023-03-22,69,0,56.411094665527344,3892.3655319213867,2,3,0,12,49683,0
100103,Clothing,62.73246383666992,2023-03-23,85,0,56.411094665527344,4794.943046569824,3,3,0,12,49768,0
100103,Clothing,62.73246383666992,2023-03-24,109,0,56.411094665527344,6148.8093185424805,4,3,0,12,49877,0
100103,Clothing,62.73246383666992,2023-03-25,39,0,56.411094665527344,2200.0326919555664,5,3,1,12,49916,0
100103,Clothing,62.73246383666992,2023-03-26,116,474,61.359124984741214,36853.75699645996,6,3,1,12,50032,0
100103,Clothing,62.73246383666992,2023-03-27,93,0,59.53824996948242,5537.057247161865,0,3,0,13,50125,0
100103,Clothing,62.73246383666992,2023-03-28,37,0,59.53824996948242,2202.9152488708496,1,3,0,13,50162,0
100103,Clothing,62.73246383666992,2023-03-29,115,0,59.53824996948242,6846.8987464904785,2,3,0,13,50277,0
100103,Clothing,62.73246383666992,2023-03-30,101,0,59.53824996948242,6013.363246917725,3,3,0,13,50378,0
100103,Clothing,62.73246383666992,2023-03-31,104,622,63.396446990966794,46649.26097412109,4,3,0,13,50482,0
100103,Clothing,62.73246383666992,2023-04-01,98,0,62.192893981933594,6094.903610229492,5,4,1,13,50580,0
100103,Clothing,62.73246383666992,2023-04-02,131,0,62.192893981933594,8147.269111633301,6,4,1,13,50711,0
100103,Clothing,62.73246383666992,2023-04-03,99,0,62.192893981933594,6157.096504211426,0,4,0,14,50810,0
100103,Clothing,62.73246383666992,2023-04-04,65,0,62.192893981933594,4042.5381088256836,1,4,0,14,50875,0
100103,Clothing,62.73246383666992,2023-04-05,92,0,62.192893981933594,5721.746246337891,2,4,0,14,50967,0
100103,Clothing,62.73246383666992,2023-04-06,221,906,64.74703353881836,73403.48882415771,3,4,0,14,51188,0
100103,Clothing,62.73246383666992,2023-04-07,99,0,64.11406707763672,6347.292640686035,4,4,0,14,51287,0
100103,Clothing,62.73246383666992,2023-04-08,151,0,64.11406707763672,9681.224128723145,5,4,1,14,51438,0
100103,Clothing,62.73246383666992,2023-04-09,108,0,64.11406707763672,6924.319244384766,6,4,1,14,51546,0
100103,Clothing,62.73246383666992,2023-04-10,29,0,64.11406707763672,1859.3079452514648,0,4,0,15,51575,0
100103,Clothing,62.73246383666992,2023-04-11,125,0,64.11406707763672,8014.25838470459,1,4,0,15,51700,0
100103,Clothing,62.73246383666992,2023-04-12,42,0,64.11406707763672,2692.790817260742,2,4,0,15,51742,0
100103,Clothing,62.73246383666992,2023-04-13,53,0,64.11406707763672,3398.045555114746,3,4,0,15,51795,0
100103,Clothing,62.73246383666992,2023-04-14,81,0,64.11406707763672,5193.239433288574,4,4,0,15,51876,0
100103,Clothing,62.73246383666992,2023-04-15,123,506,53.9494979095459,32494.34648574829,5,4,1,15,51999,0
100103,Clothing,62.73246383666992,2023-04-16,120,0,57.7089958190918,6925.079498291016,6,4,1,15,52119,0
100103,Clothing,62.73246383666992,2023-04-17,189,0,57.7089958190918,10907.00020980835,0,4,0,16,52308,0
100103,Clothing,62.73246383666992,2023-04-18,108,0,57.7089958190918,6232.571548461914,1,4,0,16,52416,0
100103,Clothing,62.73246383666992,2023-04-19,90,0,57.7089958190918,5193.809623718262,2,4,0,16,52506,0
100103,Clothing,62.73246383666992,2023-04-20,81,419,60.49052154541016,30583.084490356447,3,4,0,16,52587,0
100103,Clothing,62.73246383666992,2023-04-21,85,0,59.49104309082031,5056.738662719727,4,4,0,16,52672,0
100103,Clothing,62.73246383666992,2023-04-22,28,0,59.49104309082031,1665.7492065429688,5,4,1,16,52700,0
100103,Clothing,62.73246383666992,2023-04-23,229,848,58.20408538818359,62454.24110778808,6,4,1,16,52929,0
100103,Clothing,62.73246383666992,2023-04-24,62,0,58.57817077636719,3631.8465881347656,0,4,0,17,52991,0
100103,Clothing,62.73246383666992,2023-04-25,112,0,58.57817077636719,6560.755126953125,1,4,0,17,53103,0
100103,Clothing,62.73246383666992,2023-04-26,87,0,58.57817077636719,5096.300857543945,2,4,0,17,53190,0
100103,Clothing,62.73246383666992,2023-04-27,83,0,58.57817077636719,4861.988174438477,3,4,0,17,53273,0
100103,Clothing,62.73246383666992,2023-04-28,26,0,58.57817077636719,1523.0324401855469,4,4,0,17,53299,0
100103,Clothing,62.73246383666992,2023-04-29,130,0,58.57817077636719,7615.162200927734,5,4,1,17,53429,0
100103,Clothing,62.73246383666992,2023-04-30,60,0,58.57817077636719,3514.6902465820312,6,4,1,17,53489,0
100103,Clothing,62.73246383666992,2023-05-01,104,0,58.57817077636719,6092.1297607421875,0,5,0,18,53593,0
100103,Clothing,62.73246383666992,2023-05-02,60,0,58.57817077636719,3514.6902465820312,1,5,0,18,53653,0
100103,Clothing,62.73246383666992,2023-05-03,83,0,58.57817077636719,4861.988174438477,2,5,0,18,53736,0
100103,Clothing,62.73246383666992,2023-05-04,108,0,58.57817077636719,6326.442443847656,3,5,0,18,53844,0
100103,Clothing,62.73246383666992,2023-05-05,166,655,51.59123847961426,41558.73117523194,4,5,0,18,54010,0
100103,Clothing,62.73246383666992,2023-05-06,79,0,53.222476959228516,4204.575679779053,5,5,1,18,54089,0
100103,Clothing,62.73246383666992,2023-05-07,131,0,53.222476959228516,6972.144481658936,6,5,1,18,54220,0
100103,Clothing,62.73246383666992,2023-05-08,23,0,53.222476959228516,1224.1169700622559,0,5,0,19,54243,0
100103,Clothing,62.73246383666992,2023-05-09,52,0,53.222476959228516,2767.568801879883,1,5,0,19,54295,0
100103,Clothing,62.73246383666992,2023-05-10,75,0,53.222476959228516,3991.6857719421387,2,5,0,19,54370,0
100103,Clothing,62.73246383666992,2023-05-11,136,526,50.90458625793457,33396.74746215821,3,5,0,19,54506,0
100103,Clothing,62.73246383666992,2023-05-12,62,0,51.67917251586914,3204.1086959838867,4,5,0,19,54568,0
100103,Clothing,62.73246383666992,2023-05-13,39,0,51.67917251586914,2015.4877281188965,5,5,1,19,54607,0
100103,Clothing,62.73246383666992,2023-05-14,61,0,51.67917251586914,3152.4295234680176,6,5,1,19,54668,0
100103,Clothing,62.73246383666992,2023-05-15,133,0,51.67917251586914,6873.329944610596,0,5,0,20,54801,0
100103,Clothing,62.73246383666992,2023-05-16,108,743,59.576980667114256,52181.47782409668,1,5,0,20,54909,0
100103,Clothing,62.73246383666992,2023-05-17,112,0,57.243961334228516,6411.323669433594,2,5,0,20,55021,0
100103,Clothing,62.73246383666992,2023-05-18,83,0,57.243961334228516,4751.248790740967,3,5,0,20,55104,0
100103,Clothing,62.73246383666992,2023-05-19,84,0,57.243961334228516,4808.492752075195,4,5,0,20,55188,0
100103,Clothing,62.73246383666992,2023-05-20,83,0,57.243961334228516,4751.248790740967,5,5,1,20,55271,0
100103,Clothing,62.73246383666992,2023-05-21,162,0,57.243961334228516,9273.52173614502,6,5,1,20,55433,0
100103,Clothing,62.73246383666992,2023-05-22,102,0,57.243961334228516,5838.884056091309,0,5,0,21,55535,0
100103,Clothing,62.73246383666992,2023-05-23,169,586,62.224986419677734,47707.53540985107,1,5,0,21,55704,0
100103,Clothing,62.73246383666992,2023-05-24,100,0,60.47997283935547,6047.997283935547,2,5,0,21,55804,0
100103,Clothing,62.73246383666992,2023-05-25,56,0,60.47997283935547,3386.8784790039062,3,5,0,21,55860,0
100103,Clothing,62.73246383666992,2023-05-26,86,0,60.47997283935547,5201.27766418457,4,5,0,21,55946,0
100103,Clothing,62.73246383666992,2023-05-27,62,0,60.47997283935547,3749.758316040039,5,5,1,21,56008,0
100103,Clothing,62.73246383666992,2023-05-28,29,0,60.47997283935547,1753.9192123413086,6,5,1,21,56037,0
100103,Clothing,62.73246383666992,2023-05-29,88,0,60.47997283935547,5322.237609863281,0,5,0,22,56125,0
100103,Clothing,62.73246383666992,2023-05-30,83,0,60.47997283935547,5019.837745666504,1,5,0,22,56208,0
100103,Clothing,62.73246383666992,2023-05-31,82,0,60.47997283935547,4959.357772827148,2,5,0,22,56290,0
100103,Clothing,62.73246383666992,2023-06-01,67,0,60.47997283935547,4052.1581802368164,3,6,0,22,56357,0
100103,Clothing,62.73246383666992,2023-06-02,58,309,55.71922653198242,19982.290277709963,4,6,0,22,56415,0
100103,Clothing,62.73246383666992,2023-06-03,97,0,57.578453063964844,5585.10994720459,5,6,1,22,56512,0
100103,Clothing,62.73246383666992,2023-06-04,106,584,65.57120460510254,46467.23537628174,6,6,1,22,56618,0
100103,Clothing,62.73246383666992,2023-06-05,79,0,63.01240921020508,4977.980327606201,0,6,0,23,56697,0
100103,Clothing,62.73246383666992,2023-06-06,138,0,63.01240921020508,8695.7124710083,1,6,0,23,56835,0
100103,Clothing,62.73246383666992,2023-06-07,127,0,63.01240921020508,8002.575969696045,2,6,0,23,56962,0
100103,Clothing,62.73246383666992,2023-06-08,193,855,65.87275573730469,69575.6637145996,3,6,0,23,57155,0
100103,Clothing,62.73246383666992,2023-06-09,116,0,65.05551147460938,7546.4393310546875,4,6,0,23,57271,0
100103,Clothing,62.73246383666992,2023-06-10,149,0,65.05551147460938,9693.271209716797,5,6,1,23,57420,0
100103,Clothing,62.73246383666992,2023-06-11,190,0,65.05551147460938,12360.547180175781,6,6,1,23,57610,0
100103,Clothing,62.73246383666992,2023-06-12,99,0,65.05551147460938,6440.495635986328,0,6,0,24,57709,0
100103,Clothing,62.73246383666992,2023-06-13,125,0,65.05551147460938,8131.938934326172,1,6,0,24,57834,0
100103,Clothing,62.73246383666992,2023-06-14,47,0,65.05551147460938,3057.6090393066406,2,6,0,24,57881,0
100103,Clothing,62.73246383666992,2023-06-15,80,0,65.05551147460938,5204.44091796875,3,6,0,24,57961,0
100103,Clothing,62.73246383666992,2023-06-16,141,873,59.34818649291992,59192.18859100342,4,6,0,24,58102,0
100103,Clothing,62.73246383666992,2023-06-17,144,0,60.696372985839844,8740.277709960938,5,6,1,24,58246,0
100103,Clothing,62.73246383666992,2023-06-18,80,0,60.696372985839844,4855.7098388671875,6,6,1,24,58326,0
100103,Clothing,62.73246383666992,2023-06-19,84,0,60.696372985839844,5098.495330810547,0,6,0,25,58410,0
100103,Clothing,62.73246383666992,2023-06-20,136,767,70.82952606201172,66426.57108886717,1,6,0,25,58546,0
100103,Clothing,62.73246383666992,2023-06-21,61,0,66.91905212402344,4082.0621795654297,2,6,0,25,58607,0
100103,Clothing,62.73246383666992,2023-06-22,99,0,66.91905212402344,6624.98616027832,3,6,0,25,58706,0
100103,Clothing,62.73246383666992,2023-06-23,71,0,66.91905212402344,4751.252700805664,4,6,0,25,58777,0
100103,Clothing,62.73246383666992,2023-06-24,57,0,66.91905212402344,3814.385971069336,5,6,1,25,58834,0
100103,Clothing,62.73246383666992,2023-06-25,135,0,66.91905212402344,9034.072036743164,6,6,1,25,58969,0
100103,Clothing,62.73246383666992,2023-06-26,157,0,66.91905212402344,10506.29118347168,0,6,0,26,59126,0
100103,Clothing,62.73246383666992,2023-06-27,143,0,66.91905212402344,9569.424453735352,1,6,0,26,59269,0
100103,Clothing,62.73246383666992,2023-06-28,70,0,66.91905212402344,4684.333648681641,2,6,0,26,59339,0
100103,Clothing,62.73246383666992,2023-06-29,133,0,66.91905212402344,8900.233932495117,3,6,0,26,59472,0
100103,Clothing,62.73246383666992,2023-06-30,93,0,66.91905212402344,6223.47184753418,4,6,0,26,59565,0
100103,Clothing,62.73246383666992,2023-07-01,78,416,54.14553161621094,24981.662932128907,5,7,1,26,59643,0
100103,Clothing,62.73246383666992,2023-07-02,132,0,59.371063232421875,7836.9803466796875,6,7,1,26,59775,0
100103,Clothing,62.73246383666992,2023-07-03,106,0,59.371063232421875,6293.332702636719,0,7,0,27,59881,0
100103,Clothing,62.73246383666992,2023-07-04,54,0,59.371063232421875,3206.0374145507812,1,7,0,27,59935,0
100103,Clothing,62.73246383666992,2023-07-05,90,0,59.371063232421875,5343.395690917969,2,7,0,27,60025,0
100103,Clothing,62.73246383666992,2023-07-06,99,0,59.371063232421875,5877.735260009766,3,7,0,27,60124,0
100103,Clothing,62.73246383666992,2023-07-07,114,492,56.29114608764648,33756.681307983396,4,7,0,27,60238,0
100103,Clothing,62.73246383666992,2023-07-08,227,972,62.738977127075195,76431.69561569214,5,7,1,27,60465,0
100103,Clothing,62.73246383666992,2023-07-09,92,0,61.11795425415039,5622.851791381836,6,7,1,27,60557,0
100103,Clothing,62.73246383666992,2023-07-11,95,0,61.11795425415039,5806.205654144287,1,7,0,28,60652,0
100103,Clothing,62.73246383666992,2023-07-12,135,0,61.11795425415039,8250.923824310303,2,7,0,28,60787,0
100103,Clothing,62.73246383666992,2023-07-13,96,0,61.11795425415039,5867.3236083984375,3,7,0,28,60883,0
100103,Clothing,62.73246383666992,2023-07-14,126,0,61.11795425415039,7700.862236022949,4,7,0,28,61009,0
100103,Clothing,62.73246383666992,2023-07-15,110,0,61.11795425415039,6722.974967956543,5,7,1,28,61119,0
100103,Clothing,62.73246383666992,2023-07-16,42,0,61.11795425415039,2566.9540786743164,6,7,1,28,61161,0
100103,Clothing,62.73246383666992,2023-07-17,51,0,61.11795425415039,3117.01566696167,0,7,0,29,61212,0
100103,Clothing,62.73246383666992,2023-07-18,85,0,61.11795425415039,5195.026111602783,1,7,0,29,61297,0
100103,Clothing,62.73246383666992,2023-07-19,69,0,61.11795425415039,4217.138843536377,2,7,0,29,61366,0
100103,Clothing,62.73246383666992,2023-07-20,68,0,61.11795425415039,4156.020889282227,3,7,0,29,61434,0
100103,Clothing,62.73246383666992,2023-07-21,91,0,61.11795425415039,5561.733837127686,4,7,0,29,61525,0
100103,Clothing,62.73246383666992,2023-07-22,120,433,50.95210266113281,27017.754638671875,5,7,1,29,61645,0
100103,Clothing,62.73246383666992,2023-07-23,58,0,54.654205322265625,3169.9439086914062,6,7,1,29,61703,0
100103,Clothing,62.73246383666992,2023-07-24,78,0,54.654205322265625,4263.028015136719,0,7,0,30,61781,0
100103,Clothing,62.73246383666992,2023-07-25,188,830,66.3159407043457,69669.353704834,1,7,0,30,61969,0
100103,Clothing,62.73246383666992,2023-07-26,73,0,62.951881408691406,4595.487342834473,2,7,0,30,62042,0
100103,Clothing,62.73246383666992,2023-07-27,141,0,62.951881408691406,8876.215278625488,3,7,0,30,62183,0
100103,Clothing,62.73246383666992,2023-07-28,90,0,62.951881408691406,5665.669326782227,4,7,0,30,62273,0
100103,Clothing,62.73246383666992,2023-07-29,69,0,62.951881408691406,4343.679817199707,5,7,1,30,62342,0
100103,Clothing,62.73246383666992,2023-07-30,92,0,62.951881408691406,5791.573089599609,6,7,1,30,62434,0
100103,Clothing,62.73246383666992,2023-07-31,57,0,62.951881408691406,3588.25724029541,0,7,0,31,62491,0
100103,Clothing,62.73246383666992,2023-08-01,155,0,62.951881408691406,9757.541618347168,1,8,0,31,62646,0
100103,Clothing,62.73246383666992,2023-08-02,185,702,64.44385154724121,57402.69507247925,2,8,0,31,62831,0
100103,Clothing,62.73246383666992,2023-08-03,74,0,63.97770309448242,4734.350028991699,3,8,0,31,62905,0
100103,Clothing,62.73246383666992,2023-08-04,68,0,63.97770309448242,4350.483810424805,4,8,0,31,62973,0
100103,Clothing,62.73246383666992,2023-08-05,142,0,63.97770309448242,9084.833839416504,5,8,1,31,63115,0
100103,Clothing,62.73246383666992,2023-08-06,122,0,63.97770309448242,7805.2797775268555,6,8,1,31,63237,0
100103,Clothing,62.73246383666992,2023-08-07,80,0,63.97770309448242,5118.216247558594,0,8,0,32,63317,0
100103,Clothing,62.73246383666992,2023-08-08,72,0,63.97770309448242,4606.394622802734,1,8,0,32,63389,0
100103,Clothing,62.73246383666992,2023-08-09,94,0,63.97770309448242,6013.904090881348,2,8,0,32,63483,0
100103,Clothing,62.73246383666992,2023-08-10,149,526,57.68539161682129,38170.29670181274,3,8,0,32,63632,0
100103,Clothing,62.73246383666992,2023-08-11,16,0,59.72078323364258,955.5325317382812,4,8,0,32,63648,0
100103,Clothing,62.73246383666992,2023-08-12,75,0,59.72078323364258,4479.058742523193,5,8,1,32,63723,0
100103,Clothing,62.73246383666992,2023-08-13,15,0,59.72078323364258,895.8117485046387,6,8,1,32,63738,0
100103,Clothing,62.73246383666992,2023-08-14,43,0,59.72078323364258,2567.993679046631,0,8,0,33,63781,0
100103,Clothing,62.73246383666992,2023-08-15,76,0,59.72078323364258,4538.779525756836,1,8,0,33,63857,0
100103,Clothing,62.73246383666992,2023-08-16,69,0,59.72078323364258,4120.734043121338,2,8,0,33,63926,0
100103,Clothing,62.73246383666992,2023-08-17,78,0,59.72078323364258,4658.221092224121,3,8,0,33,64004,0
100103,Clothing,62.73246383666992,2023-08-18,159,667,52.595157089233396,42445.29995437622,4,8,0,33,64163,0
100103,Clothing,62.73246383666992,2023-08-19,68,0,54.5603141784668,3710.101364135742,5,8,1,33,64231,0
100103,Clothing,62.73246383666992,2023-08-20,36,0,54.5603141784668,1964.1713104248047,6,8,1,33,64267,0
100103,Clothing,62.73246383666992,2023-08-21,109,0,54.5603141784668,5947.074245452881,0,8,0,34,64376,0
100103,Clothing,62.73246383666992,2023-08-22,172,837,61.37937728881836,63401.85578735352,1,8,0,34,64548,0
100103,Clothing,62.73246383666992,2023-08-23,144,0,59.16875457763672,8520.300659179688,2,8,0,34,64692,0
100103,Clothing,62.73246383666992,2023-08-24,27,0,59.16875457763672,1597.5563735961914,3,8,0,34,64719,0
100103,Clothing,62.73246383666992,2023-08-25,85,0,59.16875457763672,5029.344139099121,4,8,0,34,64804,0
100103,Clothing,62.73246383666992,2023-08-26,136,0,59.16875457763672,8046.950622558594,5,8,1,34,64940,0
100103,Clothing,62.73246383666992,2023-08-27,98,0,59.16875457763672,5798.537948608398,6,8,1,34,65038,0
100103,Clothing,62.73246383666992,2023-08-28,125,0,59.16875457763672,7396.09432220459,0,8,0,35,65163,0
100103,Clothing,62.73246383666992,2023-08-29,146,0,59.16875457763672,8638.638168334961,1,8,0,35,65309,0
100103,Clothing,62.73246383666992,2023-08-30,113,0,59.16875457763672,6686.069267272949,2,8,0,35,65422,0
100103,Clothing,62.73246383666992,2023-08-31,71,0,59.16875457763672,4200.981575012207,3,8,0,35,65493,0
100103,Clothing,62.73246383666992,2023-09-01,69,545,51.625747528076175,30534.03315887451,4,9,0,35,65562,0
100103,Clothing,62.73246383666992,2023-09-02,75,0,54.071495056152344,4055.362129211426,5,9,1,35,65637,0
100103,Clothing,62.73246383666992,2023-09-03,67,0,54.071495056152344,3622.790168762207,6,9,1,35,65704,0
100103,Clothing,62.73246383666992,2023-09-04,83,0,54.071495056152344,4487.9340896606445,0,9,0,36,65787,0
100103,Clothing,62.73246383666992,2023-09-05,119,0,54.071495056152344,6434.507911682129,1,9,0,36,65906,0
100103,Clothing,62.73246383666992,2023-09-06,151,639,54.75753509521485,43371.89559875488,2,9,0,36,66057,0
100103,Clothing,62.73246383666992,2023-09-07,128,0,54.52507019042969,6979.208984375,3,9,0,36,66185,0
100103,Clothing,62.73246383666992,2023-09-08,121,0,54.52507019042969,6597.533493041992,4,9,0,36,66306,0
100103,Clothing,62.73246383666992,2023-09-09,131,0,54.52507019042969,7142.784194946289,5,9,1,36,66437,0
100103,Clothing,62.73246383666992,2023-09-10,39,0,54.52507019042969,2126.477737426758,6,9,1,36,66476,0
100103,Clothing,62.73246383666992,2023-09-11,186,573,56.27318916320801,42973.276368713385,0,9,0,37,66662,0
100103,Clothing,62.73246383666992,2023-09-12,95,0,55.596378326416016,5281.6559410095215,1,9,0,37,66757,0
100103,Clothing,62.73246383666992,2023-09-13,135,0,55.596378326416016,7505.511074066162,2,9,0,37,66892,0
100103,Clothing,62.73246383666992,2023-09-14,107,0,55.596378326416016,5948.812480926514,3,9,0,37,66999,0
100103,Clothing,62.73246383666992,2023-09-15,51,0,55.596378326416016,2835.415294647217,4,9,0,37,67050,0
100103,Clothing,62.73246383666992,2023-09-16,77,0,55.596378326416016,4280.921131134033,5,9,1,37,67127,0
100103,Clothing,62.73246383666992,2023-09-17,55,0,55.596378326416016,3057.800807952881,6,9,1,37,67182,0
100103,Clothing,62.73246383666992,2023-09-18,127,642,56.94493537902832,44009.563586273194,0,9,0,38,67309,0
100103,Clothing,62.73246383666992,2023-09-19,91,0,56.51987075805664,5143.308238983154,1,9,0,38,67400,0
100103,Clothing,62.73246383666992,2023-09-20,102,0,56.51987075805664,5765.026817321777,2,9,0,38,67502,0
100103,Clothing,62.73246383666992,2023-09-21,72,0,56.51987075805664,4069.430694580078,3,9,0,38,67574,0
100103,Clothing,62.73246383666992,2023-09-22,86,0,56.51987075805664,4860.708885192871,4,9,0,38,67660,0
100103,Clothing,62.73246383666992,2023-09-23,177,567,60.68519287109375,45799.05827636719,5,9,1,38,67837,0
100103,Clothing,62.73246383666992,2023-09-24,108,0,59.0203857421875,6374.20166015625,6,9,1,38,67945,0
100103,Clothing,62.73246383666992,2023-09-25,113,0,59.0203857421875,6669.3035888671875,0,9,0,39,68058,0
100103,Clothing,62.73246383666992,2023-09-26,119,0,59.0203857421875,7023.4259033203125,1,9,0,39,68177,0
100103,Clothing,62.73246383666992,2023-09-27,103,0,59.0203857421875,6079.0997314453125,2,9,0,39,68280,0
100103,Clothing,62.73246383666992,2023-09-28,138,0,59.0203857421875,8144.813232421875,3,9,0,39,68418,0
100103,Clothing,62.73246383666992,2023-09-29,106,0,59.0203857421875,6256.160888671875,4,9,0,39,68524,0
100103,Clothing,62.73246383666992,2023-09-30,88,361,53.977372894287114,23701.477629394532,5,9,1,39,68612,0
100103,Clothing,62.73246383666992,2023-10-01,68,0,55.93474578857422,3803.562713623047,6,10,1,39,68680,0
100103,Clothing,62.73246383666992,2023-10-02,201,728,53.56229988098144,49368.18455215454,0,10,0,40,68881,0
100103,Clothing,62.73246383666992,2023-10-03,63,0,54.30459976196289,3421.189785003662,1,10,0,40,68944,0
100103,Clothing,62.73246383666992,2023-10-04,101,0,54.30459976196289,5484.764575958252,2,10,0,40,69045,0
100103,Clothing,62.73246383666992,2023-10-05,137,0,54.30459976196289,7439.730167388916,3,10,0,40,69182,0
100103,Clothing,62.73246383666992,2023-10-06,155,0,54.30459976196289,8417.212963104248,4,10,0,40,69337,0
100103,Clothing,62.73246383666992,2023-10-07,72,0,54.30459976196289,3909.931182861328,5,10,1,40,69409,0
100103,Clothing,62.73246383666992,2023-10-08,85,0,54.30459976196289,4615.890979766846,6,10,1,40,69494,0
100103,Clothing,62.73246383666992,2023-10-09,64,0,54.30459976196289,3475.494384765625,0,10,0,41,69558,0
100103,Clothing,62.73246383666992,2023-10-10,116,654,64.58412193298341,51287.756288452154,1,10,0,41,69674,0
100103,Clothing,62.73246383666992,2023-10-11,155,0,61.6882438659668,9561.677799224854,2,10,0,41,69829,0
100103,Clothing,62.73246383666992,2023-10-12,67,0,61.6882438659668,4133.112339019775,3,10,0,41,69896,0
100103,Clothing,62.73246383666992,2023-10-13,45,0,61.6882438659668,2775.970973968506,4,10,0,41,69941,0
100103,Clothing,62.73246383666992,2023-10-14,58,0,61.6882438659668,3577.918144226074,5,10,1,41,69999,0
100103,Clothing,62.73246383666992,2023-10-15,63,0,61.6882438659668,3886.359363555908,6,10,1,41,70062,0
100103,Clothing,62.73246383666992,2023-10-16,72,0,61.6882438659668,4441.553558349609,0,10,0,42,70134,0
100103,Clothing,62.73246383666992,2023-10-17,271,818,60.21181503295898,65356.34374786377,1,10,0,42,70405,0
100103,Clothing,62.73246383666992,2023-10-18,93,0,60.60363006591797,5636.137596130371,2,10,0,42,70498,0
100103,Clothing,62.73246383666992,2023-10-19,126,0,60.60363006591797,7636.057388305664,3,10,0,42,70624,0
100103,Clothing,62.73246383666992,2023-10-20,101,0,60.60363006591797,6120.966636657715,4,10,0,42,70725,0
100103,Clothing,62.73246383666992,2023-10-21,137,0,60.60363006591797,8302.697319030762,5,10,1,42,70862,0
100103,Clothing,62.73246383666992,2023-10-22,124,0,60.60363006591797,7514.850128173828,6,10,1,42,70986,0
100103,Clothing,62.73246383666992,2023-10-23,183,670,58.16579971313477,49266.832695007324,0,10,0,43,71169,0
100103,Clothing,62.73246383666992,2023-10-24,79,0,58.88159942626953,4651.646354675293,1,10,0,43,71248,0
100103,Clothing,62.73246383666992,2023-10-25,155,0,58.88159942626953,9126.647911071777,2,10,0,43,71403,0
100103,Clothing,62.73246383666992,2023-10-26,69,0,58.88159942626953,4062.8303604125977,3,10,0,43,71472,0
100103,Clothing,62.73246383666992,2023-10-27,55,0,58.88159942626953,3238.487968444824,4,10,0,43,71527,0
100103,Clothing,62.73246383666992,2023-10-28,95,0,58.88159942626953,5593.7519454956055,5,10,1,43,71622,0
100103,Clothing,62.73246383666992,2023-10-29,136,704,64.3602507019043,54982.628190917974,6,10,1,43,71758,0
100103,Clothing,62.73246383666992,2023-10-30,68,0,62.740501403808594,4266.354095458984,0,10,0,44,71826,0
100103,Clothing,62.73246383666992,2023-10-31,102,0,62.740501403808594,6399.531143188477,1,10,0,44,71928,0
100103,Clothing,62.73246383666992,2023-11-01,114,0,62.740501403808594,7152.41716003418,2,11,0,44,72042,0
100103,Clothing,62.73246383666992,2023-11-02,129,0,62.740501403808594,8093.524681091309,3,11,0,44,72171,0
100103,Clothing,62.73246383666992,2023-11-03,79,0,62.740501403808594,4956.499610900879,4,11,0,44,72250,0
100103,Clothing,62.73246383666992,2023-11-04,72,0,62.740501403808594,4517.316101074219,5,11,1,44,72322,0
100103,Clothing,62.73246383666992,2023-11-05,100,0,62.740501403808594,6274.050140380859,6,11,1,44,72422,0
100103,Clothing,62.73246383666992,2023-11-06,86,569,57.98998870849609,37287.928057861325,0,11,0,45,72508,0
100103,Clothing,62.73246383666992,2023-11-07,120,0,59.42997741699219,7131.5972900390625,1,11,0,45,72628,0
100103,Clothing,62.73246383666992,2023-11-08,240,885,69.45649932861329,80249.96967773438,2,11,0,45,72868,0
100103,Clothing,62.73246383666992,2023-11-09,49,0,66.18299865722656,3242.9669342041016,3,11,0,45,72917,0
100103,Clothing,62.73246383666992,2023-11-10,132,0,66.18299865722656,8736.155822753906,4,11,0,45,73049,0
100103,Clothing,62.73246383666992,2023-11-11,80,0,66.18299865722656,5294.639892578125,5,11,1,45,73129,0
100103,Clothing,62.73246383666992,2023-11-12,150,0,66.18299865722656,9927.449798583984,6,11,1,45,73279,0
100103,Clothing,62.73246383666992,2023-11-13,185,0,66.18299865722656,12243.854751586914,0,11,0,46,73464,0
100103,Clothing,62.73246383666992,2023-11-14,91,0,66.18299865722656,6022.652877807617,1,11,0,46,73555,0
100103,Clothing,62.73246383666992,2023-11-15,100,0,66.18299865722656,6618.299865722656,2,11,0,46,73655,0
100103,Clothing,62.73246383666992,2023-11-16,140,0,66.18299865722656,9265.619812011719,3,11,0,46,73795,0
100103,Clothing,62.73246383666992,2023-11-17,92,0,66.18299865722656,6088.835876464844,4,11,0,46,73887,0
100103,Clothing,62.73246383666992,2023-11-18,166,656,63.21093566894531,51566.93064208984,5,11,1,46,74053,0
100103,Clothing,62.73246383666992,2023-11-19,97,0,64.01187133789062,6209.151519775391,6,11,1,46,74150,0
100103,Clothing,62.73246383666992,2023-11-20,139,0,64.01187133789062,8897.650115966797,0,11,0,47,74289,0
100103,Clothing,62.73246383666992,2023-11-21,82,0,64.01187133789062,5248.973449707031,1,11,0,47,74371,0
100103,Clothing,62.73246383666992,2023-11-22,149,0,64.01187133789062,9537.768829345703,2,11,0,47,74520,0
100103,Clothing,62.73246383666992,2023-11-23,139,524,58.90505325317383,38413.004804382326,3,11,0,47,74659,0
100103,Clothing,62.73246383666992,2023-11-24,93,0,60.570106506347656,5633.019905090332,4,11,0,47,74752,0
100103,Clothing,62.73246383666992,2023-11-25,96,0,60.570106506347656,5814.730224609375,5,11,1,47,74848,0
100103,Clothing,62.73246383666992,2023-11-26,179,772,62.51996368408203,59818.23699890137,6,11,1,47,75027,0
100103,Clothing,62.73246383666992,2023-11-27,142,0,61.90992736816406,8791.209686279297,0,11,0,48,75169,0
100103,Clothing,62.73246383666992,2023-11-28,41,0,61.90992736816406,2538.3070220947266,1,11,0,48,75210,0
100103,Clothing,62.73246383666992,2023-11-29,81,0,61.90992736816406,5014.704116821289,2,11,0,48,75291,0
100103,Clothing,62.73246383666992,2023-11-30,144,0,61.90992736816406,8915.029541015625,3,11,0,48,75435,0
100103,Clothing,62.73246383666992,2023-12-01,184,780,63.01803871154785,60988.95824584961,4,12,0,48,75619,0
100103,Clothing,62.73246383666992,2023-12-02,143,0,62.6160774230957,8954.099071502686,5,12,1,48,75762,0
100103,Clothing,62.73246383666992,2023-12-03,171,0,62.6160774230957,10707.349239349365,6,12,1,48,75933,0
100103,Clothing,62.73246383666992,2023-12-04,101,0,62.6160774230957,6324.223819732666,0,12,0,49,76034,0
100103,Clothing,62.73246383666992,2023-12-05,128,0,62.6160774230957,8014.85791015625,1,12,0,49,76162,0
100103,Clothing,62.73246383666992,2023-12-06,219,0,62.6160774230957,13712.920955657959,2,12,0,49,76381,0
100103,Clothing,62.73246383666992,2023-12-07,93,0,62.6160774230957,5823.2952003479,3,12,0,49,76474,0
100103,Clothing,62.73246383666992,2023-12-08,95,0,62.6160774230957,5948.527355194092,4,12,0,49,76569,0
100103,Clothing,62.73246383666992,2023-12-09,126,586,58.453072738647464,41019.17433013916,5,12,1,49,76695,0
100103,Clothing,62.73246383666992,2023-12-10,213,0,59.75614547729492,12728.058986663818,6,12,1,49,76908,0
100103,Clothing,62.73246383666992,2023-12-11,164,920,65.56815185546876,72385.15380859375,0,12,0,50,77072,0
100103,Clothing,62.73246383666992,2023-12-12,31,0,63.8363037109375,1978.9254150390625,1,12,0,50,77103,0
100103,Clothing,62.73246383666992,2023-12-13,152,0,63.8363037109375,9703.1181640625,2,12,0,50,77255,0
100103,Clothing,62.73246383666992,2023-12-14,159,0,63.8363037109375,10149.972290039062,3,12,0,50,77414,0
100103,Clothing,62.73246383666992,2023-12-15,48,0,63.8363037109375,3064.142578125,4,12,0,50,77462,0
100103,Clothing,62.73246383666992,2023-12-16,190,0,63.8363037109375,12128.897705078125,5,12,1,50,77652,0
100103,Clothing,62.73246383666992,2023-12-17,91,0,63.8363037109375,5809.1036376953125,6,12,1,50,77743,0
100103,Clothing,62.73246383666992,2023-12-18,160,0,63.8363037109375,10213.80859375,0,12,0,51,77903,0
100103,Clothing,62.73246383666992,2023-12-19,118,0,63.8363037109375,7532.683837890625,1,12,0,51,78021,0
100103,Clothing,62.73246383666992,2023-12-20,121,839,66.26879806518555,64071.24913177491,2,12,0,51,78142,0
100103,Clothing,62.73246383666992,2023-12-21,139,0,65.6375961303711,9123.625862121582,3,12,0,51,78281,0
100103,Clothing,62.73246383666992,2023-12-22,145,0,65.6375961303711,9517.451438903809,4,12,0,51,78426,0
100103,Clothing,62.73246383666992,2023-12-23,119,0,65.6375961303711,7810.87393951416,5,12,1,51,78545,0
100103,Clothing,62.73246383666992,2023-12-24,94,0,65.6375961303711,6169.934036254883,6,12,1,51,78639,0
100103,Clothing,62.73246383666992,2023-12-25,108,0,65.6375961303711,7088.860382080078,0,12,0,52,78747,0
100103,Clothing,62.73246383666992,2023-12-26,55,0,65.6375961303711,3610.06778717041,1,12,0,52,78802,0
100103,Clothing,62.73246383666992,2023-12-27,92,0,65.6375961303711,6038.658843994141,2,12,0,52,78894,0
100103,Clothing,62.73246383666992,2023-12-28,208,735,66.98986404418946,63366.50344238281,3,12,0,52,79102,0
100103,Clothing,62.73246383666992,2023-12-29,113,0,66.6197280883789,7528.029273986816,4,12,0,52,79215,0
100103,Clothing,62.73246383666992,2023-12-30,50,0,66.6197280883789,3330.9864044189453,5,12,1,52,79265,0
100103,Clothing,62.73246383666992,2023-12-31,4,0,66.6197280883789,266.4789123535156,6,12,1,52,79269,0
100103,Clothing,62.73246383666992,2024-01-01,122,0,66.6197280883789,8127.606826782227,0,1,0,1,79391,0
100103,Clothing,62.73246383666992,2024-01-02,146,0,66.6197280883789,9726.48030090332,1,1,0,1,79537,0
100103,Clothing,62.73246383666992,2024-01-03,147,812,69.01760635375976,66641.67626800537,2,1,0,1,79684,0
100103,Clothing,62.73246383666992,2024-01-04,61,0,68.33521270751953,4168.447975158691,3,1,0,1,79745,0
100103,Clothing,62.73246383666992,2024-01-05,124,0,68.33521270751953,8473.566375732422,4,1,0,1,79869,0
100103,Clothing,62.73246383666992,2024-01-06,178,0,68.33521270751953,12163.667861938477,5,1,1,1,80047,0
100103,Clothing,62.73246383666992,2024-01-07,118,0,68.33521270751953,8063.555099487305,6,1,1,1,80165,0
100103,Clothing,62.73246383666992,2024-01-08,73,0,68.33521270751953,4988.470527648926,0,1,0,2,80238,0
100103,Clothing,62.73246383666992,2024-01-09,32,0,68.33521270751953,2186.726806640625,1,1,0,2,80270,0
100103,Clothing,62.73246383666992,2024-01-10,127,0,68.33521270751953,8678.57201385498,2,1,0,2,80397,0
100103,Clothing,62.73246383666992,2024-01-11,132,658,57.945962524414064,44069.93410644531,3,1,0,2,80529,0
100103,Clothing,62.73246383666992,2024-01-12,110,0,61.191925048828125,6731.111755371094,4,1,0,2,80639,0
100103,Clothing,62.73246383666992,2024-01-13,109,0,61.191925048828125,6669.919830322266,5,1,1,2,80748,0
100103,Clothing,62.73246383666992,2024-01-14,78,0,61.191925048828125,4772.970153808594,6,1,1,2,80826,0
100103,Clothing,62.73246383666992,2024-01-15,68,0,61.191925048828125,4161.0509033203125,0,1,0,3,80894,0
100103,Clothing,62.73246383666992,2024-01-16,116,0,61.191925048828125,7098.2633056640625,1,1,0,3,81010,0
100103,Clothing,62.73246383666992,2024-01-17,69,0,61.191925048828125,4222.242828369141,2,1,0,3,81079,0
100103,Clothing,62.73246383666992,2024-01-18,94,0,61.191925048828125,5752.040954589844,3,1,0,3,81173,0
100103,Clothing,62.73246383666992,2024-01-19,126,509,59.75911178588867,37771.19617004394,4,1,0,3,81299,0
100103,Clothing,62.73246383666992,2024-01-20,67,0,60.218223571777344,4034.620979309082,5,1,1,3,81366,0
100103,Clothing,62.73246383666992,2024-01-21,80,0,60.218223571777344,4817.4578857421875,6,1,1,3,81446,0
100103,Clothing,62.73246383666992,2024-01-22,142,842,59.88069595336914,58852.11765075684,0,1,0,4,81588,0
100103,Clothing,62.73246383666992,2024-01-23,60,0,59.98139190673828,3598.883514404297,1,1,0,4,81648,0
100103,Clothing,62.73246383666992,2024-01-24,171,0,59.98139190673828,10256.818016052246,2,1,0,4,81819,0
100103,Clothing,62.73246383666992,2024-01-25,236,0,59.98139190673828,14155.608489990234,3,1,0,4,82055,0
100103,Clothing,62.73246383666992,2024-01-26,75,0,59.98139190673828,4498.604393005371,4,1,0,4,82130,0
100103,Clothing,62.73246383666992,2024-01-27,65,0,59.98139190673828,3898.7904739379883,5,1,1,4,82195,0
100103,Clothing,62.73246383666992,2024-01-28,153,813,64.10123191833496,62825.1769670105,6,1,1,4,82348,0
100103,Clothing,62.73246383666992,2024-01-29,222,0,62.73246383666992,13926.606971740723,0,1,0,5,82570,0
100103,Clothing,62.73246383666992,2024-01-30,151,0,62.73246383666992,9472.602039337158,1,1,0,5,82721,0
100104,Electronics,110.23656463623047,2022-01-01,45,241,87.62999862670898,25062.179876403807,5,1,1,52,45,1
100104,Electronics,110.23656463623047,2022-01-02,82,183,90.60311157226562,24114.55029785156,6,1,1,52,127,1
100104,Electronics,110.23656463623047,2022-01-03,55,0,89.56622314453125,4926.142272949219,0,1,0,1,182,1
100104,Electronics,110.23656463623047,2022-01-04,58,0,89.56622314453125,5194.8409423828125,1,1,0,1,240,1
100104,Electronics,110.23656463623047,2022-01-05,38,0,89.56622314453125,3403.5164794921875,2,1,0,1,278,1
100104,Electronics,110.23656463623047,2022-01-06,41,115,80.2985969543457,12260.284950256348,3,1,0,1,319,1
100104,Electronics,110.23656463623047,2022-01-07,65,0,83.8971939086914,5453.317604064941,4,1,0,1,384,1
100104,Electronics,110.23656463623047,2022-01-08,32,0,83.8971939086914,2684.710205078125,5,1,1,1,416,1
100104,Electronics,110.23656463623047,2022-01-09,82,233,107.62496475219726,34650.07421936035,6,1,1,1,498,1
100104,Electronics,110.23656463623047,2022-01-10,32,0,102.66992950439453,3285.437744140625,0,1,0,2,530,1
100104,Electronics,110.23656463623047,2022-01-11,49,0,102.66992950439453,5030.826545715332,1,1,0,2,579,1
100104,Electronics,110.23656463623047,2022-01-12,82,202,103.68261611938476,29485.149043579102,2,1,0,2,661,1
100104,Electronics,110.23656463623047,2022-01-13,97,0,103.35523223876953,10025.457527160645,3,1,0,2,758,1
100104,Electronics,110.23656463623047,2022-01-14,125,291,111.26028366088867,46639.47091522217,4,1,0,2,883,1
100104,Electronics,110.23656463623047,2022-01-15,89,0,109.12056732177734,9711.730491638184,5,1,1,2,972,1
100104,Electronics,110.23656463623047,2022-01-16,113,233,101.36421829223633,34712.71333404542,6,1,1,2,1085,1
100104,Electronics,110.23656463623047,2022-01-17,31,0,104.35843658447266,3235.1115341186523,0,1,0,3,1116,1
100104,Electronics,110.23656463623047,2022-01-18,93,0,104.35843658447266,9705.334602355957,1,1,0,3,1209,1
100104,Electronics,110.23656463623047,2022-01-19,74,0,104.35843658447266,7722.524307250977,2,1,0,3,1283,1
100104,Electronics,110.23656463623047,2022-01-20,79,223,116.27421493530274,35672.92595977783,3,1,0,3,1362,1
100104,Electronics,110.23656463623047,2022-01-21,129,0,112.39842987060547,14499.397453308105,4,1,0,3,1491,1
100104,Electronics,110.23656463623047,2022-01-22,58,0,112.39842987060547,6519.108932495117,5,1,1,3,1549,1
100104,Electronics,110.23656463623047,2022-01-23,58,0,112.39842987060547,6519.108932495117,6,1,1,3,1607,1
100104,Electronics,110.23656463623047,2022-01-24,53,149,97.7838412475586,19364.12717224121,0,1,0,4,1660,1
100104,Electronics,110.23656463623047,2022-01-25,61,227,112.00216613769531,32790.78426879883,1,1,0,4,1721,1
100104,Electronics,110.23656463623047,2022-01-26,149,0,108.78433227539062,16208.865509033203,2,1,0,4,1870,1
100104,Electronics,110.23656463623047,2022-01-27,76,0,108.78433227539062,8267.609252929688,3,1,0,4,1946,1
100104,Electronics,110.23656463623047,2022-01-28,59,140,95.36976715087891,18597.902523803714,4,1,0,4,2005,1
100104,Electronics,110.23656463623047,2022-01-29,92,308,116.21330780029297,47439.32863525391,5,1,1,4,2097,1
100104,Electronics,110.23656463623047,2022-01-30,65,0,111.79661560058594,7266.780014038086,6,1,1,4,2162,1
100104,Electronics,110.23656463623047,2022-01-31,94,0,111.79661560058594,10508.881866455078,0,1,0,5,2256,1
100104,Electronics,110.23656463623047,2022-02-01,66,0,111.79661560058594,7378.576629638672,1,2,0,5,2322,1
100104,Electronics,110.23656463623047,2022-02-02,143,233,104.09325103759765,38914.66979675293,2,2,0,5,2465,1
100104,Electronics,110.23656463623047,2022-02-03,80,0,106.58650207519531,8526.920166015625,3,2,0,5,2545,1
100104,Electronics,110.23656463623047,2022-02-04,74,257,112.39747665405272,37535.256544799806,4,2,0,5,2619,1
100104,Electronics,110.23656463623047,2022-02-05,128,0,110.58495330810547,14154.8740234375,5,2,1,5,2747,1
100104,Electronics,110.23656463623047,2022-02-06,90,0,110.58495330810547,9952.645797729492,6,2,1,5,2837,1
100104,Electronics,110.23656463623047,2022-02-07,162,280,113.80014831542968,50398.768054199216,0,2,0,6,2999,1
100104,Electronics,110.23656463623047,2022-02-08,36,0,112.96029663085938,4066.5706787109375,1,2,0,6,3035,1
100104,Electronics,110.23656463623047,2022-02-09,128,289,113.5933937072754,47401.7087890625,2,2,0,6,3163,1
100104,Electronics,110.23656463623047,2022-02-10,93,0,113.38678741455078,10544.971229553223,3,2,0,6,3256,1
100104,Electronics,110.23656463623047,2022-02-11,98,0,113.38678741455078,11111.905166625977,4,2,0,6,3354,1
100104,Electronics,110.23656463623047,2022-02-12,88,251,108.45091369628906,36497.39081054687,5,2,1,6,3442,1
100104,Electronics,110.23656463623047,2022-02-13,21,0,110.09182739257812,2311.9283752441406,6,2,1,6,3463,1
100104,Electronics,110.23656463623047,2022-02-14,46,0,110.09182739257812,5064.224060058594,0,2,0,7,3509,1
100104,Electronics,110.23656463623047,2022-02-15,37,0,110.09182739257812,4073.3976135253906,1,2,0,7,3546,1
100104,Electronics,110.23656463623047,2022-02-16,50,0,110.09182739257812,5504.591369628906,2,2,0,7,3596,1
100104,Electronics,110.23656463623047,2022-02-17,57,0,110.09182739257812,6275.234161376953,3,2,0,7,3653,1
100104,Electronics,110.23656463623047,2022-02-18,71,186,110.91153106689453,28537.437411499024,4,2,0,7,3724,1
100104,Electronics,110.23656463623047,2022-02-19,67,0,110.62306213378906,7411.745162963867,5,2,1,7,3791,1
100104,Electronics,110.23656463623047,2022-02-20,93,0,110.62306213378906,10287.944778442383,6,2,1,7,3884,1
100104,Electronics,110.23656463623047,2022-02-21,119,209,109.31669662475585,35823.773796691894,0,2,0,8,4003,1
100104,Electronics,110.23656463623047,2022-02-22,38,0,109.67339324951172,4167.588943481445,1,2,0,8,4041,1
100104,Electronics,110.23656463623047,2022-02-23,209,448,128.18812057495117,85056.54440032959,2,2,0,8,4250,1
100104,Electronics,110.23656463623047,2022-02-25,57,0,124.68624114990234,7107.115745544434,4,2,0,8,4307,1
100104,Electronics,110.23656463623047,2022-02-26,102,0,124.68624114990234,12717.996597290039,5,2,1,8,4409,1
100104,Electronics,110.23656463623047,2022-02-27,120,348,122.05268920898438,56944.48541015625,6,2,1,8,4529,1
100104,Electronics,110.23656463623047,2022-02-28,54,0,122.82537841796875,6632.5704345703125,0,2,0,9,4583,1
100104,Electronics,110.23656463623047,2022-03-01,101,0,122.82537841796875,12405.363220214844,1,3,0,9,4684,1
100104,Electronics,110.23656463623047,2022-03-02,53,0,122.82537841796875,6509.745056152344,2,3,0,9,4737,1
100104,Electronics,110.23656463623047,2022-03-03,69,0,122.82537841796875,8474.951110839844,3,3,0,9,4806,1
100104,Electronics,110.23656463623047,2022-03-04,35,0,122.82537841796875,4298.888244628906,4,3,0,9,4841,1
100104,Electronics,110.23656463623047,2022-03-05,87,0,122.82537841796875,10685.807922363281,5,3,1,9,4928,1
100104,Electronics,110.23656463623047,2022-03-06,61,115,101.01535278320313,17379.353039550784,6,3,1,9,4989,1
100104,Electronics,110.23656463623047,2022-03-07,57,208,97.85710693359374,25465.980190429687,0,3,0,10,5046,1
100104,Electronics,110.23656463623047,2022-03-08,46,0,100.9442138671875,4643.433837890625,1,3,0,10,5092,1
100104,Electronics,110.23656463623047,2022-03-09,72,0,100.9442138671875,7267.9833984375,2,3,0,10,5164,1
100104,Electronics,110.23656463623047,2022-03-10,66,0,100.9442138671875,6662.318115234375,3,3,0,10,5230,1
100104,Electronics,110.23656463623047,2022-03-11,139,290,104.72842071533202,45038.9609588623,4,3,0,10,5369,1
100104,Electronics,110.23656463623047,2022-03-13,125,0,103.99684143066406,12999.605178833008,6,3,1,10,5494,1
100104,Electronics,110.23656463623047,2022-03-14,73,173,98.88922988891602,24161.82756378174,0,3,0,11,5567,1
100104,Electronics,110.23656463623047,2022-03-15,92,0,100.53845977783203,9249.538299560547,1,3,0,11,5659,1
100104,Electronics,110.23656463623047,2022-03-16,111,188,104.16668060302734,31233.87309387207,2,3,0,11,5770,1
100104,Electronics,110.23656463623047,2022-03-17,62,227,109.10893035888671,31889.057364501954,3,3,0,11,5832,1
100104,Electronics,110.23656463623047,2022-03-18,85,0,106.94786071777344,9090.568161010742,4,3,0,11,5917,1
100104,Electronics,110.23656463623047,2022-03-19,93,0,106.94786071777344,9946.15104675293,5,3,1,11,6010,1
100104,Electronics,110.23656463623047,2022-03-20,91,261,115.43108657836913,41082.05775726319,6,3,1,11,6101,1
100104,Electronics,110.23656463623047,2022-03-21,36,0,112.78217315673828,4060.158233642578,0,3,0,12,6137,1
100104,Electronics,110.23656463623047,2022-03-22,74,0,112.78217315673828,8345.880813598633,1,3,0,12,6211,1
100104,Electronics,110.23656463623047,2022-03-23,51,0,112.78217315673828,5751.890830993652,2,3,0,12,6262,1
100104,Electronics,110.23656463623047,2022-03-24,97,258,111.15523284912109,39375.545172729486,3,3,0,12,6359,1
100104,Electronics,110.23656463623047,2022-03-25,68,0,111.68046569824219,7594.271667480469,4,3,0,12,6427,1
100104,Electronics,110.23656463623047,2022-03-26,62,0,111.68046569824219,6924.188873291016,5,3,1,12,6489,1
100104,Electronics,110.23656463623047,2022-03-27,151,369,110.95734680175781,57654.79873413086,6,3,1,12,6640,1
100104,Electronics,110.23656463623047,2022-03-28,94,0,111.15469360351562,10448.541198730469,0,3,0,13,6734,1
100104,Electronics,110.23656463623047,2022-03-29,105,0,111.15469360351562,11671.24282836914,1,3,0,13,6839,1
100104,Electronics,110.23656463623047,2022-03-30,136,235,110.32183456420898,40897.539001464844,2,3,0,13,6975,1
100104,Electronics,110.23656463623047,2022-03-31,85,0,110.64366912841797,9404.711875915527,3,3,0,13,7060,1
100104,Electronics,110.23656463623047,2022-04-01,154,465,134.99273590087893,85453.64265747071,4,4,0,13,7214,1
100104,Electronics,110.23656463623047,2022-04-02,34,0,128.9054718017578,4382.786041259766,5,4,1,13,7248,1
100104,Electronics,110.23656463623047,2022-04-03,104,0,128.9054718017578,13406.169067382812,6,4,1,13,7352,1
100104,Electronics,110.23656463623047,2022-04-04,74,0,128.9054718017578,9539.004913330078,0,4,0,14,7426,1
100104,Electronics,110.23656463623047,2022-04-05,87,0,128.9054718017578,11214.77604675293,1,4,0,14,7513,1
100104,Electronics,110.23656463623047,2022-04-06,219,355,118.03252822875976,67289.28736419677,2,4,0,14,7732,1
100104,Electronics,110.23656463623047,2022-04-07,99,0,121.42505645751953,12021.080589294434,3,4,0,14,7831,1
100104,Electronics,110.23656463623047,2022-04-08,145,0,121.42505645751953,17606.633186340332,4,4,0,14,7976,1
100104,Electronics,110.23656463623047,2022-04-09,94,0,121.42505645751953,11413.955307006836,5,4,1,14,8070,1
100104,Electronics,110.23656463623047,2022-04-10,46,146,105.59166549682618,19812.43322570801,6,4,1,14,8116,1
100104,Electronics,110.23656463623047,2022-04-11,74,266,104.34412902832031,35147.89109619141,0,4,0,15,8190,1
100104,Electronics,110.23656463623047,2022-04-12,71,0,106.05825805664062,7530.136322021484,1,4,0,15,8261,1
100104,Electronics,110.23656463623047,2022-04-13,113,0,106.05825805664062,11984.58316040039,2,4,0,15,8374,1
100104,Electronics,110.23656463623047,2022-04-14,166,343,126.74070281982422,65424.213336181645,3,4,0,15,8540,1
100104,Electronics,110.23656463623047,2022-04-15,62,0,121.58140563964844,7538.047149658203,4,4,0,15,8602,1
100104,Electronics,110.23656463623047,2022-04-16,47,0,121.58140563964844,5714.326065063477,5,4,1,15,8649,1
100104,Electronics,110.23656463623047,2022-04-17,154,397,116.18535171508789,63662.04832824707,6,4,1,15,8803,1
100104,Electronics,110.23656463623047,2022-04-18,126,0,117.65070343017578,14823.988632202148,0,4,0,16,8929,1
100104,Electronics,110.23656463623047,2022-04-19,78,0,117.65070343017578,9176.754867553711,1,4,0,16,9007,1
100104,Electronics,110.23656463623047,2022-04-20,158,0,117.65070343017578,18588.811141967773,2,4,0,16,9165,1
100104,Electronics,110.23656463623047,2022-04-21,43,0,117.65070343017578,5058.980247497559,3,4,0,16,9208,1
100104,Electronics,110.23656463623047,2022-04-22,44,102,98.48732025146484,13938.504182128907,4,4,0,16,9252,1
100104,Electronics,110.23656463623047,2022-04-23,90,147,96.97060638427735,22776.79914916992,5,4,1,16,9342,1
100104,Electronics,110.23656463623047,2022-04-24,38,0,100.57121276855469,3821.706085205078,6,4,1,16,9380,1
100104,Electronics,110.23656463623047,2022-04-25,70,0,100.57121276855469,7039.984893798828,0,4,0,17,9450,1
100104,Electronics,110.23656463623047,2022-04-26,37,0,100.57121276855469,3721.1348724365234,1,4,0,17,9487,1
100104,Electronics,110.23656463623047,2022-04-27,49,97,88.35379592895508,12694.992001037597,2,4,0,17,9536,1
100104,Electronics,110.23656463623047,2022-04-28,33,0,92.61759185791016,3056.380531311035,3,4,0,17,9569,1
100104,Electronics,110.23656463623047,2022-04-29,36,64,89.18416275024414,8872.099718017578,4,4,0,17,9605,1
100104,Electronics,110.23656463623047,2022-04-30,26,0,90.83832550048828,2361.7964630126953,5,4,1,17,9631,1
100104,Electronics,110.23656463623047,2022-05-01,59,151,88.19587966918945,18451.593800964358,6,5,1,17,9690,1
100104,Electronics,110.23656463623047,2022-05-02,40,0,88.9517593383789,3558.0703735351562,0,5,0,18,9730,1
100104,Electronics,110.23656463623047,2022-05-03,29,0,88.9517593383789,2579.6010208129883,1,5,0,18,9759,1
100104,Electronics,110.23656463623047,2022-05-04,26,0,88.9517593383789,2312.7457427978516,2,5,0,18,9785,1
100104,Electronics,110.23656463623047,2022-05-05,51,134,74.75878616333009,13470.256188659669,3,5,0,18,9836,1
100104,Electronics,110.23656463623047,2022-05-06,51,0,79.09757232666016,4033.976188659668,4,5,0,18,9887,1
100104,Electronics,110.23656463623047,2022-05-07,49,135,79.55620513916016,14652.428103637696,5,5,1,18,9936,1
100104,Electronics,110.23656463623047,2022-05-08,44,0,79.39241027832031,3493.2660522460938,6,5,1,18,9980,1
100104,Electronics,110.23656463623047,2022-05-09,34,0,79.39241027832031,2699.3419494628906,0,5,0,19,10014,1
100104,Electronics,110.23656463623047,2022-05-10,30,0,79.39241027832031,2381.7723083496094,1,5,0,19,10044,1
100104,Electronics,110.23656463623047,2022-05-11,46,140,85.79982879638672,16147.724249267578,2,5,0,19,10090,1
100104,Electronics,110.23656463623047,2022-05-12,73,0,83.78965759277344,6116.645004272461,3,5,0,19,10163,1
100104,Electronics,110.23656463623047,2022-05-13,44,0,83.78965759277344,3686.7449340820312,4,5,0,19,10207,1
100104,Electronics,110.23656463623047,2022-05-14,72,207,82.98316207885742,23130.275339355467,5,5,1,19,10279,1
100104,Electronics,110.23656463623047,2022-05-15,33,0,83.14632415771484,2743.82869720459,6,5,1,19,10312,1
100104,Electronics,110.23656463623047,2022-05-16,60,0,83.14632415771484,4988.779449462891,0,5,0,20,10372,1
100104,Electronics,110.23656463623047,2022-05-17,44,116,90.13092987060547,14616.001828613282,1,5,0,20,10416,1
100104,Electronics,110.23656463623047,2022-05-18,61,0,87.42185974121094,5332.733444213867,2,5,0,20,10477,1
100104,Electronics,110.23656463623047,2022-05-19,32,0,87.42185974121094,2797.49951171875,3,5,0,20,10509,1
100104,Electronics,110.23656463623047,2022-05-20,28,0,87.42185974121094,2447.8120727539062,4,5,0,20,10537,1
100104,Electronics,110.23656463623047,2022-05-21,28,82,86.68544967651367,9520.525181884765,5,5,1,20,10565,1
100104,Electronics,110.23656463623047,2022-05-22,49,144,99.02307006835937,19507.31086669922,6,5,1,20,10614,1
100104,Electronics,110.23656463623047,2022-05-23,36,0,94.85614013671875,3414.821044921875,0,5,0,21,10650,1
100104,Electronics,110.23656463623047,2022-05-24,28,0,94.85614013671875,2655.971923828125,1,5,0,21,10678,1
100104,Electronics,110.23656463623047,2022-05-25,52,0,94.85614013671875,4932.519287109375,2,5,0,21,10730,1
100104,Electronics,110.23656463623047,2022-05-26,131,248,115.81999359130859,44408.23832092286,3,5,0,21,10861,1
100104,Electronics,110.23656463623047,2022-05-27,0,202,115.74,23379.48,4,5,0,21,10861,1
100104,Electronics,110.23656463623047,2022-05-28,73,0,113.3702163696289,8276.02579498291,5,5,1,21,10934,1
100104,Electronics,110.23656463623047,2022-05-29,40,0,113.3702163696289,4534.808654785156,6,5,1,21,10974,1
100104,Electronics,110.23656463623047,2022-05-30,59,0,113.3702163696289,6688.8427658081055,0,5,0,22,11033,1
100104,Electronics,110.23656463623047,2022-05-31,68,0,113.3702163696289,7709.174713134766,1,5,0,22,11101,1
100104,Electronics,110.23656463623047,2022-06-01,94,247,101.46983047485352,34058.088129272466,2,6,0,22,11195,1
100104,Electronics,110.23656463623047,2022-06-02,116,386,127.48503967285156,65937.42920410156,3,6,0,22,11311,1
100104,Electronics,110.23656463623047,2022-06-03,93,0,120.30007934570312,11187.90737915039,4,6,0,22,11404,1
100104,Electronics,110.23656463623047,2022-06-04,120,0,120.30007934570312,14436.009521484375,5,6,1,22,11524,1
100104,Electronics,110.23656463623047,2022-06-05,48,0,120.30007934570312,5774.40380859375,6,6,1,22,11572,1
100104,Electronics,110.23656463623047,2022-06-06,79,0,120.30007934570312,9503.706268310547,0,6,0,23,11651,1
100104,Electronics,110.23656463623047,2022-06-07,64,0,120.30007934570312,7699.205078125,1,6,0,23,11715,1
100104,Electronics,110.23656463623047,2022-06-08,138,307,122.18732986450195,54460.00304260254,2,6,0,23,11853,1
100104,Electronics,110.23656463623047,2022-06-09,91,0,121.6746597290039,11072.394035339355,3,6,0,23,11944,1
100104,Electronics,110.23656463623047,2022-06-10,226,369,120.0710952758789,71374.93506469726,4,6,0,23,12170,1
100104,Electronics,110.23656463623047,2022-06-11,81,0,120.54219055175781,9763.917434692383,5,6,1,23,12251,1
100104,Electronics,110.23656463623047,2022-06-12,103,0,120.54219055175781,12415.845626831055,6,6,1,23,12354,1
100104,Electronics,110.23656463623047,2022-06-13,63,0,120.54219055175781,7594.158004760742,0,6,0,24,12417,1
100104,Electronics,110.23656463623047,2022-06-14,70,199,108.19164825439452,28565.410755615234,1,6,0,24,12487,1
100104,Electronics,110.23656463623047,2022-06-15,119,0,112.36329650878906,13371.232284545898,2,6,0,24,12606,1
100104,Electronics,110.23656463623047,2022-06-16,85,0,112.36329650878906,9550.88020324707,3,6,0,24,12691,1
100104,Electronics,110.23656463623047,2022-06-17,128,348,135.7907827758789,65437.040390625,4,6,0,24,12819,1
100104,Electronics,110.23656463623047,2022-06-19,71,0,132.1515655517578,9382.761154174805,6,6,1,24,12890,1
100104,Electronics,110.23656463623047,2022-06-20,97,316,122.48553421020509,49941.453636779785,0,6,0,25,12987,1
100104,Electronics,110.23656463623047,2022-06-21,154,0,125.43106842041016,19316.384536743164,1,6,0,25,13141,1
100104,Electronics,110.23656463623047,2022-06-22,77,0,125.43106842041016,9658.192268371582,2,6,0,25,13218,1
100104,Electronics,110.23656463623047,2022-06-23,121,0,125.43106842041016,15177.159278869629,3,6,0,25,13339,1
100104,Electronics,110.23656463623047,2022-06-24,57,158,105.47661041259767,22046.563587036133,4,6,0,25,13396,1
100104,Electronics,110.23656463623047,2022-06-25,87,0,111.72322082519531,9719.920211791992,5,6,1,25,13483,1
100104,Electronics,110.23656463623047,2022-06-26,142,336,134.13387603759764,64943.620794677736,6,6,1,25,13625,1
100104,Electronics,110.23656463623047,2022-06-27,16,0,129.8677520751953,2077.884033203125,0,6,0,26,13641,1
100104,Electronics,110.23656463623047,2022-06-28,63,0,129.8677520751953,8181.668380737305,1,6,0,26,13704,1
100104,Electronics,110.23656463623047,2022-06-29,47,0,129.8677520751953,6103.78434753418,2,6,0,26,13751,1
100104,Electronics,110.23656463623047,2022-06-30,24,0,129.8677520751953,3116.8260498046875,3,6,0,26,13775,1
100104,Electronics,110.23656463623047,2022-07-01,87,0,129.8677520751953,11298.494430541992,4,7,0,26,13862,1
100104,Electronics,110.23656463623047,2022-07-02,64,203,87.90287811279296,22182.5283984375,5,7,1,26,13926,1
100104,Electronics,110.23656463623047,2022-07-03,51,0,97.16575622558594,4955.453567504883,6,7,1,26,13977,1
100104,Electronics,110.23656463623047,2022-07-04,39,0,97.16575622558594,3789.4644927978516,0,7,0,27,14016,1
100104,Electronics,110.23656463623047,2022-07-05,55,111,96.74764266967773,16050.16069366455,1,7,0,27,14071,1
100104,Electronics,110.23656463623047,2022-07-06,55,0,96.92528533935547,5330.890693664551,2,7,0,27,14126,1
100104,Electronics,110.23656463623047,2022-07-07,40,0,96.92528533935547,3877.0114135742188,3,7,0,27,14166,1
100104,Electronics,110.23656463623047,2022-07-08,66,105,98.93143829345703,16946.46985473633,4,7,0,27,14232,1
100104,Electronics,110.23656463623047,2022-07-09,41,0,98.18287658691406,4025.4979400634766,5,7,1,27,14273,1
100104,Electronics,110.23656463623047,2022-07-10,41,0,98.18287658691406,4025.4979400634766,6,7,1,27,14314,1
100104,Electronics,110.23656463623047,2022-07-11,12,0,98.18287658691406,1178.1945190429688,0,7,0,28,14326,1
100104,Electronics,110.23656463623047,2022-07-12,39,108,93.98696945190429,13745.223617248534,1,7,0,28,14365,1
100104,Electronics,110.23656463623047,2022-07-13,15,0,95.0139389038086,1425.209083557129,2,7,0,28,14380,1
100104,Electronics,110.23656463623047,2022-07-14,30,107,95.31101318359376,13066.000791015626,3,7,0,28,14410,1
100104,Electronics,110.23656463623047,2022-07-15,24,0,95.2020263671875,2284.8486328125,4,7,0,28,14434,1
100104,Electronics,110.23656463623047,2022-07-16,152,359,108.22458877563477,55835.874987792966,5,7,1,28,14586,1
100104,Electronics,110.23656463623047,2022-07-17,25,0,105.64917755126953,2641.2294387817383,6,7,1,28,14611,1
100104,Electronics,110.23656463623047,2022-07-18,66,0,105.64917755126953,6972.845718383789,0,7,0,29,14677,1
100104,Electronics,110.23656463623047,2022-07-19,26,0,105.64917755126953,2746.878616333008,1,7,0,29,14703,1
100104,Electronics,110.23656463623047,2022-07-20,27,0,105.64917755126953,2852.5277938842773,2,7,0,29,14730,1
100104,Electronics,110.23656463623047,2022-07-21,30,0,105.64917755126953,3169.475326538086,3,7,0,29,14760,1
100104,Electronics,110.23656463623047,2022-07-22,60,0,105.64917755126953,6338.950653076172,4,7,0,29,14820,1
100104,Electronics,110.23656463623047,2022-07-23,111,196,97.88794052124024,29869.02279571533,5,7,1,29,14931,1
100104,Electronics,110.23656463623047,2022-07-24,39,0,100.03588104248047,3901.3993606567383,6,7,1,29,14970,1
100104,Electronics,110.23656463623047,2022-07-25,86,177,100.66559249877929,26495.471909790038,0,7,0,30,15056,1
100104,Electronics,110.23656463623047,2022-07-26,47,0,100.4411849975586,4720.735694885254,1,7,0,30,15103,1
100104,Electronics,110.23656463623047,2022-07-27,108,259,110.04060653686523,40843.85101196289,2,7,0,30,15211,1
100104,Electronics,110.23656463623047,2022-07-28,92,0,107.00121307373047,9844.111602783203,3,7,0,30,15303,1
100104,Electronics,110.23656463623047,2022-07-29,102,0,107.00121307373047,10914.123733520508,4,7,0,30,15405,1
100104,Electronics,110.23656463623047,2022-07-30,95,186,116.93924087524414,33173.03576629639,5,7,1,30,15500,1
100104,Electronics,110.23656463623047,2022-07-31,71,0,113.49848175048828,8058.392204284668,6,7,1,30,15571,1
100104,Electronics,110.23656463623047,2022-08-01,89,196,108.5376527404785,30744.092187805174,0,8,0,31,15660,1
100104,Electronics,110.23656463623047,2022-08-02,106,0,110.30530548095703,11692.362380981445,1,8,0,31,15766,1
100104,Electronics,110.23656463623047,2022-08-03,144,242,108.09606369018555,41657.84634277344,2,8,0,31,15910,1
100104,Electronics,110.23656463623047,2022-08-04,74,0,108.7821273803711,8049.877426147461,3,8,0,31,15984,1
100104,Electronics,110.23656463623047,2022-08-05,43,0,108.7821273803711,4677.631477355957,4,8,0,31,16027,1
100104,Electronics,110.23656463623047,2022-08-06,170,334,123.63163330078126,62869.315322265626,5,8,1,31,16197,1
100104,Electronics,110.23656463623047,2022-08-07,29,0,120.2232666015625,3486.4747314453125,6,8,1,31,16226,1
100104,Electronics,110.23656463623047,2022-08-08,83,0,120.2232666015625,9978.531127929688,0,8,0,32,16309,1
100104,Electronics,110.23656463623047,2022-08-09,106,233,101.30330642700196,33500.66096252442,1,8,0,32,16415,1
100104,Electronics,110.23656463623047,2022-08-10,142,0,107.9266128540039,15325.579025268555,2,8,0,32,16557,1
100104,Electronics,110.23656463623047,2022-08-11,105,189,104.62068252563476,30651.7433303833,3,8,0,32,16662,1
100104,Electronics,110.23656463623047,2022-08-12,131,0,105.89136505126953,13871.768821716309,4,8,0,32,16793,1
100104,Electronics,110.23656463623047,2022-08-13,106,235,106.58194412231445,36369.99215393067,5,8,1,32,16899,1
100104,Electronics,110.23656463623047,2022-08-14,69,0,106.3838882446289,7340.4882888793945,6,8,1,32,16968,1
100104,Electronics,110.23656463623047,2022-08-15,100,248,106.72574417114258,37157.468834228515,0,8,0,33,17068,1
100104,Electronics,110.23656463623047,2022-08-16,87,0,106.61148834228516,9275.199485778809,1,8,0,33,17155,1
100104,Electronics,110.23656463623047,2022-08-17,119,392,130.54742340087893,68561.3767694092,2,8,0,33,17274,1
100104,Electronics,110.23656463623047,2022-08-18,88,0,123.76484680175781,10891.306518554688,3,8,0,33,17362,1
100104,Electronics,110.23656463623047,2022-08-19,90,0,123.76484680175781,11138.836212158203,4,8,0,33,17452,1
100104,Electronics,110.23656463623047,2022-08-20,86,0,123.76484680175781,10643.776824951172,5,8,1,33,17538,1
100104,Electronics,110.23656463623047,2022-08-21,180,311,108.45130432128906,52569.52955566406,6,8,1,33,17718,1
100104,Electronics,110.23656463623047,2022-08-22,64,0,113.64260864257812,7273.126953125,0,8,0,34,17782,1
100104,Electronics,110.23656463623047,2022-08-23,184,0,113.64260864257812,20910.239990234375,1,8,0,34,17966,1
100104,Electronics,110.23656463623047,2022-08-24,104,211,112.38659500122071,35358.271760253905,2,8,0,34,18070,1
100104,Electronics,110.23656463623047,2022-08-25,98,288,110.73027313232421,42605.03353393555,3,8,0,34,18168,1
100104,Electronics,110.23656463623047,2022-08-26,76,0,111.45054626464844,8470.241516113281,4,8,0,34,18244,1
100104,Electronics,110.23656463623047,2022-08-27,39,0,111.45054626464844,4346.571304321289,5,8,1,34,18283,1
100104,Electronics,110.23656463623047,2022-08-28,76,0,111.45054626464844,8470.241516113281,6,8,1,34,18359,1
100104,Electronics,110.23656463623047,2022-08-29,47,0,111.45054626464844,5238.175674438477,0,8,0,35,18406,1
100104,Electronics,110.23656463623047,2022-08-30,102,0,111.45054626464844,11367.95571899414,1,8,0,35,18508,1
100104,Electronics,110.23656463623047,2022-08-31,56,135,103.15468887329101,19459.645153808593,2,8,0,35,18564,1
100104,Electronics,110.23656463623047,2022-09-01,57,0,106.22937774658203,6055.074531555176,3,9,0,35,18621,1
100104,Electronics,110.23656463623047,2022-09-02,117,213,104.14233184814452,34307.225652465815,4,9,0,35,18738,1
100104,Electronics,110.23656463623047,2022-09-03,64,0,104.76466369628906,6704.9384765625,5,9,1,35,18802,1
100104,Electronics,110.23656463623047,2022-09-04,64,0,104.76466369628906,6704.9384765625,6,9,1,35,18866,1
100104,Electronics,110.23656463623047,2022-09-05,46,0,104.76466369628906,4819.174530029297,0,9,0,36,18912,1
100104,Electronics,110.23656463623047,2022-09-06,103,226,101.90981811523437,33463.16253173828,1,9,0,36,19015,1
100104,Electronics,110.23656463623047,2022-09-08,110,221,107.39386764526367,35733.42088195801,3,9,0,36,19125,1
100104,Electronics,110.23656463623047,2022-09-09,116,355,104.03244506835938,48869.63725585937,4,9,0,36,19241,1
100104,Electronics,110.23656463623047,2022-09-10,111,0,104.57489013671875,11607.812805175781,5,9,1,36,19352,1
100104,Electronics,110.23656463623047,2022-09-11,119,0,104.57489013671875,12444.411926269531,6,9,1,36,19471,1
100104,Electronics,110.23656463623047,2022-09-12,64,0,104.57489013671875,6692.79296875,0,9,0,37,19535,1
100104,Electronics,110.23656463623047,2022-09-13,75,0,104.57489013671875,7843.116760253906,1,9,0,37,19610,1
100104,Electronics,110.23656463623047,2022-09-14,135,347,115.3617724609375,56129.75856445313,2,9,0,37,19745,1
100104,Electronics,110.23656463623047,2022-09-15,72,0,112.883544921875,8127.615234375,3,9,0,37,19817,1
100104,Electronics,110.23656463623047,2022-09-16,103,0,112.883544921875,11627.005126953125,4,9,0,37,19920,1
100104,Electronics,110.23656463623047,2022-09-17,54,0,112.883544921875,6095.71142578125,5,9,1,37,19974,1
100104,Electronics,110.23656463623047,2022-09-18,71,189,100.10463241577148,25522.79780303955,6,9,1,37,20045,1
100104,Electronics,110.23656463623047,2022-09-19,116,0,104.37926483154297,12107.994720458984,0,9,0,38,20161,1
100104,Electronics,110.23656463623047,2022-09-20,93,296,121.72264419555664,48212.32182037354,1,9,0,38,20254,1
100104,Electronics,110.23656463623047,2022-09-21,31,0,117.47528839111328,3641.7339401245117,2,9,0,38,20285,1
100104,Electronics,110.23656463623047,2022-09-22,67,0,117.47528839111328,7870.84432220459,3,9,0,38,20352,1
100104,Electronics,110.23656463623047,2022-09-23,86,0,117.47528839111328,10102.874801635742,4,9,0,38,20438,1
100104,Electronics,110.23656463623047,2022-09-24,164,273,125.61985046386718,55143.32095214844,5,9,1,38,20602,1
100104,Electronics,110.23656463623047,2022-09-25,47,0,123.34970092773438,5797.435943603516,6,9,1,38,20649,1
100104,Electronics,110.23656463623047,2022-09-26,140,330,117.42391082763672,54859.79503173828,0,9,0,39,20789,1
100104,Electronics,110.23656463623047,2022-09-27,73,0,119.15782165527344,8698.520980834961,1,9,0,39,20862,1
100104,Electronics,110.23656463623047,2022-09-28,112,0,119.15782165527344,13345.676025390625,2,9,0,39,20974,1
100104,Electronics,110.23656463623047,2022-09-29,14,0,119.15782165527344,1668.2095031738281,3,9,0,39,20988,1
100104,Electronics,110.23656463623047,2022-09-30,67,0,119.15782165527344,7983.57405090332,4,9,0,39,21055,1
100104,Electronics,110.23656463623047,2022-10-01,74,0,119.15782165527344,8817.678802490234,5,10,1,39,21129,1
100104,Electronics,110.23656463623047,2022-10-02,123,276,111.58071670532226,44309.456309509274,6,10,1,39,21252,1
100104,Electronics,110.23656463623047,2022-10-04,117,0,112.96143341064453,13216.48770904541,1,10,0,40,21369,1
100104,Electronics,110.23656463623047,2022-10-05,70,181,104.08035140991211,25823.319197387696,2,10,0,40,21439,1
100104,Electronics,110.23656463623047,2022-10-06,34,0,106.79070281982422,3630.8838958740234,3,10,0,40,21473,1
100104,Electronics,110.23656463623047,2022-10-07,79,0,106.79070281982422,8436.465522766113,4,10,0,40,21552,1
100104,Electronics,110.23656463623047,2022-10-08,72,187,106.88277633666992,27685.769792480467,5,10,1,40,21624,1
100104,Electronics,110.23656463623047,2022-10-09,85,0,106.85555267333984,9082.721977233887,6,10,1,40,21709,1
100104,Electronics,110.23656463623047,2022-10-10,134,244,107.97098602294922,40847.02425415039,0,10,0,41,21843,1
100104,Electronics,110.23656463623047,2022-10-11,53,0,107.66197204589844,5706.084518432617,1,10,0,41,21896,1
100104,Electronics,110.23656463623047,2022-10-12,45,0,107.66197204589844,4844.78874206543,2,10,0,41,21941,1
100104,Electronics,110.23656463623047,2022-10-13,80,219,100.83329162597656,29852.62666015625,3,10,0,41,22021,1
100104,Electronics,110.23656463623047,2022-10-14,101,0,102.96658325195312,10399.624908447266,4,10,0,41,22122,1
100104,Electronics,110.23656463623047,2022-10-15,86,328,114.68891754150391,48234.09381713867,5,10,1,41,22208,1
100104,Electronics,110.23656463623047,2022-10-16,48,0,111.57783508300781,5355.736083984375,6,10,1,41,22256,1
100104,Electronics,110.23656463623047,2022-10-17,54,0,111.57783508300781,6025.203094482422,0,10,0,42,22310,1
100104,Electronics,110.23656463623047,2022-10-18,71,0,111.57783508300781,7922.026290893555,1,10,0,42,22381,1
100104,Electronics,110.23656463623047,2022-10-19,37,0,111.57783508300781,4128.379898071289,2,10,0,42,22418,1
100104,Electronics,110.23656463623047,2022-10-20,58,0,111.57783508300781,6471.514434814453,3,10,0,42,22476,1
100104,Electronics,110.23656463623047,2022-10-21,39,0,111.57783508300781,4351.535568237305,4,10,0,42,22515,1
100104,Electronics,110.23656463623047,2022-10-22,61,156,108.84955352783203,23528.245530395507,5,10,1,42,22576,1
100104,Electronics,110.23656463623047,2022-10-23,111,397,122.47512252807617,63128.23720123291,6,10,1,42,22687,1
100104,Electronics,110.23656463623047,2022-10-24,106,0,119.29024505615234,12644.765975952148,0,10,0,43,22793,1
100104,Electronics,110.23656463623047,2022-10-25,108,0,119.29024505615234,12883.346466064453,1,10,0,43,22901,1
100104,Electronics,110.23656463623047,2022-10-26,69,0,119.29024505615234,8231.026908874512,2,10,0,43,22970,1
100104,Electronics,110.23656463623047,2022-10-27,106,0,119.29024505615234,12644.765975952148,3,10,0,43,23076,1
100104,Electronics,110.23656463623047,2022-10-28,96,221,124.75978958129883,39733.87959960937,4,10,0,43,23172,1
100104,Electronics,110.23656463623047,2022-10-29,68,305,131.9747750854492,49889.0594116211,5,10,1,43,23240,1
100104,Electronics,110.23656463623047,2022-10-30,68,0,129.17955017089844,8784.209411621094,6,10,1,43,23308,1
100104,Electronics,110.23656463623047,2022-10-31,133,0,129.17955017089844,17180.880172729492,0,10,0,44,23441,1
100104,Electronics,110.23656463623047,2022-11-01,102,0,129.17955017089844,13176.31411743164,1,11,0,44,23543,1
100104,Electronics,110.23656463623047,2022-11-02,162,313,116.60330047607422,54887.76935424805,2,11,0,44,23705,1
100104,Electronics,110.23656463623047,2022-11-03,59,0,119.90660095214844,7074.489456176758,3,11,0,44,23764,1
100104,Electronics,110.23656463623047,2022-11-04,130,321,136.65665527343748,62685.20037109374,4,11,0,44,23894,1
100104,Electronics,110.23656463623047,2022-11-05,139,0,131.143310546875,18228.920166015625,5,11,1,44,24033,1
100104,Electronics,110.23656463623047,2022-11-06,89,0,131.143310546875,11671.754638671875,6,11,1,44,24122,1
100104,Electronics,110.23656463623047,2022-11-07,82,0,131.143310546875,10753.75146484375,0,11,0,45,24204,1
100104,Electronics,110.23656463623047,2022-11-08,81,186,113.59529830932618,29694.138326110842,1,11,0,45,24285,1
100104,Electronics,110.23656463623047,2022-11-09,115,0,119.65059661865234,13759.81861114502,2,11,0,45,24400,1
100104,Electronics,110.23656463623047,2022-11-10,84,153,87.87334793090821,19997.06245239258,3,11,0,45,24484,1
100104,Electronics,110.23656463623047,2022-11-11,98,0,99.8866958618164,9788.896194458008,4,11,0,45,24582,1
100104,Electronics,110.23656463623047,2022-11-12,97,274,103.29171600341797,38455.44290466308,5,11,1,45,24679,1
100104,Electronics,110.23656463623047,2022-11-13,60,0,102.53343200683594,6152.005920410156,6,11,1,45,24739,1
100104,Electronics,110.23656463623047,2022-11-14,102,317,115.7052458190918,49335.07014709473,0,11,0,46,24841,1
100104,Electronics,110.23656463623047,2022-11-15,73,0,111.7304916381836,8156.325889587402,1,11,0,46,24914,1
100104,Electronics,110.23656463623047,2022-11-16,52,0,111.7304916381836,5809.985565185547,2,11,0,46,24966,1
100104,Electronics,110.23656463623047,2022-11-17,94,0,111.7304916381836,10502.666213989258,3,11,0,46,25060,1
100104,Electronics,110.23656463623047,2022-11-18,91,0,111.7304916381836,10167.474739074707,4,11,0,46,25151,1
100104,Electronics,110.23656463623047,2022-11-19,56,201,100.1559848022461,25223.020297851563,5,11,1,46,25207,1
100104,Electronics,110.23656463623047,2022-11-20,75,0,103.72196960449219,7779.147720336914,6,11,1,46,25282,1
100104,Electronics,110.23656463623047,2022-11-21,81,0,103.72196960449219,8401.479537963867,0,11,0,47,25363,1
100104,Electronics,110.23656463623047,2022-11-22,59,0,103.72196960449219,6119.596206665039,1,11,0,47,25422,1
100104,Electronics,110.23656463623047,2022-11-23,34,125,96.04951797485352,15059.887222290039,2,11,0,47,25456,1
100104,Electronics,110.23656463623047,2022-11-24,47,0,98.37903594970703,4623.8146896362305,3,11,0,47,25503,1
100104,Electronics,110.23656463623047,2022-11-25,62,165,88.72736068725587,19826.20272521973,4,11,0,47,25565,1
100104,Electronics,110.23656463623047,2022-11-26,86,0,91.78472137451172,7893.486038208008,5,11,1,47,25651,1
100104,Electronics,110.23656463623047,2022-11-27,103,149,97.50288681030273,24666.27468292236,6,11,1,47,25754,1
100104,Electronics,110.23656463623047,2022-11-28,67,0,95.42577362060547,6393.526832580566,0,11,0,48,25821,1
100104,Electronics,110.23656463623047,2022-11-29,88,141,98.09665466308593,22513.071220703125,1,11,0,48,25909,1
100104,Electronics,110.23656463623047,2022-11-30,61,200,101.89548324584962,26814.968955993652,2,11,0,48,25970,1
100104,Electronics,110.23656463623047,2022-12-01,127,0,100.31096649169922,12739.4927444458,3,12,0,48,26097,1
100104,Electronics,110.23656463623047,2022-12-02,55,0,100.31096649169922,5517.103157043457,4,12,0,48,26152,1
100104,Electronics,110.23656463623047,2022-12-03,78,170,106.43777114868163,26576.172299194335,5,12,1,48,26230,1
100104,Electronics,110.23656463623047,2022-12-04,81,237,104.22143692016601,33128.15278106689,6,12,1,48,26311,1
100104,Electronics,110.23656463623047,2022-12-05,103,0,104.31287384033203,10744.2260055542,0,12,0,49,26414,1
100104,Electronics,110.23656463623047,2022-12-06,112,248,108.8470231628418,39419.25318847656,1,12,0,49,26526,1
100104,Electronics,110.23656463623047,2022-12-07,128,0,107.1240463256836,13711.8779296875,2,12,0,49,26654,1
100104,Electronics,110.23656463623047,2022-12-08,66,0,107.1240463256836,7070.187057495117,3,12,0,49,26720,1
100104,Electronics,110.23656463623047,2022-12-09,137,350,115.89831909179688,56928.479431152344,4,12,0,49,26857,1
100104,Electronics,110.23656463623047,2022-12-10,109,0,113.61663818359375,12384.213562011719,5,12,1,49,26966,1
100104,Electronics,110.23656463623047,2022-12-11,48,0,113.61663818359375,5453.5986328125,6,12,1,49,27014,1
100104,Electronics,110.23656463623047,2022-12-12,56,0,113.61663818359375,6362.53173828125,0,12,0,50,27070,1
100104,Electronics,110.23656463623047,2022-12-13,67,0,113.61663818359375,7612.314758300781,1,12,0,50,27137,1
100104,Electronics,110.23656463623047,2022-12-14,119,256,108.36135482788086,40449.002449035645,2,12,0,50,27256,1
100104,Electronics,110.23656463623047,2022-12-15,60,289,121.9707244873047,43559.18693847656,3,12,0,50,27316,1
100104,Electronics,110.23656463623047,2022-12-16,119,0,117.64144897460938,13999.332427978516,4,12,0,50,27435,1
100104,Electronics,110.23656463623047,2022-12-17,88,0,117.64144897460938,10352.447509765625,5,12,1,50,27523,1
100104,Electronics,110.23656463623047,2022-12-18,115,0,117.64144897460938,13528.766632080078,6,12,1,50,27638,1
100104,Electronics,110.23656463623047,2022-12-19,81,166,116.77724060058594,28814.462977294923,0,12,0,51,27719,1
100104,Electronics,110.23656463623047,2022-12-20,91,0,117.12448120117188,10658.32778930664,1,12,0,51,27810,1
100104,Electronics,110.23656463623047,2022-12-21,87,0,117.12448120117188,10189.829864501953,2,12,0,51,27897,1
100104,Electronics,110.23656463623047,2022-12-22,114,366,104.11238021850586,49479.42268981934,3,12,0,51,28011,1
100104,Electronics,110.23656463623047,2022-12-23,16,0,106.07476043701172,1697.1961669921875,4,12,0,51,28027,1
100104,Electronics,110.23656463623047,2022-12-24,113,0,106.07476043701172,11986.447929382324,5,12,1,51,28140,1
100104,Electronics,110.23656463623047,2022-12-25,132,289,95.79860397338868,39840.021448974614,6,12,1,51,28272,1
100104,Electronics,110.23656463623047,2022-12-26,121,0,98.92720794677734,11970.192161560059,0,12,0,52,28393,1
100104,Electronics,110.23656463623047,2022-12-27,105,201,95.10752380371093,28949.5399987793,1,12,0,52,28498,1
100104,Electronics,110.23656463623047,2022-12-28,119,0,96.70504760742188,11507.900665283203,2,12,0,52,28617,1
100104,Electronics,110.23656463623047,2022-12-29,102,223,113.85343826293945,37777.561405639644,3,12,0,52,28719,1
100104,Electronics,110.23656463623047,2022-12-30,100,0,107.4468765258789,10744.68765258789,4,12,0,52,28819,1
100104,Electronics,110.23656463623047,2022-12-31,97,0,107.4468765258789,10422.347023010254,5,12,1,52,28916,1
100104,Electronics,110.23656463623047,2023-01-01,91,221,111.69336639404297,35014.292683715816,6,1,1,52,29007,1
100104,Electronics,110.23656463623047,2023-01-02,99,0,110.41673278808594,10931.256546020508,0,1,0,1,29106,1
100104,Electronics,110.23656463623047,2023-01-03,159,259,110.5732064819336,46224.279661254885,1,1,0,1,29265,1
100104,Electronics,110.23656463623047,2023-01-04,62,0,110.52641296386719,6852.637603759766,2,1,0,1,29327,1
100104,Electronics,110.23656463623047,2023-01-05,88,250,108.56821365356446,36587.805603027344,3,1,0,1,29415,1
100104,Electronics,110.23656463623047,2023-01-06,70,0,109.2364273071289,7646.549911499023,4,1,0,1,29485,1
100104,Electronics,110.23656463623047,2023-01-07,70,0,109.2364273071289,7646.549911499023,5,1,1,1,29555,1
100104,Electronics,110.23656463623047,2023-01-08,90,0,109.2364273071289,9831.278457641602,6,1,1,1,29645,1
100104,Electronics,110.23656463623047,2023-01-09,80,0,109.2364273071289,8738.914184570312,0,1,0,2,29725,1
100104,Electronics,110.23656463623047,2023-01-10,80,114,97.45698623657226,18775.517797851564,1,1,0,2,29805,1
100104,Electronics,110.23656463623047,2023-01-11,31,244,107.42919830322265,29841.400294799805,2,1,0,2,29836,1
100104,Electronics,110.23656463623047,2023-01-12,99,0,106.02839660644531,10496.811264038086,3,1,0,2,29935,1
100104,Electronics,110.23656463623047,2023-01-13,26,0,106.02839660644531,2756.738311767578,4,1,0,2,29961,1
100104,Electronics,110.23656463623047,2023-01-14,144,279,118.31176361083985,50534.337919921876,5,1,1,2,30105,1
100104,Electronics,110.23656463623047,2023-01-15,72,0,114.69352722167969,8257.933959960938,6,1,1,2,30177,1
100104,Electronics,110.23656463623047,2023-01-16,50,0,114.69352722167969,5734.676361083984,0,1,0,3,30227,1
100104,Electronics,110.23656463623047,2023-01-17,63,0,114.69352722167969,7225.69221496582,1,1,0,3,30290,1
100104,Electronics,110.23656463623047,2023-01-18,119,201,113.73107513427735,36369.25588195801,2,1,0,3,30409,1
100104,Electronics,110.23656463623047,2023-01-19,64,274,117.7410675048828,40050.356640625,3,1,0,3,30473,1
100104,Electronics,110.23656463623047,2023-01-20,105,0,116.53213500976562,12235.87417602539,4,1,0,3,30578,1
100104,Electronics,110.23656463623047,2023-01-21,77,0,116.53213500976562,8972.974395751953,5,1,1,3,30655,1
100104,Electronics,110.23656463623047,2023-01-22,114,0,116.53213500976562,13284.663391113281,6,1,1,3,30769,1
100104,Electronics,110.23656463623047,2023-01-23,116,296,113.54379348754883,46655.16008911133,0,1,0,4,30885,1
100104,Electronics,110.23656463623047,2023-01-24,47,0,114.23758697509766,5369.16658782959,1,1,0,4,30932,1
100104,Electronics,110.23656463623047,2023-01-25,70,0,114.23758697509766,7996.631088256836,2,1,0,4,31002,1
100104,Electronics,110.23656463623047,2023-01-26,66,187,112.52341918945312,28386.941333007813,3,1,0,4,31068,1
100104,Electronics,110.23656463623047,2023-01-27,90,0,113.19683837890625,10187.715454101562,4,1,0,4,31158,1
100104,Electronics,110.23656463623047,2023-01-28,94,0,113.19683837890625,10640.502807617188,5,1,1,4,31252,1
100104,Electronics,110.23656463623047,2023-01-29,24,0,113.19683837890625,2716.72412109375,6,1,1,4,31276,1
100104,Electronics,110.23656463623047,2023-01-30,75,126,102.06094375610351,20297.961563415527,0,1,0,5,31351,1
100104,Electronics,110.23656463623047,2023-01-31,50,0,106.30188751220703,5315.094375610352,1,1,0,5,31401,1
100104,Electronics,110.23656463623047,2023-02-01,68,146,101.01942810058594,21474.682221679686,2,2,0,5,31469,1
100104,Electronics,110.23656463623047,2023-02-02,70,0,102.85885620117188,7200.119934082031,3,2,0,5,31539,1
100104,Electronics,110.23656463623047,2023-02-03,44,124,96.99439819335937,16108.307041015625,4,2,0,5,31583,1
100104,Electronics,110.23656463623047,2023-02-04,59,0,99.32879638671875,5860.398986816406,5,2,1,5,31642,1
100104,Electronics,110.23656463623047,2023-02-05,35,0,99.32879638671875,3476.5078735351562,6,2,1,5,31677,1
100104,Electronics,110.23656463623047,2023-02-06,60,126,101.8931510925293,19015.278131103514,0,2,0,6,31737,1
100104,Electronics,110.23656463623047,2023-02-07,62,190,96.71857330322266,24177.423089599608,1,2,0,6,31799,1
100104,Electronics,110.23656463623047,2023-02-08,45,0,98.24714660644531,4421.121597290039,2,2,0,6,31844,1
100104,Electronics,110.23656463623047,2023-02-09,44,0,98.24714660644531,4322.874450683594,3,2,0,6,31888,1
100104,Electronics,110.23656463623047,2023-02-10,31,0,98.24714660644531,3045.6615447998047,4,2,0,6,31919,1
100104,Electronics,110.23656463623047,2023-02-11,46,0,98.24714660644531,4519.368743896484,5,2,1,6,31965,1
100104,Electronics,110.23656463623047,2023-02-12,37,0,98.24714660644531,3635.1444244384766,6,2,1,6,32002,1
100104,Electronics,110.23656463623047,2023-02-13,63,121,90.7792707824707,16543.92811859131,0,2,0,7,32065,1
100104,Electronics,110.23656463623047,2023-02-14,39,0,93.5285415649414,3647.613121032715,1,2,0,7,32104,1
100104,Electronics,110.23656463623047,2023-02-15,33,0,93.5285415649414,3086.4418716430664,2,2,0,7,32137,1
100104,Electronics,110.23656463623047,2023-02-16,5,0,93.5285415649414,467.64270782470703,3,2,0,7,32142,1
100104,Electronics,110.23656463623047,2023-02-17,48,97,91.7187287902832,13264.977963867188,4,2,0,7,32190,1
100104,Electronics,110.23656463623047,2023-02-18,44,0,92.4174575805664,4066.368133544922,5,2,1,7,32234,1
100104,Electronics,110.23656463623047,2023-02-19,94,197,90.1521842956543,26177.410647583005,6,2,1,7,32328,1
100104,Electronics,110.23656463623047,2023-02-20,28,0,90.7043685913086,2539.7223205566406,0,2,0,8,32356,1
100104,Electronics,110.23656463623047,2023-02-21,20,0,90.7043685913086,1814.0873718261719,1,2,0,8,32376,1
100104,Electronics,110.23656463623047,2023-02-22,49,0,90.7043685913086,4444.514060974121,2,2,0,8,32425,1
100104,Electronics,110.23656463623047,2023-02-23,42,106,80.09860122680664,11592.92250305176,3,2,0,8,32467,1
100104,Electronics,110.23656463623047,2023-02-24,90,208,99.7867645263672,30328.01761474609,4,2,0,8,32557,1
100104,Electronics,110.23656463623047,2023-02-25,35,0,94.77352905273438,3317.073516845703,5,2,1,8,32592,1
100104,Electronics,110.23656463623047,2023-02-26,85,0,94.77352905273438,8055.749969482422,6,2,1,8,32677,1
100104,Electronics,110.23656463623047,2023-02-27,33,0,94.77352905273438,3127.5264587402344,0,2,0,9,32710,1
100104,Electronics,110.23656463623047,2023-02-28,102,145,86.21679611206055,21163.67640686035,1,2,0,9,32812,1
100104,Electronics,110.23656463623047,2023-03-01,60,208,93.08508102416992,25132.52972290039,2,3,0,9,32872,1
100104,Electronics,110.23656463623047,2023-03-02,120,0,91.83016204833984,11019.619445800781,3,3,0,9,32992,1
100104,Electronics,110.23656463623047,2023-03-03,66,256,103.14215454101563,33883.964399414064,4,3,0,9,33058,1
100104,Electronics,110.23656463623047,2023-03-04,135,0,99.60430908203125,13446.581726074219,5,3,1,9,33193,1
100104,Electronics,110.23656463623047,2023-03-05,69,0,99.60430908203125,6872.697326660156,6,3,1,9,33262,1
100104,Electronics,110.23656463623047,2023-03-06,112,322,114.81104751586915,50638.374643554685,0,3,0,10,33374,1
100104,Electronics,110.23656463623047,2023-03-07,61,0,110.95209503173828,6768.077796936035,1,3,0,10,33435,1
100104,Electronics,110.23656463623047,2023-03-08,116,0,110.95209503173828,12870.44302368164,2,3,0,10,33551,1
100104,Electronics,110.23656463623047,2023-03-09,69,215,94.62345687866211,25992.177049255373,3,3,0,10,33620,1
100104,Electronics,110.23656463623047,2023-03-10,82,0,100.65691375732422,8253.866928100586,4,3,0,10,33702,1
100104,Electronics,110.23656463623047,2023-03-11,110,0,100.65691375732422,11072.260513305664,5,3,1,10,33812,1
100104,Electronics,110.23656463623047,2023-03-12,68,0,100.65691375732422,6844.670135498047,6,3,1,10,33880,1
100104,Electronics,110.23656463623047,2023-03-13,84,155,101.44671508789062,24263.038134765622,0,3,0,11,33964,1
100104,Electronics,110.23656463623047,2023-03-14,54,0,101.20343017578125,5464.9852294921875,1,3,0,11,34018,1
100104,Electronics,110.23656463623047,2023-03-15,85,192,116.24461380004882,32662.5743460083,2,3,0,11,34103,1
100104,Electronics,110.23656463623047,2023-03-16,57,0,111.91922760009766,6379.395973205566,3,3,0,11,34160,1
100104,Electronics,110.23656463623047,2023-03-17,113,285,98.30988739013671,38508.1545501709,4,3,0,11,34273,1
100104,Electronics,110.23656463623047,2023-03-18,92,0,101.90977478027344,9375.699279785156,5,3,1,11,34365,1
100104,Electronics,110.23656463623047,2023-03-19,72,0,101.90977478027344,7337.5037841796875,6,3,1,11,34437,1
100104,Electronics,110.23656463623047,2023-03-20,48,0,101.90977478027344,4891.669189453125,0,3,0,12,34485,1
100104,Electronics,110.23656463623047,2023-03-21,53,189,102.89931259155273,24942.52713470459,1,3,0,12,34538,1
100104,Electronics,110.23656463623047,2023-03-22,60,0,102.59862518310547,6155.917510986328,2,3,0,12,34598,1
100104,Electronics,110.23656463623047,2023-03-23,165,369,121.1525796508789,65627.23128479003,3,3,0,12,34763,1
100104,Electronics,110.23656463623047,2023-03-24,76,0,116.58515930175781,8860.472106933594,4,3,0,12,34839,1
100104,Electronics,110.23656463623047,2023-03-25,89,0,116.58515930175781,10376.079177856445,5,3,1,12,34928,1
100104,Electronics,110.23656463623047,2023-03-26,96,0,116.58515930175781,11192.17529296875,6,3,1,12,35024,1
100104,Electronics,110.23656463623047,2023-03-27,136,203,111.40538742065431,37658.19537841797,0,3,0,13,35160,1
100104,Electronics,110.23656463623047,2023-03-28,48,283,119.19357864379883,39898.73354980469,1,3,0,13,35208,1
100104,Electronics,110.23656463623047,2023-03-29,104,0,117.29715728759766,12198.904357910156,2,3,0,13,35312,1
100104,Electronics,110.23656463623047,2023-03-30,6,0,117.29715728759766,703.7829437255859,3,3,0,13,35318,1
100104,Electronics,110.23656463623047,2023-03-31,50,0,117.29715728759766,5864.857864379883,4,3,0,13,35368,1
100104,Electronics,110.23656463623047,2023-04-01,50,0,117.29715728759766,5864.857864379883,5,4,1,13,35418,1
100104,Electronics,110.23656463623047,2023-04-02,114,0,117.29715728759766,13371.875930786133,6,4,1,13,35532,1
100104,Electronics,110.23656463623047,2023-04-03,114,315,105.77649780273438,44904.46149902344,0,4,0,14,35646,1
100104,Electronics,110.23656463623047,2023-04-04,48,0,108.13299560546875,5190.3837890625,1,4,0,14,35694,1
100104,Electronics,110.23656463623047,2023-04-05,65,0,108.13299560546875,7028.644714355469,2,4,0,14,35759,1
100104,Electronics,110.23656463623047,2023-04-06,139,227,118.20373977661133,43577.27965789795,3,4,0,14,35898,1
100104,Electronics,110.23656463623047,2023-04-07,51,0,114.62747955322266,5846.0014572143555,4,4,0,14,35949,1
100104,Electronics,110.23656463623047,2023-04-08,3,0,114.62747955322266,343.88243865966797,5,4,1,14,35952,1
100104,Electronics,110.23656463623047,2023-04-09,114,211,123.30095245361329,40411.24715942383,6,4,1,14,36066,1
100104,Electronics,110.23656463623047,2023-04-10,74,0,119.81190490722656,8866.080963134766,0,4,0,15,36140,1
100104,Electronics,110.23656463623047,2023-04-11,81,0,119.81190490722656,9704.764297485352,1,4,0,15,36221,1
100104,Electronics,110.23656463623047,2023-04-12,34,0,119.81190490722656,4073.604766845703,2,4,0,15,36255,1
100104,Electronics,110.23656463623047,2023-04-13,92,128,95.98257232666015,20748.513308105466,3,4,0,15,36347,1
100104,Electronics,110.23656463623047,2023-04-14,23,0,106.19514465332031,2442.488327026367,4,4,0,15,36370,1
100104,Electronics,110.23656463623047,2023-04-15,18,0,106.19514465332031,1911.5126037597656,5,4,1,15,36388,1
100104,Electronics,110.23656463623047,2023-04-16,167,338,109.0347053527832,55167.741587829594,6,4,1,15,36555,1
100104,Electronics,110.23656463623047,2023-04-17,20,0,108.4194107055664,2168.388214111328,0,4,0,16,36575,1
100104,Electronics,110.23656463623047,2023-04-18,79,0,108.4194107055664,8565.133445739746,1,4,0,16,36654,1
100104,Electronics,110.23656463623047,2023-04-19,47,0,108.4194107055664,5095.712303161621,2,4,0,16,36701,1
100104,Electronics,110.23656463623047,2023-04-20,19,0,108.4194107055664,2059.9688034057617,3,4,0,16,36720,1
100104,Electronics,110.23656463623047,2023-04-21,29,0,108.4194107055664,3144.162910461426,4,4,0,16,36749,1
100104,Electronics,110.23656463623047,2023-04-22,29,0,108.4194107055664,3144.162910461426,5,4,1,16,36778,1
100104,Electronics,110.23656463623047,2023-04-23,47,164,105.62483337402344,22191.504337158203,6,4,1,16,36825,1
100104,Electronics,110.23656463623047,2023-04-24,74,0,106.43966674804688,7876.535339355469,0,4,0,17,36899,1
100104,Electronics,110.23656463623047,2023-04-25,47,158,86.5622932434082,16950.255564880372,1,4,0,17,36946,1
100104,Electronics,110.23656463623047,2023-04-26,46,0,93.7245864868164,4311.330978393555,2,4,0,17,36992,1
100104,Electronics,110.23656463623047,2023-04-27,26,0,93.7245864868164,2436.8392486572266,3,4,0,17,37018,1
100104,Electronics,110.23656463623047,2023-04-28,29,0,93.7245864868164,2718.013008117676,4,4,0,17,37047,1
100104,Electronics,110.23656463623047,2023-04-29,22,0,93.7245864868164,2061.940902709961,5,4,1,17,37069,1
100104,Electronics,110.23656463623047,2023-04-30,31,0,93.7245864868164,2905.4621810913086,6,4,1,17,37100,1
100104,Electronics,110.23656463623047,2023-05-01,33,115,79.25993927001953,11291.775991821289,0,5,0,18,37133,1
100104,Electronics,110.23656463623047,2023-05-02,102,264,92.36974472045898,34173.48792297363,1,5,0,18,37235,1
100104,Electronics,110.23656463623047,2023-05-03,30,0,90.10948944091797,2703.284683227539,2,5,0,18,37265,1
100104,Electronics,110.23656463623047,2023-05-04,67,0,90.10948944091797,6037.335792541504,3,5,0,18,37332,1
100104,Electronics,110.23656463623047,2023-05-05,31,0,90.10948944091797,2793.394172668457,4,5,0,18,37363,1
100104,Electronics,110.23656463623047,2023-05-06,82,0,90.10948944091797,7388.978134155273,5,5,1,18,37445,1
100104,Electronics,110.23656463623047,2023-05-07,48,0,90.10948944091797,4325.2554931640625,6,5,1,18,37493,1
100104,Electronics,110.23656463623047,2023-05-08,36,127,81.77066329956054,13083.76775756836,0,5,0,19,37529,1
100104,Electronics,110.23656463623047,2023-05-09,56,171,83.56355224609375,18929.4178515625,1,5,0,19,37585,1
100104,Electronics,110.23656463623047,2023-05-10,90,0,83.9071044921875,7551.639404296875,2,5,0,19,37675,1
100104,Electronics,110.23656463623047,2023-05-11,38,0,83.9071044921875,3188.469970703125,3,5,0,19,37713,1
100104,Electronics,110.23656463623047,2023-05-12,38,0,83.9071044921875,3188.469970703125,4,5,0,19,37751,1
100104,Electronics,110.23656463623047,2023-05-13,53,0,83.9071044921875,4447.0765380859375,5,5,1,19,37804,1
100104,Electronics,110.23656463623047,2023-05-14,108,289,110.0277178955078,44425.32706542969,6,5,1,19,37912,1
100104,Electronics,110.23656463623047,2023-05-15,0,233,119.5,27843.5,0,5,0,20,37912,1
100104,Electronics,110.23656463623047,2023-05-16,98,0,111.97904205322266,10973.94612121582,1,5,0,20,38010,1
100104,Electronics,110.23656463623047,2023-05-17,83,0,111.97904205322266,9294.26049041748,2,5,0,20,38093,1
100104,Electronics,110.23656463623047,2023-05-18,100,0,111.97904205322266,11197.904205322266,3,5,0,20,38193,1
100104,Electronics,110.23656463623047,2023-05-19,66,0,111.97904205322266,7390.616775512695,4,5,0,20,38259,1
100104,Electronics,110.23656463623047,2023-05-20,62,214,103.70209732055665,28256.660067749024,5,5,1,20,38321,1
100104,Electronics,110.23656463623047,2023-05-21,113,0,106.10419464111328,11989.7739944458,6,5,1,20,38434,1
100104,Electronics,110.23656463623047,2023-05-22,133,350,113.04492660522462,54953.340476989746,0,5,0,21,38567,1
100104,Electronics,110.23656463623047,2023-05-23,72,0,111.41985321044922,8022.229431152344,1,5,0,21,38639,1
100104,Electronics,110.23656463623047,2023-05-24,105,378,128.76524810791017,63718.25210266113,2,5,0,21,38744,1
100104,Electronics,110.23656463623047,2023-05-25,53,0,123.18049621582031,6528.566299438477,3,5,0,21,38797,1
100104,Electronics,110.23656463623047,2023-05-26,81,0,123.18049621582031,9977.620193481445,4,5,0,21,38878,1
100104,Electronics,110.23656463623047,2023-05-27,68,0,123.18049621582031,8376.273742675781,5,5,1,21,38946,1
100104,Electronics,110.23656463623047,2023-05-28,57,0,123.18049621582031,7021.288284301758,6,5,1,21,39003,1
100104,Electronics,110.23656463623047,2023-05-29,131,0,123.18049621582031,16136.645004272461,0,5,0,22,39134,1
100104,Electronics,110.23656463623047,2023-05-30,58,0,123.18049621582031,7144.468780517578,1,5,0,22,39192,1
100104,Electronics,110.23656463623047,2023-05-31,57,132,110.88849822998047,20579.288798217774,2,5,0,22,39249,1
100104,Electronics,110.23656463623047,2023-06-01,60,0,115.93699645996094,6956.219787597656,3,6,0,22,39309,1
100104,Electronics,110.23656463623047,2023-06-02,100,200,119.94009185791015,36115.01837158203,4,6,0,22,39409,1
100104,Electronics,110.23656463623047,2023-06-03,42,0,118.61018371582031,4981.627716064453,5,6,1,22,39451,1
100104,Electronics,110.23656463623047,2023-06-04,62,0,118.61018371582031,7353.831390380859,6,6,1,22,39513,1
100104,Electronics,110.23656463623047,2023-06-05,77,231,117.9545849609375,36300.04608398437,0,6,0,23,39590,1
100104,Electronics,110.23656463623047,2023-06-06,95,0,118.149169921875,11224.171142578125,1,6,0,23,39685,1
100104,Electronics,110.23656463623047,2023-06-07,144,242,103.44186538696289,39432.49723144531,2,6,0,23,39829,1
100104,Electronics,110.23656463623047,2023-06-08,110,0,108.50373077392578,11935.410385131836,3,6,0,23,39939,1
100104,Electronics,110.23656463623047,2023-06-09,131,228,115.08740478515625,41537.79005371094,4,6,0,23,40070,1
100104,Electronics,110.23656463623047,2023-06-10,111,0,112.8048095703125,12521.333862304688,5,6,1,23,40181,1
100104,Electronics,110.23656463623047,2023-06-11,109,294,120.3279493713379,48881.042962951666,6,6,1,23,40290,1
100104,Electronics,110.23656463623047,2023-06-12,119,0,118.22589874267578,14068.881950378418,0,6,0,24,40409,1
100104,Electronics,110.23656463623047,2023-06-13,59,0,118.22589874267578,6975.328025817871,1,6,0,24,40468,1
100104,Electronics,110.23656463623047,2023-06-14,80,180,116.33630935668945,30172.809497070313,2,6,0,24,40548,1
100104,Electronics,110.23656463623047,2023-06-15,130,324,109.44339553833008,49182.242839965824,3,6,0,24,40678,1
100104,Electronics,110.23656463623047,2023-06-16,102,0,112.04679107666016,11428.772689819336,4,6,0,24,40780,1
100104,Electronics,110.23656463623047,2023-06-17,173,0,112.04679107666016,19384.094856262207,5,6,1,24,40953,1
100104,Electronics,110.23656463623047,2023-06-18,29,0,112.04679107666016,3249.3569412231445,6,6,1,24,40982,1
100104,Electronics,110.23656463623047,2023-06-19,153,295,109.96478683471679,49182.60477142334,0,6,0,25,41135,1
100104,Electronics,110.23656463623047,2023-06-20,72,0,110.5395736694336,7958.849304199219,1,6,0,25,41207,1
100104,Electronics,110.23656463623047,2023-06-21,92,0,110.5395736694336,10169.64077758789,2,6,0,25,41299,1
100104,Electronics,110.23656463623047,2023-06-22,194,444,120.58994720458983,77403.89951538085,3,6,0,25,41493,1
100104,Electronics,110.23656463623047,2023-06-23,9,0,118.71989440917969,1068.4790496826172,4,6,0,25,41502,1
100104,Electronics,110.23656463623047,2023-06-24,197,0,118.71989440917969,23387.8191986084,5,6,1,25,41699,1
100104,Electronics,110.23656463623047,2023-06-25,89,0,118.71989440917969,10566.070602416992,6,6,1,25,41788,1
100104,Electronics,110.23656463623047,2023-06-26,157,294,100.96947143554686,45022.18403076172,0,6,0,26,41945,1
100104,Electronics,110.23656463623047,2023-06-27,1,0,104.72894287109375,104.72894287109375,1,6,0,26,41946,1
100104,Electronics,110.23656463623047,2023-06-28,95,309,99.23959289550781,39714.10265014648,2,6,0,26,42041,1
100104,Electronics,110.23656463623047,2023-06-29,63,0,101.00918579101562,6363.578704833984,3,6,0,26,42104,1
100104,Electronics,110.23656463623047,2023-06-30,69,0,101.00918579101562,6969.633819580078,4,6,0,26,42173,1
100104,Electronics,110.23656463623047,2023-07-01,129,0,101.00918579101562,13030.184967041016,5,7,1,26,42302,1
100104,Electronics,110.23656463623047,2023-07-02,94,0,101.00918579101562,9494.863464355469,6,7,1,26,42396,1
100104,Electronics,110.23656463623047,2023-07-03,96,197,100.03303802490234,29282.10330078125,0,7,0,27,42492,1
100104,Electronics,110.23656463623047,2023-07-04,57,188,110.05106567382813,27477.201486816408,1,7,0,27,42549,1
100104,Electronics,110.23656463623047,2023-07-05,102,0,106.12213134765625,10824.457397460938,2,7,0,27,42651,1
100104,Electronics,110.23656463623047,2023-07-06,103,382,118.54275436401367,58429.90739898682,3,7,0,27,42754,1
100104,Electronics,110.23656463623047,2023-07-07,59,0,115.18550872802734,6795.945014953613,4,7,0,27,42813,1
100104,Electronics,110.23656463623047,2023-07-08,131,0,115.18550872802734,15089.301643371582,5,7,1,27,42944,1
100104,Electronics,110.23656463623047,2023-07-09,90,0,115.18550872802734,10366.695785522461,6,7,1,27,43034,1
100104,Electronics,110.23656463623047,2023-07-10,104,0,115.18550872802734,11979.292907714844,0,7,0,28,43138,1
100104,Electronics,110.23656463623047,2023-07-11,91,196,109.42796844482422,31217.040256958007,1,7,0,28,43229,1
100104,Electronics,110.23656463623047,2023-07-12,78,0,111.22593688964844,8675.623077392578,2,7,0,28,43307,1
100104,Electronics,110.23656463623047,2023-07-13,88,152,107.97094924926758,25829.127067871093,3,7,0,28,43395,1
100104,Electronics,110.23656463623047,2023-07-14,117,0,109.28189849853516,12785.982124328613,4,7,0,28,43512,1
100104,Electronics,110.23656463623047,2023-07-15,47,145,95.72284439086914,17921.8273727417,5,7,1,28,43559,1
100104,Electronics,110.23656463623047,2023-07-16,105,268,107.86203109741211,40620.14653045654,6,7,1,28,43664,1
100104,Electronics,110.23656463623047,2023-07-17,63,0,105.48406219482422,6645.495918273926,0,7,0,29,43727,1
100104,Electronics,110.23656463623047,2023-07-18,96,0,105.48406219482422,10126.469970703125,1,7,0,29,43823,1
100104,Electronics,110.23656463623047,2023-07-19,85,0,105.48406219482422,8966.145286560059,2,7,0,29,43908,1
100104,Electronics,110.23656463623047,2023-07-20,124,252,100.50924575805664,37631.57294799805,3,7,0,29,44032,1
100104,Electronics,110.23656463623047,2023-07-21,45,0,101.75849151611328,4579.132118225098,4,7,0,29,44077,1
100104,Electronics,110.23656463623047,2023-07-22,81,0,101.75849151611328,8242.437812805176,5,7,1,29,44158,1
100104,Electronics,110.23656463623047,2023-07-23,101,233,100.8924771118164,33667.40037658691,6,7,1,29,44259,1
100104,Electronics,110.23656463623047,2023-07-24,70,0,101.12495422363281,7078.746795654297,0,7,0,30,44329,1
100104,Electronics,110.23656463623047,2023-07-25,99,241,91.74626800537109,30759.741065063477,1,7,0,30,44428,1
100104,Electronics,110.23656463623047,2023-07-26,127,0,94.80253601074219,12039.922073364258,2,7,0,30,44555,1
100104,Electronics,110.23656463623047,2023-07-27,138,232,111.57715316772462,41832.774274291995,3,7,0,30,44693,1
100104,Electronics,110.23656463623047,2023-07-28,63,0,105.73430633544922,6661.261299133301,4,7,0,30,44756,1
100104,Electronics,110.23656463623047,2023-07-29,57,0,105.73430633544922,6026.8554611206055,5,7,1,30,44813,1
100104,Electronics,110.23656463623047,2023-07-30,102,0,105.73430633544922,10784.89924621582,6,7,1,30,44915,1
100104,Electronics,110.23656463623047,2023-07-31,68,134,101.02613464355468,20311.174311523435,0,7,0,31,44983,1
100104,Electronics,110.23656463623047,2023-08-01,52,155,100.10971008300781,20631.06984863281,1,8,0,31,45035,1
100104,Electronics,110.23656463623047,2023-08-02,38,0,100.99942016601562,3837.9779663085938,2,8,0,31,45073,1
100104,Electronics,110.23656463623047,2023-08-03,171,309,116.79704635620118,56692.2698538208,3,8,0,31,45244,1
100104,Electronics,110.23656463623047,2023-08-04,56,0,112.23409271240234,6285.109191894531,4,8,0,31,45300,1
100104,Electronics,110.23656463623047,2023-08-05,90,0,112.23409271240234,10101.068344116211,5,8,1,31,45390,1
100104,Electronics,110.23656463623047,2023-08-06,106,242,104.22653045654297,35906.82445678711,6,8,1,31,45496,1
100104,Electronics,110.23656463623047,2023-08-07,52,0,106.90306091308594,5558.959167480469,0,8,0,32,45548,1
100104,Electronics,110.23656463623047,2023-08-08,123,0,106.90306091308594,13149.07649230957,1,8,0,32,45671,1
100104,Electronics,110.23656463623047,2023-08-09,87,206,97.9387124633789,28342.76596862793,2,8,0,32,45758,1
100104,Electronics,110.23656463623047,2023-08-10,112,0,100.90742492675781,11301.631591796875,3,8,0,32,45870,1
100104,Electronics,110.23656463623047,2023-08-11,68,224,110.68832794189453,32809.53260009766,4,8,0,32,45938,1
100104,Electronics,110.23656463623047,2023-08-12,4,0,107.55665588378906,430.22662353515625,5,8,1,32,45942,1
100104,Electronics,110.23656463623047,2023-08-13,74,0,107.55665588378906,7959.192535400391,6,8,1,32,46016,1
100104,Electronics,110.23656463623047,2023-08-14,38,0,107.55665588378906,4087.1529235839844,0,8,0,33,46054,1
100104,Electronics,110.23656463623047,2023-08-15,148,241,101.80092529296874,39417.26388671875,1,8,0,33,46202,1
100104,Electronics,110.23656463623047,2023-08-16,87,0,103.7718505859375,9028.151000976562,2,8,0,33,46289,1
100104,Electronics,110.23656463623047,2023-08-17,113,190,98.01330444335937,29519.136804199217,3,8,0,33,46402,1
100104,Electronics,110.23656463623047,2023-08-18,63,0,100.33660888671875,6321.206359863281,4,8,0,33,46465,1
100104,Electronics,110.23656463623047,2023-08-19,162,334,100.39356430053711,49798.034833374026,5,8,1,33,46627,1
100104,Electronics,110.23656463623047,2023-08-20,109,437,110.75813674926758,61619.27381134033,6,8,1,33,46736,1
100104,Electronics,110.23656463623047,2023-08-21,81,0,107.26627349853516,8688.568153381348,0,8,0,34,46817,1
100104,Electronics,110.23656463623047,2023-08-22,67,0,107.26627349853516,7186.8403244018555,1,8,0,34,46884,1
100104,Electronics,110.23656463623047,2023-08-23,167,0,107.26627349853516,17913.46767425537,2,8,0,34,47051,1
100104,Electronics,110.23656463623047,2023-08-24,124,0,107.26627349853516,13301.01791381836,3,8,0,34,47175,1
100104,Electronics,110.23656463623047,2023-08-25,45,0,107.26627349853516,4826.982307434082,4,8,0,34,47220,1
100104,Electronics,110.23656463623047,2023-08-26,145,321,122.70915817260743,58022.135870056154,5,8,1,34,47365,1
100104,Electronics,110.23656463623047,2023-08-27,85,0,117.93831634521484,10024.756889343262,6,8,1,34,47450,1
100104,Electronics,110.23656463623047,2023-08-28,128,0,117.93831634521484,15096.1044921875,0,8,0,35,47578,1
100104,Electronics,110.23656463623047,2023-08-29,105,0,117.93831634521484,12383.523216247559,1,8,0,35,47683,1
100104,Electronics,110.23656463623047,2023-08-30,68,200,102.13464721679688,26817.072021484375,2,8,0,35,47751,1
100104,Electronics,110.23656463623047,2023-08-31,68,0,106.33929443359375,7231.072021484375,3,8,0,35,47819,1
100104,Electronics,110.23656463623047,2023-09-01,69,155,100.09468749999999,22204.946875,4,9,0,35,47888,1
100104,Electronics,110.23656463623047,2023-09-02,52,0,102.609375,5335.6875,5,9,1,35,47940,1
100104,Electronics,110.23656463623047,2023-09-03,59,0,102.609375,6053.953125,6,9,1,35,47999,1
100104,Electronics,110.23656463623047,2023-09-04,101,233,101.86945541381836,33996.74999359131,0,9,0,36,48100,1
100104,Electronics,110.23656463623047,2023-09-05,83,381,114.70024032592774,54323.439894104005,1,9,0,36,48183,1
100104,Electronics,110.23656463623047,2023-09-06,59,0,111.00048065185547,6549.028358459473,2,9,0,36,48242,1
100104,Electronics,110.23656463623047,2023-09-07,98,0,111.00048065185547,10878.047103881836,3,9,0,36,48340,1
100104,Electronics,110.23656463623047,2023-09-08,100,0,111.00048065185547,11100.048065185547,4,9,0,36,48440,1
100104,Electronics,110.23656463623047,2023-09-09,63,0,111.00048065185547,6993.0302810668945,5,9,1,36,48503,1
100104,Electronics,110.23656463623047,2023-09-10,105,0,111.00048065185547,11655.050468444824,6,9,1,36,48608,1
100104,Electronics,110.23656463623047,2023-09-11,53,196,98.28602905273438,23881.769079589845,0,9,0,37,48661,1
100104,Electronics,110.23656463623047,2023-09-12,122,0,102.42205810546875,12495.491088867188,1,9,0,37,48783,1
100104,Electronics,110.23656463623047,2023-09-13,101,227,94.3977963256836,30642.714857788087,2,9,0,37,48884,1
100104,Electronics,110.23656463623047,2023-09-14,83,0,96.93559265136719,8045.654190063477,3,9,0,37,48967,1
100104,Electronics,110.23656463623047,2023-09-15,129,225,105.66750457763672,37707.97618103027,4,9,0,37,49096,1
100104,Electronics,110.23656463623047,2023-09-16,77,0,102.52500915527344,7894.425704956055,5,9,1,37,49173,1
100104,Electronics,110.23656463623047,2023-09-17,83,216,111.82631393432618,33914.028113098146,6,9,1,37,49256,1
100104,Electronics,110.23656463623047,2023-09-18,151,0,108.23262786865234,16343.126808166504,0,9,0,38,49407,1
100104,Electronics,110.23656463623047,2023-09-19,161,298,116.36104156494142,53742.48538391113,1,9,0,38,49568,1
100104,Electronics,110.23656463623047,2023-09-20,67,0,113.93208312988281,7633.449569702148,2,9,0,38,49635,1
100104,Electronics,110.23656463623047,2023-09-21,25,0,113.93208312988281,2848.3020782470703,3,9,0,38,49660,1
100104,Electronics,110.23656463623047,2023-09-22,92,257,110.17993774414063,38225.10854492187,4,9,0,38,49752,1
100104,Electronics,110.23656463623047,2023-09-23,172,0,111.55987548828125,19188.298583984375,5,9,1,38,49924,1
100104,Electronics,110.23656463623047,2023-09-24,51,0,111.55987548828125,5689.553649902344,6,9,1,38,49975,1
100104,Electronics,110.23656463623047,2023-09-25,67,0,111.55987548828125,7474.511657714844,0,9,0,39,50042,1
100104,Electronics,110.23656463623047,2023-09-26,73,117,99.69852096557617,18720.14406097412,1,9,0,39,50115,1
100104,Electronics,110.23656463623047,2023-09-27,101,216,110.60027053833008,35285.654648742675,2,9,0,39,50216,1
100104,Electronics,110.23656463623047,2023-09-28,105,0,108.64054107666016,11407.256813049316,3,9,0,39,50321,1
100104,Electronics,110.23656463623047,2023-09-29,111,222,109.43160400390624,36470.51608886719,4,9,0,39,50432,1
100104,Electronics,110.23656463623047,2023-09-30,90,0,109.1632080078125,9824.688720703125,5,9,1,39,50522,1
100104,Electronics,110.23656463623047,2023-10-01,84,0,109.1632080078125,9169.70947265625,6,10,1,39,50606,1
100104,Electronics,110.23656463623047,2023-10-02,104,215,97.92615631103516,30892.550512695314,0,10,0,40,50710,1
100104,Electronics,110.23656463623047,2023-10-03,42,0,101.04231262207031,4243.777130126953,1,10,0,40,50752,1
100104,Electronics,110.23656463623047,2023-10-04,110,161,103.13800216674804,27995.38047668457,2,10,0,40,50862,1
100104,Electronics,110.23656463623047,2023-10-05,52,0,102.2560043334961,5317.312225341797,3,10,0,40,50914,1
100104,Electronics,110.23656463623047,2023-10-06,106,244,111.03345733642578,39253.152955322264,4,10,0,40,51020,1
100104,Electronics,110.23656463623047,2023-10-07,62,0,108.19691467285156,6708.208709716797,5,10,1,40,51082,1
100104,Electronics,110.23656463623047,2023-10-08,69,0,108.19691467285156,7465.587112426758,6,10,1,40,51151,1
100104,Electronics,110.23656463623047,2023-10-09,45,0,108.19691467285156,4868.86116027832,0,10,0,41,51196,1
100104,Electronics,110.23656463623047,2023-10-10,40,0,108.19691467285156,4327.8765869140625,1,10,0,41,51236,1
100104,Electronics,110.23656463623047,2023-10-11,51,161,83.00579467773437,16696.791057128903,2,10,0,41,51287,1
100104,Electronics,110.23656463623047,2023-10-12,45,0,91.19158935546875,4103.621520996094,3,10,0,41,51332,1
100104,Electronics,110.23656463623047,2023-10-13,49,0,91.19158935546875,4468.387878417969,4,10,0,41,51381,1
100104,Electronics,110.23656463623047,2023-10-14,48,0,91.19158935546875,4377.1962890625,5,10,1,41,51429,1
100104,Electronics,110.23656463623047,2023-10-15,32,91,91.04793273925782,11195.4776953125,6,10,1,41,51461,1
100104,Electronics,110.23656463623047,2023-10-16,53,0,91.10586547851562,4828.610870361328,0,10,0,42,51514,1
100104,Electronics,110.23656463623047,2023-10-17,81,135,85.08620483398437,18273.52518310547,1,10,0,42,51595,1
100104,Electronics,110.23656463623047,2023-10-18,48,129,84.62075668334961,14896.812641601564,2,10,0,42,51643,1
100104,Electronics,110.23656463623047,2023-10-19,82,261,94.46100982666016,32931.57561157227,3,10,0,42,51725,1
100104,Electronics,110.23656463623047,2023-10-20,115,0,91.49201965332031,10521.582260131836,4,10,0,42,51840,1
100104,Electronics,110.23656463623047,2023-10-21,63,0,91.49201965332031,5763.99723815918,5,10,1,42,51903,1
100104,Electronics,110.23656463623047,2023-10-22,44,0,91.49201965332031,4025.6488647460938,6,10,1,42,51947,1
100104,Electronics,110.23656463623047,2023-10-23,51,0,91.49201965332031,4666.093002319336,0,10,0,43,51998,1
100104,Electronics,110.23656463623047,2023-10-24,40,0,91.49201965332031,3659.6807861328125,1,10,0,43,52038,1
100104,Electronics,110.23656463623047,2023-10-25,106,176,100.45310836791992,28496.958973999026,2,10,0,43,52144,1
100104,Electronics,110.23656463623047,2023-10-26,24,0,98.03621673583984,2352.8692016601562,3,10,0,43,52168,1
100104,Electronics,110.23656463623047,2023-10-27,100,248,111.44751785278319,39303.58357055664,4,10,0,43,52268,1
100104,Electronics,110.23656463623047,2023-10-28,76,0,107.9350357055664,8203.062713623047,5,10,1,43,52344,1
100104,Electronics,110.23656463623047,2023-10-29,58,0,107.9350357055664,6260.232070922852,6,10,1,43,52402,1
100104,Electronics,110.23656463623047,2023-10-30,46,0,107.9350357055664,4965.011642456055,0,10,0,44,52448,1
100104,Electronics,110.23656463623047,2023-10-31,54,174,106.19830963134766,24152.21744018555,1,10,0,44,52502,1
100104,Electronics,110.23656463623047,2023-11-01,90,193,95.38736297607423,26521.09533569336,2,11,0,44,52592,1
100104,Electronics,110.23656463623047,2023-11-02,47,0,99.98472595214844,4699.282119750977,3,11,0,44,52639,1
100104,Electronics,110.23656463623047,2023-11-03,71,0,99.98472595214844,7098.915542602539,4,11,0,44,52710,1
100104,Electronics,110.23656463623047,2023-11-04,110,247,95.21759658813477,33773.81124938965,5,11,1,44,52820,1
100104,Electronics,110.23656463623047,2023-11-05,73,0,96.81519317626953,7067.509101867676,6,11,1,44,52893,1
100104,Electronics,110.23656463623047,2023-11-06,90,0,96.81519317626953,8713.367385864258,0,11,0,45,52983,1
100104,Electronics,110.23656463623047,2023-11-07,56,198,100.24454711914063,25637.54927734375,1,11,0,45,53039,1
100104,Electronics,110.23656463623047,2023-11-08,105,0,99.00909423828125,10395.954895019531,2,11,0,45,53144,1
100104,Electronics,110.23656463623047,2023-11-09,168,259,108.94838500976562,46823.22736328125,3,11,0,45,53312,1
100104,Electronics,110.23656463623047,2023-11-10,59,0,105.62677001953125,6231.979431152344,4,11,0,45,53371,1
100104,Electronics,110.23656463623047,2023-11-11,125,236,108.16853744506835,39156.67436126709,5,11,1,45,53496,1
100104,Electronics,110.23656463623047,2023-11-12,87,0,107.19707489013672,9326.145515441895,6,11,1,45,53583,1
100104,Electronics,110.23656463623047,2023-11-13,132,0,107.19707489013672,14150.013885498047,0,11,0,46,53715,1
100104,Electronics,110.23656463623047,2023-11-14,100,161,107.83721939086914,28159.71387817383,1,11,0,46,53815,1
100104,Electronics,110.23656463623047,2023-11-15,84,228,116.27843215942383,36715.4166027832,2,11,0,46,53899,1
100104,Electronics,110.23656463623047,2023-11-16,54,0,113.24686431884766,6115.330673217773,3,11,0,46,53953,1
100104,Electronics,110.23656463623047,2023-11-17,52,0,113.24686431884766,5888.836944580078,4,11,0,46,54005,1
100104,Electronics,110.23656463623047,2023-11-18,64,0,113.24686431884766,7247.79931640625,5,11,1,46,54069,1
100104,Electronics,110.23656463623047,2023-11-19,160,497,117.91685760498046,77755.51443359375,6,11,1,46,54229,1
100104,Electronics,110.23656463623047,2023-11-20,59,0,117.07371520996094,6907.349197387695,0,11,0,47,54288,1
100104,Electronics,110.23656463623047,2023-11-21,68,0,117.07371520996094,7961.012634277344,1,11,0,47,54356,1
100104,Electronics,110.23656463623047,2023-11-22,98,0,117.07371520996094,11473.224090576172,2,11,0,47,54454,1
100104,Electronics,110.23656463623047,2023-11-23,80,0,117.07371520996094,9365.897216796875,3,11,0,47,54534,1
100104,Electronics,110.23656463623047,2023-11-24,66,0,117.07371520996094,7726.865203857422,4,11,0,47,54600,1
100104,Electronics,110.23656463623047,2023-11-25,64,192,103.34397644042969,25884.668984375,5,11,1,47,54664,1
100104,Electronics,110.23656463623047,2023-11-26,110,0,107.80795288085938,11858.874816894531,6,11,1,47,54774,1
100104,Electronics,110.23656463623047,2023-11-27,121,240,111.77185592651367,40489.83913421631,0,11,0,48,54895,1
100104,Electronics,110.23656463623047,2023-11-28,79,0,110.59371185302734,8736.90323638916,1,11,0,48,54974,1
100104,Electronics,110.23656463623047,2023-11-29,100,282,116.07845901489259,44642.551802978516,2,11,0,48,55074,1
100104,Electronics,110.23656463623047,2023-11-30,132,0,114.42691802978516,15104.35317993164,3,11,0,48,55206,1
100104,Electronics,110.23656463623047,2023-12-01,58,0,114.42691802978516,6636.761245727539,4,12,0,48,55264,1
100104,Electronics,110.23656463623047,2023-12-02,127,193,114.87894287109376,36772.55148925781,5,12,1,48,55391,1
100104,Electronics,110.23656463623047,2023-12-03,24,0,114.7078857421875,2752.9892578125,6,12,1,48,55415,1
100104,Electronics,110.23656463623047,2023-12-04,52,0,114.7078857421875,5964.81005859375,0,12,0,49,55467,1
100104,Electronics,110.23656463623047,2023-12-05,94,213,115.09589599609376,35350.39844726563,1,12,0,49,55561,1
100104,Electronics,110.23656463623047,2023-12-06,131,321,106.07905029296876,47358.911176757814,2,12,0,49,55692,1
100104,Electronics,110.23656463623047,2023-12-07,102,0,109.1781005859375,11136.166259765625,3,12,0,49,55794,1
100104,Electronics,110.23656463623047,2023-12-08,99,0,109.1781005859375,10808.631958007812,4,12,0,49,55893,1
100104,Electronics,110.23656463623047,2023-12-09,81,0,109.1781005859375,8843.426147460938,5,12,1,49,55974,1
100104,Electronics,110.23656463623047,2023-12-10,80,0,109.1781005859375,8734.248046875,6,12,1,49,56054,1
100104,Electronics,110.23656463623047,2023-12-11,104,214,92.9749136352539,29055.08203613281,0,12,0,50,56158,1
100104,Electronics,110.23656463623047,2023-12-12,68,341,116.19591278076172,49007.634138183595,1,12,0,50,56226,1
100104,Electronics,110.23656463623047,2023-12-13,87,0,110.76182556152344,9636.278823852539,2,12,0,50,56313,1
100104,Electronics,110.23656463623047,2023-12-14,91,0,110.76182556152344,10079.326126098633,3,12,0,50,56404,1
100104,Electronics,110.23656463623047,2023-12-15,116,0,110.76182556152344,12848.371765136719,4,12,0,50,56520,1
100104,Electronics,110.23656463623047,2023-12-16,74,215,91.93220153808593,25565.585827636718,5,12,1,50,56594,1
100104,Electronics,110.23656463623047,2023-12-17,61,0,99.04440307617188,6041.708587646484,6,12,1,50,56655,1
100104,Electronics,110.23656463623047,2023-12-18,124,345,127.13809951782227,61681.27868041993,0,12,0,51,56779,1
100104,Electronics,110.23656463623047,2023-12-19,104,0,117.84619903564453,12256.004699707031,1,12,0,51,56883,1
100104,Electronics,110.23656463623047,2023-12-20,55,0,117.84619903564453,6481.540946960449,2,12,0,51,56938,1
100104,Electronics,110.23656463623047,2023-12-21,119,0,117.84619903564453,14023.6976852417,3,12,0,51,57057,1
100104,Electronics,110.23656463623047,2023-12-22,113,0,117.84619903564453,13316.620491027832,4,12,0,51,57170,1
100104,Electronics,110.23656463623047,2023-12-23,35,0,117.84619903564453,4124.616966247559,5,12,1,51,57205,1
100104,Electronics,110.23656463623047,2023-12-24,136,472,120.17654739379883,73165.94089111328,6,12,1,51,57341,1
100104,Electronics,110.23656463623047,2023-12-26,74,0,119.88309478759766,8871.349014282227,1,12,0,52,57415,1
100104,Electronics,110.23656463623047,2023-12-27,27,0,119.88309478759766,3236.8435592651367,2,12,0,52,57442,1
100104,Electronics,110.23656463623047,2023-12-28,66,0,119.88309478759766,7912.284255981445,3,12,0,52,57508,1
100104,Electronics,110.23656463623047,2023-12-29,36,0,119.88309478759766,4315.791412353516,4,12,0,52,57544,1
100104,Electronics,110.23656463623047,2023-12-30,41,0,119.88309478759766,4915.206886291504,5,12,1,52,57585,1
100104,Electronics,110.23656463623047,2023-12-31,38,0,119.88309478759766,4555.557601928711,6,12,1,52,57623,1
100104,Electronics,110.23656463623047,2024-01-01,21,0,119.88309478759766,2517.544990539551,0,1,0,1,57644,1
100104,Electronics,110.23656463623047,2024-01-02,31,0,119.88309478759766,3716.3759384155273,1,1,0,1,57675,1
100104,Electronics,110.23656463623047,2024-01-03,32,0,119.88309478759766,3836.259033203125,2,1,0,1,57707,1
100104,Electronics,110.23656463623047,2024-01-04,10,0,119.88309478759766,1198.8309478759766,3,1,0,1,57717,1
100104,Electronics,110.23656463623047,2024-01-05,63,127,95.42775283813477,17701.976857604983,4,1,0,1,57780,1
100104,Electronics,110.23656463623047,2024-01-06,15,0,102.13550567626953,1532.032585144043,5,1,1,1,57795,1
100104,Electronics,110.23656463623047,2024-01-07,44,0,102.13550567626953,4493.962249755859,6,1,1,1,57839,1
100104,Electronics,110.23656463623047,2024-01-08,62,145,89.55873229980469,18269.012805175782,0,1,0,2,57901,1
100104,Electronics,110.23656463623047,2024-01-09,39,188,98.51474792480468,22642.260338134765,1,1,0,2,57940,1
100104,Electronics,110.23656463623047,2024-01-10,116,0,96.63949584960938,11210.181518554688,2,1,0,2,58056,1
100104,Electronics,110.23656463623047,2024-01-11,107,256,100.74725280761719,36753.44210083008,3,1,0,2,58163,1
100104,Electronics,110.23656463623047,2024-01-12,107,0,99.52450561523438,10649.122100830078,4,1,0,2,58270,1
100104,Electronics,110.23656463623047,2024-01-13,121,330,122.00450317382813,56348.14976806641,5,1,1,2,58391,1
100104,Electronics,110.23656463623047,2024-01-14,114,0,115.66900634765625,13186.266723632812,6,1,1,2,58505,1
100104,Electronics,110.23656463623047,2024-01-15,103,0,115.66900634765625,11913.907653808594,0,1,0,3,58608,1
100104,Electronics,110.23656463623047,2024-01-16,46,0,115.66900634765625,5320.7742919921875,1,1,0,3,58654,1
100104,Electronics,110.23656463623047,2024-01-17,85,200,111.24055206298829,31530.993850708008,2,1,0,3,58739,1
100104,Electronics,110.23656463623047,2024-01-18,120,351,111.29331771850586,52314.43625244141,3,1,0,3,58859,1
100104,Electronics,110.23656463623047,2024-01-19,100,0,111.74663543701172,11174.663543701172,4,1,0,3,58959,1
100104,Electronics,110.23656463623047,2024-01-20,135,0,111.74663543701172,15085.795783996582,5,1,1,3,59094,1
100104,Electronics,110.23656463623047,2024-01-21,162,268,111.44271759033202,47908.42049926758,6,1,1,3,59256,1
100104,Electronics,110.23656463623047,2024-01-22,106,0,111.55543518066406,11824.87612915039,0,1,0,4,59362,1
100104,Electronics,110.23656463623047,2024-01-23,25,0,111.55543518066406,2788.8858795166016,1,1,0,4,59387,1
100104,Electronics,110.23656463623047,2024-01-24,88,234,121.67873504638672,39747.21736816406,2,1,0,4,59475,1
100104,Electronics,110.23656463623047,2024-01-25,57,0,117.79747009277344,6714.455795288086,3,1,0,4,59532,1
100104,Electronics,110.23656463623047,2024-01-26,63,0,117.79747009277344,7421.240615844727,4,1,0,4,59595,1
100104,Electronics,110.23656463623047,2024-01-27,103,0,117.79747009277344,12133.139419555664,5,1,1,4,59698,1
100104,Electronics,110.23656463623047,2024-01-28,76,188,105.93328231811523,27484.418912353514,6,1,1,4,59774,1
100104,Electronics,110.23656463623047,2024-01-29,85,0,110.23656463623047,9370.10799407959,0,1,0,5,59859,1
100104,Electronics,110.23656463623047,2024-01-30,86,0,110.23656463623047,9480.34455871582,1,1,0,5,59945,1
100105,Groceries,62.190677642822266,2022-01-01,65,423,54.40999992370605,26552.079990081787,5,1,1,52,65,3
100105,Groceries,62.190677642822266,2022-01-02,87,487,61.456200408935544,36033.37887115478,6,1,1,52,152,3
100105,Groceries,62.190677642822266,2022-01-03,0,761,58.17,44267.37,0,1,0,1,152,3
100105,Groceries,62.190677642822266,2022-01-05,91,0,58.86482620239258,5356.699184417725,2,1,0,1,243,3
100105,Groceries,62.190677642822266,2022-01-06,71,0,58.86482620239258,4179.402660369873,3,1,0,1,314,3
100105,Groceries,62.190677642822266,2022-01-07,64,0,58.86482620239258,3767.348876953125,4,1,0,1,378,3
100105,Groceries,62.190677642822266,2022-01-08,95,0,58.86482620239258,5592.158489227295,5,1,1,1,473,3
100105,Groceries,62.190677642822266,2022-01-09,88,0,58.86482620239258,5180.104705810547,6,1,1,1,561,3
100105,Groceries,62.190677642822266,2022-01-10,142,0,58.86482620239258,8358.805320739746,0,1,0,2,703,3
100105,Groceries,62.190677642822266,2022-01-11,80,0,58.86482620239258,4709.186096191406,1,1,0,2,783,3
100105,Groceries,62.190677642822266,2022-01-12,90,0,58.86482620239258,5297.834358215332,2,1,0,2,873,3
100105,Groceries,62.190677642822266,2022-01-13,131,0,58.86482620239258,7711.292232513428,3,1,0,2,1004,3
100105,Groceries,62.190677642822266,2022-01-14,117,684,66.88219345092773,55062.60326751709,4,1,0,2,1121,3
100105,Groceries,62.190677642822266,2022-01-15,141,0,64.25438690185547,9059.868553161621,5,1,1,2,1262,3
100105,Groceries,62.190677642822266,2022-01-16,165,0,64.25438690185547,10601.973838806152,6,1,1,2,1427,3
100105,Groceries,62.190677642822266,2022-01-17,94,0,64.25438690185547,6039.912368774414,0,1,0,3,1521,3
100105,Groceries,62.190677642822266,2022-01-18,148,0,64.25438690185547,9509.64926147461,1,1,0,3,1669,3
100105,Groceries,62.190677642822266,2022-01-19,84,0,64.25438690185547,5397.368499755859,2,1,0,3,1753,3
100105,Groceries,62.190677642822266,2022-01-20,87,0,64.25438690185547,5590.131660461426,3,1,0,3,1840,3
100105,Groceries,62.190677642822266,2022-01-21,129,514,59.70007308959961,37801.9188571167,4,1,0,3,1969,3
100105,Groceries,62.190677642822266,2022-01-22,130,951,69.50039108276367,77313.46168151856,5,1,1,3,2099,3
100105,Groceries,62.190677642822266,2022-01-23,57,0,66.84078216552734,3809.9245834350586,6,1,1,3,2156,3
100105,Groceries,62.190677642822266,2022-01-24,114,0,66.84078216552734,7619.849166870117,0,1,0,4,2270,3
100105,Groceries,62.190677642822266,2022-01-25,40,0,66.84078216552734,2673.6312866210938,1,1,0,4,2310,3
100105,Groceries,62.190677642822266,2022-01-26,180,0,66.84078216552734,12031.340789794922,2,1,0,4,2490,3
100105,Groceries,62.190677642822266,2022-01-27,58,0,66.84078216552734,3876.765365600586,3,1,0,4,2548,3
100105,Groceries,62.190677642822266,2022-01-28,130,0,66.84078216552734,8689.301681518555,4,1,0,4,2678,3
100105,Groceries,62.190677642822266,2022-01-29,137,0,66.84078216552734,9157.187156677246,5,1,1,4,2815,3
100105,Groceries,62.190677642822266,2022-01-30,27,0,66.84078216552734,1804.7011184692383,6,1,1,4,2842,3
100105,Groceries,62.190677642822266,2022-01-31,64,0,66.84078216552734,4277.81005859375,0,1,0,5,2906,3
100105,Groceries,62.190677642822266,2022-02-01,97,0,66.84078216552734,6483.555870056152,1,2,0,5,3003,3
100105,Groceries,62.190677642822266,2022-02-02,140,0,66.84078216552734,9357.709503173828,2,2,0,5,3143,3
100105,Groceries,62.190677642822266,2022-02-03,116,621,61.177823867797855,44079.1551373291,3,2,0,5,3259,3
100105,Groceries,62.190677642822266,2022-02-04,92,0,63.1756477355957,5812.159591674805,4,2,0,5,3351,3
100105,Groceries,62.190677642822266,2022-02-05,111,0,63.1756477355957,7012.496898651123,5,2,1,5,3462,3
100105,Groceries,62.190677642822266,2022-02-06,195,0,63.1756477355957,12319.251308441162,6,2,1,5,3657,3
100105,Groceries,62.190677642822266,2022-02-07,169,0,63.1756477355957,10676.684467315674,0,2,0,6,3826,3
100105,Groceries,62.190677642822266,2022-02-08,60,0,63.1756477355957,3790.538864135742,1,2,0,6,3886,3
100105,Groceries,62.190677642822266,2022-02-09,115,0,63.1756477355957,7265.199489593506,2,2,0,6,4001,3
100105,Groceries,62.190677642822266,2022-02-10,217,649,71.35841354370118,62691.311477966316,3,2,0,6,4218,3
100105,Groceries,62.190677642822266,2022-02-11,66,0,69.28682708740234,4572.930587768555,4,2,0,6,4284,3
100105,Groceries,62.190677642822266,2022-02-12,157,1097,76.84056335449219,98265.73689331055,5,2,1,6,4441,3
100105,Groceries,62.190677642822266,2022-02-14,91,0,74.81112670898438,6807.812530517578,0,2,0,7,4532,3
100105,Groceries,62.190677642822266,2022-02-15,85,0,74.81112670898438,6358.945770263672,1,2,0,7,4617,3
100105,Groceries,62.190677642822266,2022-02-16,119,0,74.81112670898438,8902.52407836914,2,2,0,7,4736,3
100105,Groceries,62.190677642822266,2022-02-17,129,0,74.81112670898438,9650.635345458984,3,2,0,7,4865,3
100105,Groceries,62.190677642822266,2022-02-18,187,0,74.81112670898438,13989.680694580078,4,2,0,7,5052,3
100105,Groceries,62.190677642822266,2022-02-19,108,0,74.81112670898438,8079.6016845703125,5,2,1,7,5160,3
100105,Groceries,62.190677642822266,2022-02-20,199,0,74.81112670898438,14887.41421508789,6,2,1,7,5359,3
100105,Groceries,62.190677642822266,2022-02-21,114,0,74.81112670898438,8528.468444824219,0,2,0,8,5473,3
100105,Groceries,62.190677642822266,2022-02-22,189,767,61.407275390625,56244.650097656246,1,2,0,8,5662,3
100105,Groceries,62.190677642822266,2022-02-23,277,0,65.66455078125,18189.08056640625,2,2,0,8,5939,3
100105,Groceries,62.190677642822266,2022-02-24,113,0,65.66455078125,7420.09423828125,3,2,0,8,6052,3
100105,Groceries,62.190677642822266,2022-02-25,114,0,65.66455078125,7485.7587890625,4,2,0,8,6166,3
100105,Groceries,62.190677642822266,2022-02-26,155,0,65.66455078125,10178.00537109375,5,2,1,8,6321,3
100105,Groceries,62.190677642822266,2022-02-27,98,618,56.390851974487305,38742.60698699951,6,2,1,8,6419,3
100105,Groceries,62.190677642822266,2022-02-28,100,0,59.53170394897461,5953.170394897461,0,2,0,9,6519,3
100105,Groceries,62.190677642822266,2022-03-01,100,0,59.53170394897461,5953.170394897461,1,3,0,9,6619,3
100105,Groceries,62.190677642822266,2022-03-02,88,0,59.53170394897461,5238.789947509766,2,3,0,9,6707,3
100105,Groceries,62.190677642822266,2022-03-03,33,0,59.53170394897461,1964.546230316162,3,3,0,9,6740,3
100105,Groceries,62.190677642822266,2022-03-04,49,0,59.53170394897461,2917.053493499756,4,3,0,9,6789,3
100105,Groceries,62.190677642822266,2022-03-05,182,697,65.84080856323243,59042.7043170166,5,3,1,9,6971,3
100105,Groceries,62.190677642822266,2022-03-06,59,0,63.571617126464844,3750.725410461426,6,3,1,9,7030,3
100105,Groceries,62.190677642822266,2022-03-07,50,0,63.571617126464844,3178.580856323242,0,3,0,10,7080,3
100105,Groceries,62.190677642822266,2022-03-08,91,0,63.571617126464844,5785.017158508301,1,3,0,10,7171,3
100105,Groceries,62.190677642822266,2022-03-09,24,0,63.571617126464844,1525.7188110351562,2,3,0,10,7195,3
100105,Groceries,62.190677642822266,2022-03-10,43,0,63.571617126464844,2733.5795364379883,3,3,0,10,7238,3
100105,Groceries,62.190677642822266,2022-03-11,75,0,63.571617126464844,4767.871284484863,4,3,0,10,7313,3
100105,Groceries,62.190677642822266,2022-03-12,115,0,63.571617126464844,7310.735969543457,5,3,1,10,7428,3
100105,Groceries,62.190677642822266,2022-03-13,41,0,63.571617126464844,2606.4363021850586,6,3,1,10,7469,3
100105,Groceries,62.190677642822266,2022-03-14,56,0,63.571617126464844,3560.0105590820312,0,3,0,11,7525,3
100105,Groceries,62.190677642822266,2022-03-15,54,0,63.571617126464844,3432.8673248291016,1,3,0,11,7579,3
100105,Groceries,62.190677642822266,2022-03-16,92,0,63.571617126464844,5848.588775634766,2,3,0,11,7671,3
100105,Groceries,62.190677642822266,2022-03-17,100,0,63.571617126464844,6357.161712646484,3,3,0,11,7771,3
100105,Groceries,62.190677642822266,2022-03-18,63,0,63.571617126464844,4005.011878967285,4,3,0,11,7834,3
100105,Groceries,62.190677642822266,2022-03-19,73,0,63.571617126464844,4640.728050231934,5,3,1,11,7907,3
100105,Groceries,62.190677642822266,2022-03-20,90,477,62.22140960693359,35135.803729248044,6,3,1,11,7997,3
100105,Groceries,62.190677642822266,2022-03-21,171,0,62.59281921386719,10703.372085571289,0,3,0,12,8168,3
100105,Groceries,62.190677642822266,2022-03-22,53,0,62.59281921386719,3317.419418334961,1,3,0,12,8221,3
100105,Groceries,62.190677642822266,2022-03-23,48,432,61.22644851684571,29190.37905761719,2,3,0,12,8269,3
100105,Groceries,62.190677642822266,2022-03-24,132,0,61.742897033691406,8150.062408447266,3,3,0,12,8401,3
100105,Groceries,62.190677642822266,2022-03-25,110,0,61.742897033691406,6791.718673706055,4,3,0,12,8511,3
100105,Groceries,62.190677642822266,2022-03-26,102,687,64.05454948425293,50980.9780947876,5,3,1,12,8613,3
100105,Groceries,62.190677642822266,2022-03-27,150,0,63.29909896850586,9494.864845275879,6,3,1,12,8763,3
100105,Groceries,62.190677642822266,2022-03-28,125,0,63.29909896850586,7912.387371063232,0,3,0,13,8888,3
100105,Groceries,62.190677642822266,2022-03-29,54,0,63.29909896850586,3418.1513442993164,1,3,0,13,8942,3
100105,Groceries,62.190677642822266,2022-03-30,63,0,63.29909896850586,3987.843235015869,2,3,0,13,9005,3
100105,Groceries,62.190677642822266,2022-03-31,91,0,63.29909896850586,5760.218006134033,3,3,0,13,9096,3
100105,Groceries,62.190677642822266,2022-04-01,72,0,63.29909896850586,4557.535125732422,4,4,0,13,9168,3
100105,Groceries,62.190677642822266,2022-04-02,152,0,63.29909896850586,9621.46304321289,5,4,1,13,9320,3
100105,Groceries,62.190677642822266,2022-04-03,110,654,57.3266145324707,42841.93519714355,6,4,1,13,9430,3
100105,Groceries,62.190677642822266,2022-04-04,47,0,59.083229064941406,2776.911766052246,0,4,0,14,9477,3
100105,Groceries,62.190677642822266,2022-04-05,154,0,59.083229064941406,9098.817276000977,1,4,0,14,9631,3
100105,Groceries,62.190677642822266,2022-04-06,93,0,59.083229064941406,5494.740303039551,2,4,0,14,9724,3
100105,Groceries,62.190677642822266,2022-04-07,52,0,59.083229064941406,3072.327911376953,3,4,0,14,9776,3
100105,Groceries,62.190677642822266,2022-04-08,123,0,59.083229064941406,7267.237174987793,4,4,0,14,9899,3
100105,Groceries,62.190677642822266,2022-04-09,98,0,59.083229064941406,5790.156448364258,5,4,1,14,9997,3
100105,Groceries,62.190677642822266,2022-04-10,105,684,53.06278915405274,40903.78572235107,6,4,1,14,10102,3
100105,Groceries,62.190677642822266,2022-04-11,101,0,54.72557830810547,5527.283409118652,0,4,0,15,10203,3
100105,Groceries,62.190677642822266,2022-04-12,146,0,54.72557830810547,7989.934432983398,1,4,0,15,10349,3
100105,Groceries,62.190677642822266,2022-04-13,115,0,54.72557830810547,6293.441505432129,2,4,0,15,10464,3
100105,Groceries,62.190677642822266,2022-04-14,57,0,54.72557830810547,3119.3579635620117,3,4,0,15,10521,3
100105,Groceries,62.190677642822266,2022-04-15,100,0,54.72557830810547,5472.557830810547,4,4,0,15,10621,3
100105,Groceries,62.190677642822266,2022-04-16,129,723,63.656875,55758.15375,5,4,1,15,10750,3
100105,Groceries,62.190677642822266,2022-04-17,110,0,61.09375,6720.3125,6,4,1,15,10860,3
100105,Groceries,62.190677642822266,2022-04-18,179,0,61.09375,10935.78125,0,4,0,16,11039,3
100105,Groceries,62.190677642822266,2022-04-19,70,0,61.09375,4276.5625,1,4,0,16,11109,3
100105,Groceries,62.190677642822266,2022-04-20,83,0,61.09375,5070.78125,2,4,0,16,11192,3
100105,Groceries,62.190677642822266,2022-04-21,65,0,61.09375,3971.09375,3,4,0,16,11257,3
100105,Groceries,62.190677642822266,2022-04-22,139,737,64.87086334228516,57532.00000915527,4,4,0,16,11396,3
100105,Groceries,62.190677642822266,2022-04-23,111,0,63.69172668457031,7069.781661987305,5,4,1,16,11507,3
100105,Groceries,62.190677642822266,2022-04-24,54,0,63.69172668457031,3439.353240966797,6,4,1,16,11561,3
100105,Groceries,62.190677642822266,2022-04-25,88,0,63.69172668457031,5604.8719482421875,0,4,0,17,11649,3
100105,Groceries,62.190677642822266,2022-04-26,32,0,63.69172668457031,2038.13525390625,1,4,0,17,11681,3
100105,Groceries,62.190677642822266,2022-04-27,104,0,63.69172668457031,6623.9395751953125,2,4,0,17,11785,3
100105,Groceries,62.190677642822266,2022-04-28,98,0,63.69172668457031,6241.789215087891,3,4,0,17,11883,3
100105,Groceries,62.190677642822266,2022-04-29,101,0,63.69172668457031,6432.864395141602,4,4,0,17,11984,3
100105,Groceries,62.190677642822266,2022-04-30,74,0,63.69172668457031,4713.187774658203,5,4,1,17,12058,3
100105,Groceries,62.190677642822266,2022-05-01,59,0,63.69172668457031,3757.8118743896484,6,5,1,17,12117,3
100105,Groceries,62.190677642822266,2022-05-02,60,0,63.69172668457031,3821.5036010742188,0,5,0,18,12177,3
100105,Groceries,62.190677642822266,2022-05-03,78,0,63.69172668457031,4967.954681396484,1,5,0,18,12255,3
100105,Groceries,62.190677642822266,2022-05-04,43,0,63.69172668457031,2738.7442474365234,2,5,0,18,12298,3
100105,Groceries,62.190677642822266,2022-05-05,54,0,63.69172668457031,3439.353240966797,3,5,0,18,12352,3
100105,Groceries,62.190677642822266,2022-05-06,66,319,56.48254447937012,21148.055871276854,4,5,0,18,12418,3
100105,Groceries,62.190677642822266,2022-05-07,74,0,58.845088958740234,4354.536582946777,5,5,1,18,12492,3
100105,Groceries,62.190677642822266,2022-05-08,27,0,58.845088958740234,1588.8174018859863,6,5,1,18,12519,3
100105,Groceries,62.190677642822266,2022-05-09,84,533,63.64617233276367,39922.45695190429,0,5,0,19,12603,3
100105,Groceries,62.190677642822266,2022-05-10,74,0,62.192344665527344,4602.233505249023,1,5,0,19,12677,3
100105,Groceries,62.190677642822266,2022-05-11,101,0,62.192344665527344,6281.426811218262,2,5,0,19,12778,3
100105,Groceries,62.190677642822266,2022-05-12,65,0,62.192344665527344,4042.5024032592773,3,5,0,19,12843,3
100105,Groceries,62.190677642822266,2022-05-13,93,0,62.192344665527344,5783.888053894043,4,5,0,19,12936,3
100105,Groceries,62.190677642822266,2022-05-14,95,0,62.192344665527344,5908.272743225098,5,5,1,19,13031,3
100105,Groceries,62.190677642822266,2022-05-15,37,0,62.192344665527344,2301.1167526245117,6,5,1,19,13068,3
100105,Groceries,62.190677642822266,2022-05-16,67,0,62.192344665527344,4166.887092590332,0,5,0,20,13135,3
100105,Groceries,62.190677642822266,2022-05-17,86,259,54.90410820007324,18408.366610412595,1,5,0,20,13221,3
100105,Groceries,62.190677642822266,2022-05-18,53,0,57.988216400146484,3073.3754692077637,2,5,0,20,13274,3
100105,Groceries,62.190677642822266,2022-05-19,44,0,57.988216400146484,2551.4815216064453,3,5,0,20,13318,3
100105,Groceries,62.190677642822266,2022-05-20,89,401,56.62436813354492,27591.697527770997,4,5,0,20,13407,3
100105,Groceries,62.190677642822266,2022-05-21,62,0,57.118736267089844,3541.3616485595703,5,5,1,20,13469,3
100105,Groceries,62.190677642822266,2022-05-22,64,0,57.118736267089844,3655.59912109375,6,5,1,20,13533,3
100105,Groceries,62.190677642822266,2022-05-23,63,0,57.118736267089844,3598.48038482666,0,5,0,21,13596,3
100105,Groceries,62.190677642822266,2022-05-24,43,0,57.118736267089844,2456.1056594848633,1,5,0,21,13639,3
100105,Groceries,62.190677642822266,2022-05-25,84,526,51.79644203186035,30801.80226135254,2,5,0,21,13723,3
100105,Groceries,62.190677642822266,2022-05-26,101,0,53.5928840637207,5412.881290435791,3,5,0,21,13824,3
100105,Groceries,62.190677642822266,2022-05-27,110,0,53.5928840637207,5895.217247009277,4,5,0,21,13934,3
100105,Groceries,62.190677642822266,2022-05-28,111,0,53.5928840637207,5948.810131072998,5,5,1,21,14045,3
100105,Groceries,62.190677642822266,2022-05-29,114,0,53.5928840637207,6109.58878326416,6,5,1,21,14159,3
100105,Groceries,62.190677642822266,2022-05-30,150,455,61.29497619628906,37960.342858886725,0,5,0,22,14309,3
100105,Groceries,62.190677642822266,2022-05-31,127,0,58.419952392578125,7419.333953857422,1,5,0,22,14436,3
100105,Groceries,62.190677642822266,2022-06-01,94,0,58.419952392578125,5491.475524902344,2,6,0,22,14530,3
100105,Groceries,62.190677642822266,2022-06-02,125,705,65.89246055603027,56023.315139007565,3,6,0,22,14655,3
100105,Groceries,62.190677642822266,2022-06-03,100,0,63.59492111206055,6359.492111206055,4,6,0,22,14755,3
100105,Groceries,62.190677642822266,2022-06-04,55,0,63.59492111206055,3497.72066116333,5,6,1,22,14810,3
100105,Groceries,62.190677642822266,2022-06-05,139,0,63.59492111206055,8839.694034576416,6,6,1,22,14949,3
100105,Groceries,62.190677642822266,2022-06-06,85,0,63.59492111206055,5405.5682945251465,0,6,0,23,15034,3
100105,Groceries,62.190677642822266,2022-06-07,108,0,63.59492111206055,6868.251480102539,1,6,0,23,15142,3
100105,Groceries,62.190677642822266,2022-06-08,270,1053,76.60799880981446,103945.6793572998,2,6,0,23,15412,3
100105,Groceries,62.190677642822266,2022-06-09,122,0,73.2959976196289,8942.111709594727,3,6,0,23,15534,3
100105,Groceries,62.190677642822266,2022-06-10,117,0,73.2959976196289,8575.631721496582,4,6,0,23,15651,3
100105,Groceries,62.190677642822266,2022-06-11,210,0,73.2959976196289,15392.15950012207,5,6,1,23,15861,3
100105,Groceries,62.190677642822266,2022-06-12,83,0,73.2959976196289,6083.567802429199,6,6,1,23,15944,3
100105,Groceries,62.190677642822266,2022-06-13,194,0,73.2959976196289,14219.423538208008,0,6,0,24,16138,3
100105,Groceries,62.190677642822266,2022-06-14,167,1041,86.59034118652343,107755.97395629883,1,6,0,24,16305,3
100105,Groceries,62.190677642822266,2022-06-15,197,0,82.98068237304688,16347.194427490234,2,6,0,24,16502,3
100105,Groceries,62.190677642822266,2022-06-16,153,0,82.98068237304688,12696.044403076172,3,6,0,24,16655,3
100105,Groceries,62.190677642822266,2022-06-17,79,0,82.98068237304688,6555.473907470703,4,6,0,24,16734,3
100105,Groceries,62.190677642822266,2022-06-18,187,0,82.98068237304688,15517.387603759766,5,6,1,24,16921,3
100105,Groceries,62.190677642822266,2022-06-19,93,0,82.98068237304688,7717.203460693359,6,6,1,24,17014,3
100105,Groceries,62.190677642822266,2022-06-20,184,0,82.98068237304688,15268.445556640625,0,6,0,25,17198,3
100105,Groceries,62.190677642822266,2022-06-21,191,762,73.74504837036133,68528.88847747803,1,6,0,25,17389,3
100105,Groceries,62.190677642822266,2022-06-22,108,0,76.81009674072266,8295.490447998047,2,6,0,25,17497,3
100105,Groceries,62.190677642822266,2022-06-23,158,0,76.81009674072266,12135.99528503418,3,6,0,25,17655,3
100105,Groceries,62.190677642822266,2022-06-24,92,0,76.81009674072266,7066.528900146484,4,6,0,25,17747,3
100105,Groceries,62.190677642822266,2022-06-25,124,0,76.81009674072266,9524.45199584961,5,6,1,25,17871,3
100105,Groceries,62.190677642822266,2022-06-26,115,0,76.81009674072266,8833.161125183105,6,6,1,25,17986,3
100105,Groceries,62.190677642822266,2022-06-27,79,0,76.81009674072266,6067.99764251709,0,6,0,26,18065,3
100105,Groceries,62.190677642822266,2022-06-28,119,0,76.81009674072266,9140.401512145996,1,6,0,26,18184,3
100105,Groceries,62.190677642822266,2022-06-29,98,589,64.98399200439454,42835.162432861325,2,6,0,26,18282,3
100105,Groceries,62.190677642822266,2022-06-30,27,0,68.66798400878906,1854.0355682373047,3,6,0,26,18309,3
100105,Groceries,62.190677642822266,2022-07-01,54,0,68.66798400878906,3708.0711364746094,4,7,0,26,18363,3
100105,Groceries,62.190677642822266,2022-07-02,35,0,68.66798400878906,2403.379440307617,5,7,1,26,18398,3
100105,Groceries,62.190677642822266,2022-07-03,214,0,68.66798400878906,14694.94857788086,6,7,1,26,18612,3
100105,Groceries,62.190677642822266,2022-07-04,97,0,68.66798400878906,6660.794448852539,0,7,0,27,18709,3
100105,Groceries,62.190677642822266,2022-07-05,73,0,68.66798400878906,5012.762832641602,1,7,0,27,18782,3
100105,Groceries,62.190677642822266,2022-07-06,80,0,68.66798400878906,5493.438720703125,2,7,0,27,18862,3
100105,Groceries,62.190677642822266,2022-07-07,102,341,61.64806503295898,26648.525266723635,3,7,0,27,18964,3
100105,Groceries,62.190677642822266,2022-07-08,115,0,64.41613006591797,7407.854957580566,4,7,0,27,19079,3
100105,Groceries,62.190677642822266,2022-07-09,98,409,59.411117248535156,29483.53898071289,5,7,1,27,19177,3
100105,Groceries,62.190677642822266,2022-07-10,103,0,61.46223449707031,6330.610153198242,6,7,1,27,19280,3
100105,Groceries,62.190677642822266,2022-07-11,65,0,61.46223449707031,3995.0452423095703,0,7,0,28,19345,3
100105,Groceries,62.190677642822266,2022-07-12,84,0,61.46223449707031,5162.827697753906,1,7,0,28,19429,3
100105,Groceries,62.190677642822266,2022-07-13,87,0,61.46223449707031,5347.214401245117,2,7,0,28,19516,3
100105,Groceries,62.190677642822266,2022-07-14,162,746,59.99098281860351,54243.47843322754,3,7,0,28,19678,3
100105,Groceries,62.190677642822266,2022-07-15,111,0,60.38196563720703,6702.3981857299805,4,7,0,28,19789,3
100105,Groceries,62.190677642822266,2022-07-16,124,0,60.38196563720703,7487.363739013672,5,7,1,28,19913,3
100105,Groceries,62.190677642822266,2022-07-17,99,0,60.38196563720703,5977.814598083496,6,7,1,28,20012,3
100105,Groceries,62.190677642822266,2022-07-18,52,0,60.38196563720703,3139.8622131347656,0,7,0,29,20064,3
100105,Groceries,62.190677642822266,2022-07-19,196,632,58.882681884765624,48513.89129882812,1,7,0,29,20260,3
100105,Groceries,62.190677642822266,2022-07-20,87,0,59.43536376953125,5170.876647949219,2,7,0,29,20347,3
100105,Groceries,62.190677642822266,2022-07-21,17,0,59.43536376953125,1010.4011840820312,3,7,0,29,20364,3
100105,Groceries,62.190677642822266,2022-07-22,51,0,59.43536376953125,3031.2035522460938,4,7,0,29,20415,3
100105,Groceries,62.190677642822266,2022-07-23,70,0,59.43536376953125,4160.4754638671875,5,7,1,29,20485,3
100105,Groceries,62.190677642822266,2022-07-24,60,0,59.43536376953125,3566.121826171875,6,7,1,29,20545,3
100105,Groceries,62.190677642822266,2022-07-25,130,0,59.43536376953125,7726.5972900390625,0,7,0,30,20675,3
100105,Groceries,62.190677642822266,2022-07-26,152,0,59.43536376953125,9034.17529296875,1,7,0,30,20827,3
100105,Groceries,62.190677642822266,2022-07-27,89,511,51.876567153930665,29937.348953399658,2,7,0,30,20916,3
100105,Groceries,62.190677642822266,2022-07-28,159,796,67.86769248962403,68108.40621170044,3,7,0,30,21075,3
100105,Groceries,62.190677642822266,2022-07-29,150,0,62.69538497924805,9404.307746887207,4,7,0,30,21225,3
100105,Groceries,62.190677642822266,2022-07-30,181,0,62.69538497924805,11347.864681243896,5,7,1,30,21406,3
100105,Groceries,62.190677642822266,2022-07-31,150,0,62.69538497924805,9404.307746887207,6,7,1,30,21556,3
100105,Groceries,62.190677642822266,2022-08-01,128,0,62.69538497924805,8025.00927734375,0,8,0,31,21684,3
100105,Groceries,62.190677642822266,2022-08-02,129,0,62.69538497924805,8087.704662322998,1,8,0,31,21813,3
100105,Groceries,62.190677642822266,2022-08-03,102,0,62.69538497924805,6394.929267883301,2,8,0,31,21915,3
100105,Groceries,62.190677642822266,2022-08-04,129,678,73.4854165649414,61545.167473754875,3,8,0,31,22044,3
100105,Groceries,62.190677642822266,2022-08-05,195,0,69.40083312988281,13533.162460327148,4,8,0,31,22239,3
100105,Groceries,62.190677642822266,2022-08-06,124,0,69.40083312988281,8605.703308105469,5,8,1,31,22363,3
100105,Groceries,62.190677642822266,2022-08-07,95,0,69.40083312988281,6593.079147338867,6,8,1,31,22458,3
100105,Groceries,62.190677642822266,2022-08-08,145,0,69.40083312988281,10063.120803833008,0,8,0,32,22603,3
100105,Groceries,62.190677642822266,2022-08-09,231,749,76.54922119140625,76324.00019042968,1,8,0,32,22834,3
100105,Groceries,62.190677642822266,2022-08-10,148,0,74.0284423828125,10956.20947265625,2,8,0,32,22982,3
100105,Groceries,62.190677642822266,2022-08-11,111,0,74.0284423828125,8217.157104492188,3,8,0,32,23093,3
100105,Groceries,62.190677642822266,2022-08-12,121,0,74.0284423828125,8957.441528320312,4,8,0,32,23214,3
100105,Groceries,62.190677642822266,2022-08-13,231,933,74.23882797241211,86463.95852325439,5,8,1,32,23445,3
100105,Groceries,62.190677642822266,2022-08-14,166,0,74.16765594482422,12311.83088684082,6,8,1,32,23611,3
100105,Groceries,62.190677642822266,2022-08-15,103,0,74.16765594482422,7639.2685623168945,0,8,0,33,23714,3
100105,Groceries,62.190677642822266,2022-08-16,212,0,74.16765594482422,15723.543060302734,1,8,0,33,23926,3
100105,Groceries,62.190677642822266,2022-08-17,90,0,74.16765594482422,6675.08903503418,2,8,0,33,24016,3
100105,Groceries,62.190677642822266,2022-08-18,164,0,74.16765594482422,12163.495574951172,3,8,0,33,24180,3
100105,Groceries,62.190677642822266,2022-08-19,195,0,74.16765594482422,14462.692909240723,4,8,0,33,24375,3
100105,Groceries,62.190677642822266,2022-08-20,123,0,74.16765594482422,9122.621681213379,5,8,1,33,24498,3
100105,Groceries,62.190677642822266,2022-08-21,153,772,71.08561264038086,65218.37746795654,6,8,1,33,24651,3
100105,Groceries,62.190677642822266,2022-08-22,106,0,71.95122528076172,7626.829879760742,0,8,0,34,24757,3
100105,Groceries,62.190677642822266,2022-08-23,190,0,71.95122528076172,13670.732803344727,1,8,0,34,24947,3
100105,Groceries,62.190677642822266,2022-08-24,124,0,71.95122528076172,8921.951934814453,2,8,0,34,25071,3
100105,Groceries,62.190677642822266,2022-08-25,178,874,64.3048583984375,65974.92958984376,3,8,0,34,25249,3
100105,Groceries,62.190677642822266,2022-08-26,110,0,66.709716796875,7338.06884765625,4,8,0,34,25359,3
100105,Groceries,62.190677642822266,2022-08-27,74,0,66.709716796875,4936.51904296875,5,8,1,34,25433,3
100105,Groceries,62.190677642822266,2022-08-28,74,0,66.709716796875,4936.51904296875,6,8,1,34,25507,3
100105,Groceries,62.190677642822266,2022-08-29,77,0,66.709716796875,5136.648193359375,0,8,0,35,25584,3
100105,Groceries,62.190677642822266,2022-08-30,210,0,66.709716796875,14009.04052734375,1,8,0,35,25794,3
100105,Groceries,62.190677642822266,2022-08-31,91,0,66.709716796875,6070.584228515625,2,8,0,35,25885,3
100105,Groceries,62.190677642822266,2022-09-01,118,0,66.709716796875,7871.74658203125,3,9,0,35,26003,3
100105,Groceries,62.190677642822266,2022-09-02,92,0,66.709716796875,6137.2939453125,4,9,0,35,26095,3
100105,Groceries,62.190677642822266,2022-09-03,103,0,66.709716796875,6871.100830078125,5,9,1,35,26198,3
100105,Groceries,62.190677642822266,2022-09-04,114,858,67.31362197875976,65537.74581115722,6,9,1,35,26312,3
100105,Groceries,62.190677642822266,2022-09-05,127,0,67.16724395751953,8530.23998260498,0,9,0,36,26439,3
100105,Groceries,62.190677642822266,2022-09-06,105,0,67.16724395751953,7052.560615539551,1,9,0,36,26544,3
100105,Groceries,62.190677642822266,2022-09-07,173,0,67.16724395751953,11619.933204650879,2,9,0,36,26717,3
100105,Groceries,62.190677642822266,2022-09-08,97,0,67.16724395751953,6515.2226638793945,3,9,0,36,26814,3
100105,Groceries,62.190677642822266,2022-09-09,74,0,67.16724395751953,4970.376052856445,4,9,0,36,26888,3
100105,Groceries,62.190677642822266,2022-09-10,113,0,67.16724395751953,7589.898567199707,5,9,1,36,27001,3
100105,Groceries,62.190677642822266,2022-09-11,90,0,67.16724395751953,6045.051956176758,6,9,1,36,27091,3
100105,Groceries,62.190677642822266,2022-09-12,135,565,69.33289993286132,48824.18298187256,0,9,0,37,27226,3
100105,Groceries,62.190677642822266,2022-09-13,70,0,68.65579986572266,4805.905990600586,1,9,0,37,27296,3
100105,Groceries,62.190677642822266,2022-09-14,114,0,68.65579986572266,7826.761184692383,2,9,0,37,27410,3
100105,Groceries,62.190677642822266,2022-09-15,42,0,68.65579986572266,2883.5435943603516,3,9,0,37,27452,3
100105,Groceries,62.190677642822266,2022-09-16,196,636,66.16771102905273,54656.542723388666,4,9,0,37,27648,3
100105,Groceries,62.190677642822266,2022-09-17,92,0,67.06542205810547,6170.018829345703,5,9,1,37,27740,3
100105,Groceries,62.190677642822266,2022-09-18,175,0,67.06542205810547,11736.448860168457,6,9,1,37,27915,3
100105,Groceries,62.190677642822266,2022-09-19,109,0,67.06542205810547,7310.131004333496,0,9,0,38,28024,3
100105,Groceries,62.190677642822266,2022-09-20,32,0,67.06542205810547,2146.093505859375,1,9,0,38,28056,3
100105,Groceries,62.190677642822266,2022-09-21,111,0,67.06542205810547,7444.261848449707,2,9,0,38,28167,3
100105,Groceries,62.190677642822266,2022-09-22,152,483,64.45091445922851,40581.78799560547,3,9,0,38,28319,3
100105,Groceries,62.190677642822266,2022-09-23,105,0,65.49182891845703,6876.642036437988,4,9,0,38,28424,3
100105,Groceries,62.190677642822266,2022-09-24,104,0,65.49182891845703,6811.150207519531,5,9,1,38,28528,3
100105,Groceries,62.190677642822266,2022-09-25,164,0,65.49182891845703,10740.659942626953,6,9,1,38,28692,3
100105,Groceries,62.190677642822266,2022-09-26,82,0,65.49182891845703,5370.329971313477,0,9,0,39,28774,3
100105,Groceries,62.190677642822266,2022-09-27,135,546,58.42479331970215,38856.45419631958,1,9,0,39,28909,3
100105,Groceries,62.190677642822266,2022-09-28,48,0,60.6895866394043,2913.1001586914062,2,9,0,39,28957,3
100105,Groceries,62.190677642822266,2022-09-29,97,0,60.6895866394043,5886.889904022217,3,9,0,39,29054,3
100105,Groceries,62.190677642822266,2022-09-30,94,0,60.6895866394043,5704.821144104004,4,9,0,39,29148,3
100105,Groceries,62.190677642822266,2022-10-01,135,866,73.54814682006835,76291.19964141845,5,10,1,39,29283,3
100105,Groceries,62.190677642822266,2022-10-02,101,0,69.89629364013672,7059.525657653809,6,10,1,39,29384,3
100105,Groceries,62.190677642822266,2022-10-03,56,0,69.89629364013672,3914.1924438476562,0,10,0,40,29440,3
100105,Groceries,62.190677642822266,2022-10-04,49,0,69.89629364013672,3424.918388366699,1,10,0,40,29489,3
100105,Groceries,62.190677642822266,2022-10-05,88,0,69.89629364013672,6150.873840332031,2,10,0,40,29577,3
100105,Groceries,62.190677642822266,2022-10-06,103,0,69.89629364013672,7199.318244934082,3,10,0,40,29680,3
100105,Groceries,62.190677642822266,2022-10-07,186,0,69.89629364013672,13000.71061706543,4,10,0,40,29866,3
100105,Groceries,62.190677642822266,2022-10-08,86,0,69.89629364013672,6011.081253051758,5,10,1,40,29952,3
100105,Groceries,62.190677642822266,2022-10-09,118,0,69.89629364013672,8247.762649536133,6,10,1,40,30070,3
100105,Groceries,62.190677642822266,2022-10-10,101,0,69.89629364013672,7059.525657653809,0,10,0,41,30171,3
100105,Groceries,62.190677642822266,2022-10-11,195,631,60.0053377532959,48288.961723785396,1,10,0,41,30366,3
100105,Groceries,62.190677642822266,2022-10-12,81,0,62.9306755065918,5097.384716033936,2,10,0,41,30447,3
100105,Groceries,62.190677642822266,2022-10-13,205,0,62.9306755065918,12900.788478851318,3,10,0,41,30652,3
100105,Groceries,62.190677642822266,2022-10-14,49,0,62.9306755065918,3083.603099822998,4,10,0,41,30701,3
100105,Groceries,62.190677642822266,2022-10-15,150,643,60.80100326538086,47869.60097961426,5,10,1,41,30851,3
100105,Groceries,62.190677642822266,2022-10-16,106,0,61.50200653076172,6519.212692260742,6,10,1,41,30957,3
100105,Groceries,62.190677642822266,2022-10-17,109,0,61.50200653076172,6703.718711853027,0,10,0,42,31066,3
100105,Groceries,62.190677642822266,2022-10-18,105,0,61.50200653076172,6457.7106857299805,1,10,0,42,31171,3
100105,Groceries,62.190677642822266,2022-10-19,103,0,61.50200653076172,6334.706672668457,2,10,0,42,31274,3
100105,Groceries,62.190677642822266,2022-10-20,77,0,61.50200653076172,4735.654502868652,3,10,0,42,31351,3
100105,Groceries,62.190677642822266,2022-10-21,223,857,61.91087509155274,66932.93029083252,4,10,0,42,31574,3
100105,Groceries,62.190677642822266,2022-10-22,124,0,61.80175018310547,7663.417022705078,5,10,1,42,31698,3
100105,Groceries,62.190677642822266,2022-10-23,187,0,61.80175018310547,11556.927284240723,6,10,1,42,31885,3
100105,Groceries,62.190677642822266,2022-10-24,90,0,61.80175018310547,5562.157516479492,0,10,0,43,31975,3
100105,Groceries,62.190677642822266,2022-10-25,170,0,61.80175018310547,10506.29753112793,1,10,0,43,32145,3
100105,Groceries,62.190677642822266,2022-10-26,58,0,61.80175018310547,3584.501510620117,2,10,0,43,32203,3
100105,Groceries,62.190677642822266,2022-10-27,83,0,61.80175018310547,5129.545265197754,3,10,0,43,32286,3
100105,Groceries,62.190677642822266,2022-10-28,184,725,66.7628923034668,61421.66436767578,4,10,0,43,32470,3
100105,Groceries,62.190677642822266,2022-10-29,51,0,65.4057846069336,3335.6950149536133,5,10,1,43,32521,3
100105,Groceries,62.190677642822266,2022-10-30,86,0,65.4057846069336,5624.897476196289,6,10,1,43,32607,3
100105,Groceries,62.190677642822266,2022-10-31,107,0,65.4057846069336,6998.4189529418945,0,10,0,44,32714,3
100105,Groceries,62.190677642822266,2022-11-01,186,0,65.4057846069336,12165.475936889648,1,11,0,44,32900,3
100105,Groceries,62.190677642822266,2022-11-02,69,0,65.4057846069336,4512.999137878418,2,11,0,44,32969,3
100105,Groceries,62.190677642822266,2022-11-03,113,0,65.4057846069336,7390.853660583496,3,11,0,44,33082,3
100105,Groceries,62.190677642822266,2022-11-04,103,348,62.136245040893556,27698.516478424073,4,11,0,44,33185,3
100105,Groceries,62.190677642822266,2022-11-05,97,0,63.46249008178711,6155.86153793335,5,11,1,44,33282,3
100105,Groceries,62.190677642822266,2022-11-06,43,0,63.46249008178711,2728.8870735168457,6,11,1,44,33325,3
100105,Groceries,62.190677642822266,2022-11-07,62,0,63.46249008178711,3934.674385070801,0,11,0,45,33387,3
100105,Groceries,62.190677642822266,2022-11-08,100,0,63.46249008178711,6346.249008178711,1,11,0,45,33487,3
100105,Groceries,62.190677642822266,2022-11-09,92,670,67.71813415527345,52186.07668457032,2,11,0,45,33579,3
100105,Groceries,62.190677642822266,2022-11-10,83,0,66.70626831054688,5536.620269775391,3,11,0,45,33662,3
100105,Groceries,62.190677642822266,2022-11-11,124,0,66.70626831054688,8271.577270507812,4,11,0,45,33786,3
100105,Groceries,62.190677642822266,2022-11-12,119,966,68.91076889038087,75309.61299591065,5,11,1,45,33905,3
100105,Groceries,62.190677642822266,2022-11-13,210,0,68.27153778076172,14337.022933959961,6,11,1,45,34115,3
100105,Groceries,62.190677642822266,2022-11-14,67,0,68.27153778076172,4574.193031311035,0,11,0,46,34182,3
100105,Groceries,62.190677642822266,2022-11-15,124,0,68.27153778076172,8465.670684814453,1,11,0,46,34306,3
100105,Groceries,62.190677642822266,2022-11-16,64,0,68.27153778076172,4369.37841796875,2,11,0,46,34370,3
100105,Groceries,62.190677642822266,2022-11-17,195,0,68.27153778076172,13312.949867248535,3,11,0,46,34565,3
100105,Groceries,62.190677642822266,2022-11-18,126,0,68.27153778076172,8602.213760375977,4,11,0,46,34691,3
100105,Groceries,62.190677642822266,2022-11-19,49,0,68.27153778076172,3345.305351257324,5,11,1,46,34740,3
100105,Groceries,62.190677642822266,2022-11-20,80,0,68.27153778076172,5461.7230224609375,6,11,1,46,34820,3
100105,Groceries,62.190677642822266,2022-11-21,112,0,68.27153778076172,7646.4122314453125,0,11,0,47,34932,3
100105,Groceries,62.190677642822266,2022-11-22,105,500,54.966066207885746,31265.223903656006,1,11,0,47,35037,3
100105,Groceries,62.190677642822266,2022-11-23,104,0,60.002132415771484,6240.221771240234,2,11,0,47,35141,3
100105,Groceries,62.190677642822266,2022-11-24,157,0,60.002132415771484,9420.334789276123,3,11,0,47,35298,3
100105,Groceries,62.190677642822266,2022-11-25,195,613,66.41145042419433,54671.40566543579,4,11,0,47,35493,3
100105,Groceries,62.190677642822266,2022-11-26,72,0,63.99290084838867,4607.488861083984,5,11,1,47,35565,3
100105,Groceries,62.190677642822266,2022-11-27,110,0,63.99290084838867,7039.219093322754,6,11,1,47,35675,3
100105,Groceries,62.190677642822266,2022-11-28,71,0,63.99290084838867,4543.495960235596,0,11,0,48,35746,3
100105,Groceries,62.190677642822266,2022-11-29,109,0,63.99290084838867,6975.226192474365,1,11,0,48,35855,3
100105,Groceries,62.190677642822266,2022-11-30,91,0,63.99290084838867,5823.353977203369,2,11,0,48,35946,3
100105,Groceries,62.190677642822266,2022-12-01,87,0,63.99290084838867,5567.382373809814,3,12,0,48,36033,3
100105,Groceries,62.190677642822266,2022-12-02,67,0,63.99290084838867,4287.524356842041,4,12,0,48,36100,3
100105,Groceries,62.190677642822266,2022-12-03,107,552,64.90517471313476,42908.15738861084,5,12,1,48,36207,3
100105,Groceries,62.190677642822266,2022-12-04,46,0,64.60034942626953,2971.6160736083984,6,12,1,48,36253,3
100105,Groceries,62.190677642822266,2022-12-05,152,1090,68.15786849975586,85667.11202392577,0,12,0,49,36405,3
100105,Groceries,62.190677642822266,2022-12-06,195,0,67.07573699951172,13079.768714904785,1,12,0,49,36600,3
100105,Groceries,62.190677642822266,2022-12-07,46,0,67.07573699951172,3085.483901977539,2,12,0,49,36646,3
100105,Groceries,62.190677642822266,2022-12-08,144,0,67.07573699951172,9658.906127929688,3,12,0,49,36790,3
100105,Groceries,62.190677642822266,2022-12-09,109,0,67.07573699951172,7311.255332946777,4,12,0,49,36899,3
100105,Groceries,62.190677642822266,2022-12-10,138,0,67.07573699951172,9256.451705932617,5,12,1,49,37037,3
100105,Groceries,62.190677642822266,2022-12-11,78,0,67.07573699951172,5231.907485961914,6,12,1,49,37115,3
100105,Groceries,62.190677642822266,2022-12-12,180,0,67.07573699951172,12073.63265991211,0,12,0,50,37295,3
100105,Groceries,62.190677642822266,2022-12-13,112,0,67.07573699951172,7512.4825439453125,1,12,0,50,37407,3
100105,Groceries,62.190677642822266,2022-12-14,248,844,74.35785537719727,82696.01626708984,2,12,0,50,37655,3
100105,Groceries,62.190677642822266,2022-12-15,144,0,71.84571075439453,10345.782348632812,3,12,0,50,37799,3
100105,Groceries,62.190677642822266,2022-12-16,174,0,71.84571075439453,12501.153671264648,4,12,0,50,37973,3
100105,Groceries,62.190677642822266,2022-12-17,129,0,71.84571075439453,9268.096687316895,5,12,1,50,38102,3
100105,Groceries,62.190677642822266,2022-12-18,233,919,69.27706985473633,79171.21455230712,6,12,1,50,38335,3
100105,Groceries,62.190677642822266,2022-12-19,148,0,70.20413970947266,10390.212677001953,0,12,0,51,38483,3
100105,Groceries,62.190677642822266,2022-12-20,135,0,70.20413970947266,9477.558860778809,1,12,0,51,38618,3
100105,Groceries,62.190677642822266,2022-12-21,132,0,70.20413970947266,9266.94644165039,2,12,0,51,38750,3
100105,Groceries,62.190677642822266,2022-12-22,98,0,70.20413970947266,6880.00569152832,3,12,0,51,38848,3
100105,Groceries,62.190677642822266,2022-12-23,70,0,70.20413970947266,4914.289779663086,4,12,0,51,38918,3
100105,Groceries,62.190677642822266,2022-12-24,55,0,70.20413970947266,3861.227684020996,5,12,1,51,38973,3
100105,Groceries,62.190677642822266,2022-12-25,96,0,70.20413970947266,6739.597412109375,6,12,1,51,39069,3
100105,Groceries,62.190677642822266,2022-12-26,118,0,70.20413970947266,8284.088485717773,0,12,0,52,39187,3
100105,Groceries,62.190677642822266,2022-12-27,65,0,70.20413970947266,4563.269081115723,1,12,0,52,39252,3
100105,Groceries,62.190677642822266,2022-12-28,58,0,70.20413970947266,4071.840103149414,2,12,0,52,39310,3
100105,Groceries,62.190677642822266,2022-12-29,75,0,70.20413970947266,5265.310478210449,3,12,0,52,39385,3
100105,Groceries,62.190677642822266,2022-12-30,150,0,70.20413970947266,10530.620956420898,4,12,0,52,39535,3
100105,Groceries,62.190677642822266,2022-12-31,159,754,66.3610368347168,59997.959713439945,5,12,1,52,39694,3
100105,Groceries,62.190677642822266,2023-01-01,194,0,67.3520736694336,13066.302291870117,6,1,1,52,39888,3
100105,Groceries,62.190677642822266,2023-01-02,170,0,67.3520736694336,11449.852523803711,0,1,0,1,40058,3
100105,Groceries,62.190677642822266,2023-01-03,1,0,67.3520736694336,67.3520736694336,1,1,0,1,40059,3
100105,Groceries,62.190677642822266,2023-01-04,67,0,67.3520736694336,4512.588935852051,2,1,0,1,40126,3
100105,Groceries,62.190677642822266,2023-01-05,172,688,69.9011344909668,60552.99026489258,3,1,0,1,40298,3
100105,Groceries,62.190677642822266,2023-01-06,164,0,69.0522689819336,11324.57211303711,4,1,0,1,40462,3
100105,Groceries,62.190677642822266,2023-01-07,104,0,69.0522689819336,7181.435974121094,5,1,1,1,40566,3
100105,Groceries,62.190677642822266,2023-01-08,140,0,69.0522689819336,9667.317657470703,6,1,1,1,40706,3
100105,Groceries,62.190677642822266,2023-01-09,143,0,69.0522689819336,9874.474464416504,0,1,0,2,40849,3
100105,Groceries,62.190677642822266,2023-01-10,168,700,69.1795571899414,60069.37121582031,1,1,0,2,41017,3
100105,Groceries,62.190677642822266,2023-01-11,186,0,69.13911437988281,12859.875274658203,2,1,0,2,41203,3
100105,Groceries,62.190677642822266,2023-01-12,66,0,69.13911437988281,4563.181549072266,3,1,0,2,41269,3
100105,Groceries,62.190677642822266,2023-01-13,65,0,69.13911437988281,4494.042434692383,4,1,0,2,41334,3
100105,Groceries,62.190677642822266,2023-01-14,166,0,69.13911437988281,11477.092987060547,5,1,1,2,41500,3
100105,Groceries,62.190677642822266,2023-01-15,87,0,69.13911437988281,6015.102951049805,6,1,1,2,41587,3
100105,Groceries,62.190677642822266,2023-01-16,206,823,77.17641418457032,80761.80264404297,0,1,0,3,41793,3
100105,Groceries,62.190677642822266,2023-01-17,165,0,74.99282836914062,12373.816680908203,1,1,0,3,41958,3
100105,Groceries,62.190677642822266,2023-01-18,96,0,74.99282836914062,7199.3115234375,2,1,0,3,42054,3
100105,Groceries,62.190677642822266,2023-01-19,147,1016,85.66245239257813,102621.35100341796,3,1,0,3,42201,3
100105,Groceries,62.190677642822266,2023-01-20,122,0,82.21490478515625,10030.218383789062,4,1,0,3,42323,3
100105,Groceries,62.190677642822266,2023-01-21,179,0,82.21490478515625,14716.467956542969,5,1,1,3,42502,3
100105,Groceries,62.190677642822266,2023-01-22,109,0,82.21490478515625,8961.424621582031,6,1,1,3,42611,3
100105,Groceries,62.190677642822266,2023-01-23,142,0,82.21490478515625,11674.516479492188,0,1,0,4,42753,3
100105,Groceries,62.190677642822266,2023-01-24,146,0,82.21490478515625,12003.376098632812,1,1,0,4,42899,3
100105,Groceries,62.190677642822266,2023-01-25,134,0,82.21490478515625,11016.797241210938,2,1,0,4,43033,3
100105,Groceries,62.190677642822266,2023-01-26,74,0,82.21490478515625,6083.9029541015625,3,1,0,4,43107,3
100105,Groceries,62.190677642822266,2023-01-27,73,0,82.21490478515625,6001.688049316406,4,1,0,4,43180,3
100105,Groceries,62.190677642822266,2023-01-28,188,0,82.21490478515625,15456.402099609375,5,1,1,4,43368,3
100105,Groceries,62.190677642822266,2023-01-29,51,0,82.21490478515625,4192.960144042969,6,1,1,4,43419,3
100105,Groceries,62.190677642822266,2023-01-30,30,0,82.21490478515625,2466.4471435546875,0,1,0,5,43449,3
100105,Groceries,62.190677642822266,2023-01-31,61,0,82.21490478515625,5015.109191894531,1,1,0,5,43510,3
100105,Groceries,62.190677642822266,2023-02-01,61,0,82.21490478515625,5015.109191894531,2,2,0,5,43571,3
100105,Groceries,62.190677642822266,2023-02-02,52,0,82.21490478515625,4275.175048828125,3,2,0,5,43623,3
100105,Groceries,62.190677642822266,2023-02-03,40,0,82.21490478515625,3288.59619140625,4,2,0,5,43663,3
100105,Groceries,62.190677642822266,2023-02-04,66,288,63.910923919677735,21016.98195739746,5,2,1,5,43729,3
100105,Groceries,62.190677642822266,2023-02-05,95,0,71.15184783935547,6759.4255447387695,6,2,1,5,43824,3
100105,Groceries,62.190677642822266,2023-02-06,103,0,71.15184783935547,7328.640327453613,0,2,0,6,43927,3
100105,Groceries,62.190677642822266,2023-02-07,113,484,59.703413772583005,34398.82151260376,1,2,0,6,44040,3
100105,Groceries,62.190677642822266,2023-02-08,51,0,63.056827545166016,3215.898204803467,2,2,0,6,44091,3
100105,Groceries,62.190677642822266,2023-02-09,77,0,63.056827545166016,4855.375720977783,3,2,0,6,44168,3
100105,Groceries,62.190677642822266,2023-02-10,90,0,63.056827545166016,5675.114479064941,4,2,0,6,44258,3
100105,Groceries,62.190677642822266,2023-02-11,125,0,63.056827545166016,7882.103443145752,5,2,1,6,44383,3
100105,Groceries,62.190677642822266,2023-02-12,35,0,63.056827545166016,2206.9889640808105,6,2,1,6,44418,3
100105,Groceries,62.190677642822266,2023-02-13,87,425,50.505318298339844,24515.065383911133,0,2,0,7,44505,3
100105,Groceries,62.190677642822266,2023-02-14,36,0,54.48063659667969,1961.3029174804688,1,2,0,7,44541,3
100105,Groceries,62.190677642822266,2023-02-15,75,0,54.48063659667969,4086.0477447509766,2,2,0,7,44616,3
100105,Groceries,62.190677642822266,2023-02-16,109,0,54.48063659667969,5938.389389038086,3,2,0,7,44725,3
100105,Groceries,62.190677642822266,2023-02-17,34,0,54.48063659667969,1852.3416442871094,4,2,0,7,44759,3
100105,Groceries,62.190677642822266,2023-02-18,79,0,54.48063659667969,4303.970291137695,5,2,1,7,44838,3
100105,Groceries,62.190677642822266,2023-02-19,48,0,54.48063659667969,2615.070556640625,6,2,1,7,44886,3
100105,Groceries,62.190677642822266,2023-02-20,58,0,54.48063659667969,3159.876922607422,0,2,0,8,44944,3
100105,Groceries,62.190677642822266,2023-02-21,57,224,49.45657287597656,13565.539307861327,1,2,0,8,45001,3
100105,Groceries,62.190677642822266,2023-02-22,32,0,51.443145751953125,1646.1806640625,2,2,0,8,45033,3
100105,Groceries,62.190677642822266,2023-02-23,26,0,51.443145751953125,1337.5217895507812,3,2,0,8,45059,3
100105,Groceries,62.190677642822266,2023-02-24,82,0,51.443145751953125,4218.337951660156,4,2,0,8,45141,3
100105,Groceries,62.190677642822266,2023-02-25,95,367,51.563467788696286,23832.258879852296,5,2,1,8,45236,3
100105,Groceries,62.190677642822266,2023-02-26,56,0,51.52693557739258,2885.5083923339844,6,2,1,8,45292,3
100105,Groceries,62.190677642822266,2023-02-27,83,0,51.52693557739258,4276.735652923584,0,2,0,9,45375,3
100105,Groceries,62.190677642822266,2023-02-28,84,0,51.52693557739258,4328.262588500977,1,2,0,9,45459,3
100105,Groceries,62.190677642822266,2023-03-01,150,672,55.848980560302735,46393.854168090824,2,3,0,9,45609,3
100105,Groceries,62.190677642822266,2023-03-02,140,0,54.91796112060547,7688.514556884766,3,3,0,9,45749,3
100105,Groceries,62.190677642822266,2023-03-03,79,798,63.275674438476564,57415.6065612793,4,3,0,9,45828,3
100105,Groceries,62.190677642822266,2023-03-05,161,0,60.601348876953125,9756.817169189453,6,3,1,9,45989,3
100105,Groceries,62.190677642822266,2023-03-06,79,0,60.601348876953125,4787.506561279297,0,3,0,10,46068,3
100105,Groceries,62.190677642822266,2023-03-07,73,0,60.601348876953125,4423.898468017578,1,3,0,10,46141,3
100105,Groceries,62.190677642822266,2023-03-08,133,0,60.601348876953125,8059.979400634766,2,3,0,10,46274,3
100105,Groceries,62.190677642822266,2023-03-09,40,0,60.601348876953125,2424.053955078125,3,3,0,10,46314,3
100105,Groceries,62.190677642822266,2023-03-10,153,0,60.601348876953125,9272.006378173828,4,3,0,10,46467,3
100105,Groceries,62.190677642822266,2023-03-11,99,0,60.601348876953125,5999.533538818359,5,3,1,10,46566,3
100105,Groceries,62.190677642822266,2023-03-12,114,0,60.601348876953125,6908.553771972656,6,3,1,10,46680,3
100105,Groceries,62.190677642822266,2023-03-13,122,0,60.601348876953125,7393.364562988281,0,3,0,11,46802,3
100105,Groceries,62.190677642822266,2023-03-14,58,0,60.601348876953125,3514.8782348632812,1,3,0,11,46860,3
100105,Groceries,62.190677642822266,2023-03-15,179,669,63.608395385742185,54303.3055480957,2,3,0,11,47039,3
100105,Groceries,62.190677642822266,2023-03-16,163,0,62.866790771484375,10247.286895751953,3,3,0,11,47202,3
100105,Groceries,62.190677642822266,2023-03-17,96,0,62.866790771484375,6035.2119140625,4,3,0,11,47298,3
100105,Groceries,62.190677642822266,2023-03-18,0,706,67.74,47824.439999999995,5,3,1,11,47298,3
100105,Groceries,62.190677642822266,2023-03-19,115,0,65.36896514892578,7517.430992126465,6,3,1,11,47413,3
100105,Groceries,62.190677642822266,2023-03-20,17,0,65.36896514892578,1111.2724075317383,0,3,0,12,47430,3
100105,Groceries,62.190677642822266,2023-03-21,67,0,65.36896514892578,4379.720664978027,1,3,0,12,47497,3
100105,Groceries,62.190677642822266,2023-03-22,82,0,65.36896514892578,5360.255142211914,2,3,0,12,47579,3
100105,Groceries,62.190677642822266,2023-03-23,77,0,65.36896514892578,5033.410316467285,3,3,0,12,47656,3
100105,Groceries,62.190677642822266,2023-03-24,99,0,65.36896514892578,6471.527549743652,4,3,0,12,47755,3
100105,Groceries,62.190677642822266,2023-03-25,143,0,65.36896514892578,9347.762016296387,5,3,1,12,47898,3
100105,Groceries,62.190677642822266,2023-03-26,60,0,65.36896514892578,3922.137908935547,6,3,1,12,47958,3
100105,Groceries,62.190677642822266,2023-03-27,66,0,65.36896514892578,4314.351699829102,0,3,0,13,48024,3
100105,Groceries,62.190677642822266,2023-03-28,126,676,67.5821746826172,54595.70802001953,1,3,0,13,48150,3
100105,Groceries,62.190677642822266,2023-03-29,101,0,66.86434936523438,6753.299285888672,2,3,0,13,48251,3
100105,Groceries,62.190677642822266,2023-03-30,85,0,66.86434936523438,5683.469696044922,3,3,0,13,48336,3
100105,Groceries,62.190677642822266,2023-03-31,100,0,66.86434936523438,6686.4349365234375,4,3,0,13,48436,3
100105,Groceries,62.190677642822266,2023-04-01,86,0,66.86434936523438,5750.334045410156,5,4,1,13,48522,3
100105,Groceries,62.190677642822266,2023-04-02,94,0,66.86434936523438,6285.248840332031,6,4,1,13,48616,3
100105,Groceries,62.190677642822266,2023-04-03,45,0,66.86434936523438,3008.895721435547,0,4,0,14,48661,3
100105,Groceries,62.190677642822266,2023-04-04,88,0,66.86434936523438,5884.062744140625,1,4,0,14,48749,3
100105,Groceries,62.190677642822266,2023-04-05,131,624,62.467536468505855,46459.214554748534,2,4,0,14,48880,3
100105,Groceries,62.190677642822266,2023-04-06,98,0,63.89507293701172,6261.717147827148,3,4,0,14,48978,3
100105,Groceries,62.190677642822266,2023-04-07,63,0,63.89507293701172,4025.3895950317383,4,4,0,14,49041,3
100105,Groceries,62.190677642822266,2023-04-08,72,0,63.89507293701172,4600.445251464844,5,4,1,14,49113,3
100105,Groceries,62.190677642822266,2023-04-09,40,0,63.89507293701172,2555.8029174804688,6,4,1,14,49153,3
100105,Groceries,62.190677642822266,2023-04-10,44,0,63.89507293701172,2811.3832092285156,0,4,0,15,49197,3
100105,Groceries,62.190677642822266,2023-04-11,47,0,63.89507293701172,3003.068428039551,1,4,0,15,49244,3
100105,Groceries,62.190677642822266,2023-04-12,72,0,63.89507293701172,4600.445251464844,2,4,0,15,49316,3
100105,Groceries,62.190677642822266,2023-04-13,74,0,63.89507293701172,4728.235397338867,3,4,0,15,49390,3
100105,Groceries,62.190677642822266,2023-04-14,88,0,63.89507293701172,5622.766418457031,4,4,0,15,49478,3
100105,Groceries,62.190677642822266,2023-04-15,93,0,63.89507293701172,5942.24178314209,5,4,1,15,49571,3
100105,Groceries,62.190677642822266,2023-04-16,81,313,59.08211097717285,22841.701978302004,6,4,1,15,49652,3
100105,Groceries,62.190677642822266,2023-04-17,97,0,60.9642219543457,5913.529529571533,0,4,0,16,49749,3
100105,Groceries,62.190677642822266,2023-04-18,42,0,60.9642219543457,2560.4973220825195,1,4,0,16,49791,3
100105,Groceries,62.190677642822266,2023-04-19,98,363,50.124487152099604,21942.84948181152,2,4,0,16,49889,3
100105,Groceries,62.190677642822266,2023-04-20,69,0,54.51897430419922,3761.809226989746,3,4,0,16,49958,3
100105,Groceries,62.190677642822266,2023-04-21,28,0,54.51897430419922,1526.5312805175781,4,4,0,16,49986,3
100105,Groceries,62.190677642822266,2023-04-22,37,0,54.51897430419922,2017.202049255371,5,4,1,16,50023,3
100105,Groceries,62.190677642822266,2023-04-23,140,612,56.82103233337402,43097.08905334473,6,4,1,16,50163,3
100105,Groceries,62.190677642822266,2023-04-24,129,0,56.04206466674805,7229.426342010498,0,4,0,17,50292,3
100105,Groceries,62.190677642822266,2023-04-25,86,0,56.04206466674805,4819.617561340332,1,4,0,17,50378,3
100105,Groceries,62.190677642822266,2023-04-26,77,0,56.04206466674805,4315.2389793396,2,4,0,17,50455,3
100105,Groceries,62.190677642822266,2023-04-27,72,0,56.04206466674805,4035.0286560058594,3,4,0,17,50527,3
100105,Groceries,62.190677642822266,2023-04-28,91,0,56.04206466674805,5099.827884674072,4,4,0,17,50618,3
100105,Groceries,62.190677642822266,2023-04-29,93,0,56.04206466674805,5211.912014007568,5,4,1,17,50711,3
100105,Groceries,62.190677642822266,2023-04-30,105,675,67.85148406982421,54872.711654663086,6,4,1,17,50816,3
100105,Groceries,62.190677642822266,2023-05-01,79,0,64.43296813964844,5090.204483032227,0,5,0,18,50895,3
100105,Groceries,62.190677642822266,2023-05-02,105,0,64.43296813964844,6765.461654663086,1,5,0,18,51000,3
100105,Groceries,62.190677642822266,2023-05-03,43,0,64.43296813964844,2770.617630004883,2,5,0,18,51043,3
100105,Groceries,62.190677642822266,2023-05-04,69,0,64.43296813964844,4445.874801635742,3,5,0,18,51112,3
100105,Groceries,62.190677642822266,2023-05-05,62,0,64.43296813964844,3994.844024658203,4,5,0,18,51174,3
100105,Groceries,62.190677642822266,2023-05-06,127,0,64.43296813964844,8182.986953735352,5,5,1,18,51301,3
100105,Groceries,62.190677642822266,2023-05-07,105,0,64.43296813964844,6765.461654663086,6,5,1,18,51406,3
100105,Groceries,62.190677642822266,2023-05-08,120,0,64.43296813964844,7731.9561767578125,0,5,0,19,51526,3
100105,Groceries,62.190677642822266,2023-05-09,33,0,64.43296813964844,2126.2879486083984,1,5,0,19,51559,3
100105,Groceries,62.190677642822266,2023-05-10,145,431,61.80855262756347,35373.340261993406,2,5,0,19,51704,3
100105,Groceries,62.190677642822266,2023-05-11,94,654,59.399101409912106,43826.231065063475,3,5,0,19,51798,3
100105,Groceries,62.190677642822266,2023-05-12,58,0,60.47820281982422,3507.7357635498047,4,5,0,19,51856,3
100105,Groceries,62.190677642822266,2023-05-13,78,0,60.47820281982422,4717.299819946289,5,5,1,19,51934,3
100105,Groceries,62.190677642822266,2023-05-14,72,0,60.47820281982422,4354.430603027344,6,5,1,19,52006,3
100105,Groceries,62.190677642822266,2023-05-15,183,0,60.47820281982422,11067.511116027832,0,5,0,20,52189,3
100105,Groceries,62.190677642822266,2023-05-16,134,0,60.47820281982422,8104.079177856445,1,5,0,20,52323,3
100105,Groceries,62.190677642822266,2023-05-17,153,0,60.47820281982422,9253.165031433105,2,5,0,20,52476,3
100105,Groceries,62.190677642822266,2023-05-18,138,583,62.62589958190918,45457.69828460694,3,5,0,20,52614,3
100105,Groceries,62.190677642822266,2023-05-19,170,0,61.94179916381836,10530.105857849121,4,5,0,20,52784,3
100105,Groceries,62.190677642822266,2023-05-20,55,0,61.94179916381836,3406.7989540100098,5,5,1,20,52839,3
100105,Groceries,62.190677642822266,2023-05-21,146,0,61.94179916381836,9043.50267791748,6,5,1,20,52985,3
100105,Groceries,62.190677642822266,2023-05-22,82,0,61.94179916381836,5079.2275314331055,0,5,0,21,53067,3
100105,Groceries,62.190677642822266,2023-05-23,106,0,61.94179916381836,6565.830711364746,1,5,0,21,53173,3
100105,Groceries,62.190677642822266,2023-05-24,218,707,73.39458099365234,69198.26731323241,2,5,0,21,53391,3
100105,Groceries,62.190677642822266,2023-05-25,55,0,70.71916198730469,3889.553909301758,3,5,0,21,53446,3
100105,Groceries,62.190677642822266,2023-05-26,128,0,70.71916198730469,9052.052734375,4,5,0,21,53574,3
100105,Groceries,62.190677642822266,2023-05-27,30,0,70.71916198730469,2121.5748596191406,5,5,1,21,53604,3
100105,Groceries,62.190677642822266,2023-05-28,137,609,65.62934768676757,48077.16126617431,6,5,1,21,53741,3
100105,Groceries,62.190677642822266,2023-05-29,101,0,67.49869537353516,6817.368232727051,0,5,0,22,53842,3
100105,Groceries,62.190677642822266,2023-05-30,58,0,67.49869537353516,3914.924331665039,1,5,0,22,53900,3
100105,Groceries,62.190677642822266,2023-05-31,85,0,67.49869537353516,5737.389106750488,2,5,0,22,53985,3
100105,Groceries,62.190677642822266,2023-06-01,140,0,67.49869537353516,9449.817352294922,3,6,0,22,54125,3
100105,Groceries,62.190677642822266,2023-06-02,142,0,67.49869537353516,9584.814743041992,4,6,0,22,54267,3
100105,Groceries,62.190677642822266,2023-06-03,89,0,67.49869537353516,6007.383888244629,5,6,1,22,54356,3
100105,Groceries,62.190677642822266,2023-06-04,196,751,72.77862487792969,69721.32095214844,6,6,1,22,54552,3
100105,Groceries,62.190677642822266,2023-06-05,109,0,71.33724975585938,7775.760223388672,0,6,0,23,54661,3
100105,Groceries,62.190677642822266,2023-06-06,246,0,71.33724975585938,17548.963439941406,1,6,0,23,54907,3
100105,Groceries,62.190677642822266,2023-06-07,13,0,71.33724975585938,927.3842468261719,2,6,0,23,54920,3
100105,Groceries,62.190677642822266,2023-06-08,113,0,71.33724975585938,8061.109222412109,3,6,0,23,55033,3
100105,Groceries,62.190677642822266,2023-06-09,176,574,69.89515060424804,52216.33301269531,4,6,0,23,55209,3
100105,Groceries,62.190677642822266,2023-06-10,88,0,70.4103012084961,6196.106506347656,5,6,1,23,55297,3
100105,Groceries,62.190677642822266,2023-06-11,179,765,72.34127334594726,68723.05585784912,6,6,1,23,55476,3
100105,Groceries,62.190677642822266,2023-06-12,195,0,71.60254669189453,13962.496604919434,0,6,0,24,55671,3
100105,Groceries,62.190677642822266,2023-06-13,184,0,71.60254669189453,13174.868591308594,1,6,0,24,55855,3
100105,Groceries,62.190677642822266,2023-06-14,109,0,71.60254669189453,7804.677589416504,2,6,0,24,55964,3
100105,Groceries,62.190677642822266,2023-06-15,76,0,71.60254669189453,5441.793548583984,3,6,0,24,56040,3
100105,Groceries,62.190677642822266,2023-06-16,115,0,71.60254669189453,8234.292869567871,4,6,0,24,56155,3
100105,Groceries,62.190677642822266,2023-06-17,93,0,71.60254669189453,6659.036842346191,5,6,1,24,56248,3
100105,Groceries,62.190677642822266,2023-06-18,187,751,71.36870529174806,66899.45577911378,6,6,1,24,56435,3
100105,Groceries,62.190677642822266,2023-06-19,108,0,71.4474105834961,7716.320343017578,0,6,0,25,56543,3
100105,Groceries,62.190677642822266,2023-06-20,180,0,71.4474105834961,12860.533905029297,1,6,0,25,56723,3
100105,Groceries,62.190677642822266,2023-06-21,116,0,71.4474105834961,8287.899627685547,2,6,0,25,56839,3
100105,Groceries,62.190677642822266,2023-06-22,177,0,71.4474105834961,12646.191673278809,3,6,0,25,57016,3
100105,Groceries,62.190677642822266,2023-06-23,78,0,71.4474105834961,5572.898025512695,4,6,0,25,57094,3
100105,Groceries,62.190677642822266,2023-06-24,124,0,71.4474105834961,8859.478912353516,5,6,1,25,57218,3
100105,Groceries,62.190677642822266,2023-06-25,141,554,68.0931788635254,46869.14643951416,6,6,1,25,57359,3
100105,Groceries,62.190677642822266,2023-06-26,94,0,69.19635772705078,6504.457626342773,0,6,0,26,57453,3
100105,Groceries,62.190677642822266,2023-06-27,99,0,69.19635772705078,6850.439414978027,1,6,0,26,57552,3
100105,Groceries,62.190677642822266,2023-06-28,98,0,69.19635772705078,6781.243057250977,2,6,0,26,57650,3
100105,Groceries,62.190677642822266,2023-06-29,144,565,71.30047897338866,50880.217944335935,3,6,0,26,57794,3
100105,Groceries,62.190677642822266,2023-06-30,196,0,70.52095794677734,13822.10775756836,4,6,0,26,57990,3
100105,Groceries,62.190677642822266,2023-07-01,63,0,70.52095794677734,4442.820350646973,5,7,1,26,58053,3
100105,Groceries,62.190677642822266,2023-07-02,177,0,70.52095794677734,12482.20955657959,6,7,1,26,58230,3
100105,Groceries,62.190677642822266,2023-07-03,155,477,72.14277877807618,45805.86142120361,0,7,0,27,58385,3
100105,Groceries,62.190677642822266,2023-07-04,90,0,71.48555755615234,6433.700180053711,1,7,0,27,58475,3
100105,Groceries,62.190677642822266,2023-07-05,72,0,71.48555755615234,5146.960144042969,2,7,0,27,58547,3
100105,Groceries,62.190677642822266,2023-07-06,137,0,71.48555755615234,9793.521385192871,3,7,0,27,58684,3
100105,Groceries,62.190677642822266,2023-07-07,121,888,68.00615921020508,67884.84052886962,4,7,0,27,58805,3
100105,Groceries,62.190677642822266,2023-07-08,164,0,68.96231842041016,11309.820220947266,5,7,1,27,58969,3
100105,Groceries,62.190677642822266,2023-07-09,123,0,68.96231842041016,8482.36516571045,6,7,1,27,59092,3
100105,Groceries,62.190677642822266,2023-07-10,137,0,68.96231842041016,9447.837623596191,0,7,0,28,59229,3
100105,Groceries,62.190677642822266,2023-07-11,189,0,68.96231842041016,13033.87818145752,1,7,0,28,59418,3
100105,Groceries,62.190677642822266,2023-07-12,93,0,68.96231842041016,6413.4956130981445,2,7,0,28,59511,3
100105,Groceries,62.190677642822266,2023-07-13,160,782,75.9485433959961,72931.49388671876,3,7,0,28,59671,3
100105,Groceries,62.190677642822266,2023-07-14,145,0,73.71708679199219,10688.977584838867,4,7,0,28,59816,3
100105,Groceries,62.190677642822266,2023-07-15,86,0,73.71708679199219,6339.669464111328,5,7,1,28,59902,3
100105,Groceries,62.190677642822266,2023-07-16,89,0,73.71708679199219,6560.820724487305,6,7,1,28,59991,3
100105,Groceries,62.190677642822266,2023-07-17,195,0,73.71708679199219,14374.831924438477,0,7,0,29,60186,3
100105,Groceries,62.190677642822266,2023-07-18,158,0,73.71708679199219,11647.299713134766,1,7,0,29,60344,3
100105,Groceries,62.190677642822266,2023-07-19,114,0,73.71708679199219,8403.74789428711,2,7,0,29,60458,3
100105,Groceries,62.190677642822266,2023-07-20,100,0,73.71708679199219,7371.708679199219,3,7,0,29,60558,3
100105,Groceries,62.190677642822266,2023-07-21,135,476,64.78727523803711,38580.004314270016,4,7,0,29,60693,3
100105,Groceries,62.190677642822266,2023-07-22,135,912,65.97965881347656,68661.38787963867,5,7,1,29,60828,3
100105,Groceries,62.190677642822266,2023-07-23,199,0,66.51931762695312,13237.344207763672,6,7,1,29,61027,3
100105,Groceries,62.190677642822266,2023-07-25,86,0,66.51931762695312,5720.661315917969,1,7,0,30,61113,3
100105,Groceries,62.190677642822266,2023-07-26,234,0,66.51931762695312,15565.520324707031,2,7,0,30,61347,3
100105,Groceries,62.190677642822266,2023-07-27,72,0,66.51931762695312,4789.390869140625,3,7,0,30,61419,3
100105,Groceries,62.190677642822266,2023-07-28,159,0,66.51931762695312,10576.571502685547,4,7,0,30,61578,3
100105,Groceries,62.190677642822266,2023-07-29,41,0,66.51931762695312,2727.292022705078,5,7,1,30,61619,3
100105,Groceries,62.190677642822266,2023-07-30,116,0,66.51931762695312,7716.2408447265625,6,7,1,30,61735,3
100105,Groceries,62.190677642822266,2023-07-31,74,0,66.51931762695312,4922.429504394531,0,7,0,31,61809,3
100105,Groceries,62.190677642822266,2023-08-01,155,1001,75.92457550048829,89617.67840515137,1,8,0,31,61964,3
100105,Groceries,62.190677642822266,2023-08-02,40,0,73.73915100097656,2949.5660400390625,2,8,0,31,62004,3
100105,Groceries,62.190677642822266,2023-08-03,127,0,73.73915100097656,9364.872177124023,3,8,0,31,62131,3
100105,Groceries,62.190677642822266,2023-08-04,30,0,73.73915100097656,2212.174530029297,4,8,0,31,62161,3
100105,Groceries,62.190677642822266,2023-08-05,115,0,73.73915100097656,8480.002365112305,5,8,1,31,62276,3
100105,Groceries,62.190677642822266,2023-08-06,105,0,73.73915100097656,7742.610855102539,6,8,1,31,62381,3
100105,Groceries,62.190677642822266,2023-08-07,124,0,73.73915100097656,9143.654724121094,0,8,0,32,62505,3
100105,Groceries,62.190677642822266,2023-08-08,162,0,73.73915100097656,11945.742462158203,1,8,0,32,62667,3
100105,Groceries,62.190677642822266,2023-08-09,151,0,73.73915100097656,11134.611801147461,2,8,0,32,62818,3
100105,Groceries,62.190677642822266,2023-08-10,77,0,73.73915100097656,5677.914627075195,3,8,0,32,62895,3
100105,Groceries,62.190677642822266,2023-08-11,211,708,71.47814804077149,65386.16847320557,4,8,0,32,63106,3
100105,Groceries,62.190677642822266,2023-08-12,111,0,72.08629608154297,8001.5788650512695,5,8,1,32,63217,3
100105,Groceries,62.190677642822266,2023-08-13,141,0,72.08629608154297,10164.167747497559,6,8,1,32,63358,3
100105,Groceries,62.190677642822266,2023-08-14,40,0,72.08629608154297,2883.4518432617188,0,8,0,33,63398,3
100105,Groceries,62.190677642822266,2023-08-15,123,0,72.08629608154297,8866.614418029785,1,8,0,33,63521,3
100105,Groceries,62.190677642822266,2023-08-16,123,521,69.67419387817384,44518.271694030766,2,8,0,33,63644,3
100105,Groceries,62.190677642822266,2023-08-17,15,0,70.55838775634766,1058.3758163452148,3,8,0,33,63659,3
100105,Groceries,62.190677642822266,2023-08-18,59,0,70.55838775634766,4162.944877624512,4,8,0,33,63718,3
100105,Groceries,62.190677642822266,2023-08-19,146,0,70.55838775634766,10301.524612426758,5,8,1,33,63864,3
100105,Groceries,62.190677642822266,2023-08-20,96,0,70.55838775634766,6773.605224609375,6,8,1,33,63960,3
100105,Groceries,62.190677642822266,2023-08-21,142,0,70.55838775634766,10019.291061401367,0,8,0,34,64102,3
100105,Groceries,62.190677642822266,2023-08-22,129,0,70.55838775634766,9102.032020568848,1,8,0,34,64231,3
100105,Groceries,62.190677642822266,2023-08-23,55,0,70.55838775634766,3880.711326599121,2,8,0,34,64286,3
100105,Groceries,62.190677642822266,2023-08-24,100,597,65.38573715209961,44979.57743041992,3,8,0,34,64386,3
100105,Groceries,62.190677642822266,2023-08-25,134,0,66.58147430419922,8921.917556762695,4,8,0,34,64520,3
100105,Groceries,62.190677642822266,2023-08-26,125,930,69.58119293212891,74083.39823303223,5,8,1,34,64645,3
100105,Groceries,62.190677642822266,2023-08-28,118,0,68.74238586425781,8111.601531982422,0,8,0,35,64763,3
100105,Groceries,62.190677642822266,2023-08-29,151,0,68.74238586425781,10380.10026550293,1,8,0,35,64914,3
100105,Groceries,62.190677642822266,2023-08-30,88,0,68.74238586425781,6049.3299560546875,2,8,0,35,65002,3
100105,Groceries,62.190677642822266,2023-08-31,162,0,68.74238586425781,11136.266510009766,3,8,0,35,65164,3
100105,Groceries,62.190677642822266,2023-09-01,35,0,68.74238586425781,2405.9835052490234,4,9,0,35,65199,3
100105,Groceries,62.190677642822266,2023-09-02,86,0,68.74238586425781,5911.845184326172,5,9,1,35,65285,3
100105,Groceries,62.190677642822266,2023-09-03,194,1128,72.36706573486327,96624.68150512695,6,9,1,35,65479,3
100105,Groceries,62.190677642822266,2023-09-04,21,0,71.34413146972656,1498.2267608642578,0,9,0,36,65500,3
100105,Groceries,62.190677642822266,2023-09-05,63,0,71.34413146972656,4494.680282592773,1,9,0,36,65563,3
100105,Groceries,62.190677642822266,2023-09-06,86,0,71.34413146972656,6135.595306396484,2,9,0,36,65649,3
100105,Groceries,62.190677642822266,2023-09-07,92,0,71.34413146972656,6563.660095214844,3,9,0,36,65741,3
100105,Groceries,62.190677642822266,2023-09-08,77,0,71.34413146972656,5493.498123168945,4,9,0,36,65818,3
100105,Groceries,62.190677642822266,2023-09-09,76,0,71.34413146972656,5422.153991699219,5,9,1,36,65894,3
100105,Groceries,62.190677642822266,2023-09-10,81,0,71.34413146972656,5778.874649047852,6,9,1,36,65975,3
100105,Groceries,62.190677642822266,2023-09-11,130,0,71.34413146972656,9274.737091064453,0,9,0,37,66105,3
100105,Groceries,62.190677642822266,2023-09-12,98,0,71.34413146972656,6991.724884033203,1,9,0,37,66203,3
100105,Groceries,62.190677642822266,2023-09-13,119,0,71.34413146972656,8489.951644897461,2,9,0,37,66322,3
100105,Groceries,62.190677642822266,2023-09-14,100,0,71.34413146972656,7134.413146972656,3,9,0,37,66422,3
100105,Groceries,62.190677642822266,2023-09-15,139,0,71.34413146972656,9916.834274291992,4,9,0,37,66561,3
100105,Groceries,62.190677642822266,2023-09-16,112,0,71.34413146972656,7990.542724609375,5,9,1,37,66673,3
100105,Groceries,62.190677642822266,2023-09-17,193,665,69.0462239074707,58894.16242828369,6,9,1,37,66866,3
100105,Groceries,62.190677642822266,2023-09-18,61,0,69.7824478149414,4256.729316711426,0,9,0,38,66927,3
100105,Groceries,62.190677642822266,2023-09-19,79,0,69.7824478149414,5512.813377380371,1,9,0,38,67006,3
100105,Groceries,62.190677642822266,2023-09-20,79,0,69.7824478149414,5512.813377380371,2,9,0,38,67085,3
100105,Groceries,62.190677642822266,2023-09-21,117,0,69.7824478149414,8164.5463943481445,3,9,0,38,67202,3
100105,Groceries,62.190677642822266,2023-09-22,157,0,69.7824478149414,10955.8443069458,4,9,0,38,67359,3
100105,Groceries,62.190677642822266,2023-09-23,131,542,61.89005401611328,40488.854152221684,5,9,1,38,67490,3
100105,Groceries,62.190677642822266,2023-09-24,126,0,64.72010803222656,8154.733612060547,6,9,1,38,67616,3
100105,Groceries,62.190677642822266,2023-09-25,149,0,64.72010803222656,9643.296096801758,0,9,0,39,67765,3
100105,Groceries,62.190677642822266,2023-09-26,111,0,64.72010803222656,7183.931991577148,1,9,0,39,67876,3
100105,Groceries,62.190677642822266,2023-09-27,190,668,69.13403930664063,59993.83493652344,2,9,0,39,68066,3
100105,Groceries,62.190677642822266,2023-09-28,96,0,67.71807861328125,6500.935546875,3,9,0,39,68162,3
100105,Groceries,62.190677642822266,2023-09-29,131,0,67.71807861328125,8871.068298339844,4,9,0,39,68293,3
100105,Groceries,62.190677642822266,2023-09-30,50,0,67.71807861328125,3385.9039306640625,5,9,1,39,68343,3
100105,Groceries,62.190677642822266,2023-10-01,80,0,67.71807861328125,5417.4462890625,6,10,1,39,68423,3
100105,Groceries,62.190677642822266,2023-10-02,146,0,67.71807861328125,9886.839477539062,0,10,0,40,68569,3
100105,Groceries,62.190677642822266,2023-10-03,87,0,67.71807861328125,5891.472839355469,1,10,0,40,68656,3
100105,Groceries,62.190677642822266,2023-10-04,109,473,63.687792663574214,36546.578800659176,2,10,0,40,68765,3
100105,Groceries,62.190677642822266,2023-10-05,154,0,65.11558532714844,10027.80014038086,3,10,0,40,68919,3
100105,Groceries,62.190677642822266,2023-10-06,93,0,65.11558532714844,6055.749435424805,4,10,0,40,69012,3
100105,Groceries,62.190677642822266,2023-10-07,47,0,65.11558532714844,3060.4325103759766,5,10,1,40,69059,3
100105,Groceries,62.190677642822266,2023-10-08,43,0,65.11558532714844,2799.970169067383,6,10,1,40,69102,3
100105,Groceries,62.190677642822266,2023-10-09,70,0,65.11558532714844,4558.090972900391,0,10,0,41,69172,3
100105,Groceries,62.190677642822266,2023-10-10,48,0,65.11558532714844,3125.548095703125,1,10,0,41,69220,3
100105,Groceries,62.190677642822266,2023-10-11,42,0,65.11558532714844,2734.8545837402344,2,10,0,41,69262,3
100105,Groceries,62.190677642822266,2023-10-12,68,329,56.78140983581543,21737.971737670898,3,10,0,41,69330,3
100105,Groceries,62.190677642822266,2023-10-13,67,0,59.86281967163086,4010.8089179992676,4,10,0,41,69397,3
100105,Groceries,62.190677642822266,2023-10-14,92,641,54.241120452880864,38797.37616333008,5,10,1,41,69489,3
100105,Groceries,62.190677642822266,2023-10-15,42,0,55.99224090576172,2351.674118041992,6,10,1,41,69531,3
100105,Groceries,62.190677642822266,2023-10-16,83,0,55.99224090576172,4647.355995178223,0,10,0,42,69614,3
100105,Groceries,62.190677642822266,2023-10-17,40,0,55.99224090576172,2239.6896362304688,1,10,0,42,69654,3
100105,Groceries,62.190677642822266,2023-10-18,29,0,55.99224090576172,1623.7749862670898,2,10,0,42,69683,3
100105,Groceries,62.190677642822266,2023-10-19,81,0,55.99224090576172,4535.371513366699,3,10,0,42,69764,3
100105,Groceries,62.190677642822266,2023-10-20,60,0,55.99224090576172,3359.534454345703,4,10,0,42,69824,3
100105,Groceries,62.190677642822266,2023-10-21,85,0,55.99224090576172,4759.340476989746,5,10,1,42,69909,3
100105,Groceries,62.190677642822266,2023-10-22,88,0,55.99224090576172,4927.317199707031,6,10,1,42,69997,3
100105,Groceries,62.190677642822266,2023-10-23,80,0,55.99224090576172,4479.3792724609375,0,10,0,43,70077,3
100105,Groceries,62.190677642822266,2023-10-24,40,0,55.99224090576172,2239.6896362304688,1,10,0,43,70117,3
100105,Groceries,62.190677642822266,2023-10-25,98,0,55.99224090576172,5487.239608764648,2,10,0,43,70215,3
100105,Groceries,62.190677642822266,2023-10-26,90,350,55.668342971801756,24463.301734924316,3,10,0,43,70305,3
100105,Groceries,62.190677642822266,2023-10-27,106,799,63.374888229370114,58896.27630462646,4,10,0,43,70411,3
100105,Groceries,62.190677642822266,2023-10-28,134,0,61.149776458740234,8194.070045471191,5,10,1,43,70545,3
100105,Groceries,62.190677642822266,2023-10-29,73,0,61.149776458740234,4463.933681488037,6,10,1,43,70618,3
100105,Groceries,62.190677642822266,2023-10-30,107,0,61.149776458740234,6543.026081085205,0,10,0,44,70725,3
100105,Groceries,62.190677642822266,2023-10-31,103,0,61.149776458740234,6298.426975250244,1,10,0,44,70828,3
100105,Groceries,62.190677642822266,2023-11-01,142,0,61.149776458740234,8683.268257141113,2,11,0,44,70970,3
100105,Groceries,62.190677642822266,2023-11-02,97,0,61.149776458740234,5931.528316497803,3,11,0,44,71067,3
100105,Groceries,62.190677642822266,2023-11-03,122,825,66.52798217773437,64128.21765136718,4,11,0,44,71189,3
100105,Groceries,62.190677642822266,2023-11-04,60,0,64.92596435546875,3895.557861328125,5,11,1,44,71249,3
100105,Groceries,62.190677642822266,2023-11-05,137,0,64.92596435546875,8894.857116699219,6,11,1,44,71386,3
100105,Groceries,62.190677642822266,2023-11-06,93,0,64.92596435546875,6038.114685058594,0,11,0,45,71479,3
100105,Groceries,62.190677642822266,2023-11-07,90,0,64.92596435546875,5843.3367919921875,1,11,0,45,71569,3
100105,Groceries,62.190677642822266,2023-11-08,155,0,64.92596435546875,10063.524475097656,2,11,0,45,71724,3
100105,Groceries,62.190677642822266,2023-11-09,76,0,64.92596435546875,4934.373291015625,3,11,0,45,71800,3
100105,Groceries,62.190677642822266,2023-11-10,98,0,64.92596435546875,6362.7445068359375,4,11,0,45,71898,3
100105,Groceries,62.190677642822266,2023-11-11,102,0,64.92596435546875,6622.4483642578125,5,11,1,45,72000,3
100105,Groceries,62.190677642822266,2023-11-12,113,443,66.0141387939453,36847.69536743165,6,11,1,45,72113,3
100105,Groceries,62.190677642822266,2023-11-13,182,0,65.57827758789062,11935.246520996094,0,11,0,46,72295,3
100105,Groceries,62.190677642822266,2023-11-14,114,812,61.57358375549316,56142.137096252445,1,11,0,46,72409,3
100105,Groceries,62.190677642822266,2023-11-15,76,0,62.82716751098633,4774.864730834961,2,11,0,46,72485,3
100105,Groceries,62.190677642822266,2023-11-16,132,0,62.82716751098633,8293.186111450195,3,11,0,46,72617,3
100105,Groceries,62.190677642822266,2023-11-17,49,0,62.82716751098633,3078.53120803833,4,11,0,46,72666,3
100105,Groceries,62.190677642822266,2023-11-18,37,0,62.82716751098633,2324.605197906494,5,11,1,46,72703,3
100105,Groceries,62.190677642822266,2023-11-19,182,0,62.82716751098633,11434.544486999512,6,11,1,46,72885,3
100105,Groceries,62.190677642822266,2023-11-20,165,0,62.82716751098633,10366.482639312744,0,11,0,47,73050,3
100105,Groceries,62.190677642822266,2023-11-21,120,0,62.82716751098633,7539.260101318359,1,11,0,47,73170,3
100105,Groceries,62.190677642822266,2023-11-22,147,736,75.9620979309082,69511.75679168702,2,11,0,47,73317,3
100105,Groceries,62.190677642822266,2023-11-23,117,0,71.8241958618164,8403.43091583252,3,11,0,47,73434,3
100105,Groceries,62.190677642822266,2023-11-24,54,0,71.8241958618164,3878.506576538086,4,11,0,47,73488,3
100105,Groceries,62.190677642822266,2023-11-25,193,0,71.8241958618164,13862.069801330566,5,11,1,47,73681,3
100105,Groceries,62.190677642822266,2023-11-26,72,0,71.8241958618164,5171.342102050781,6,11,1,47,73753,3
100105,Groceries,62.190677642822266,2023-11-27,136,0,71.8241958618164,9768.090637207031,0,11,0,48,73889,3
100105,Groceries,62.190677642822266,2023-11-28,82,0,71.8241958618164,5889.584060668945,1,11,0,48,73971,3
100105,Groceries,62.190677642822266,2023-11-29,65,0,71.8241958618164,4668.572731018066,2,11,0,48,74036,3
100105,Groceries,62.190677642822266,2023-11-30,94,492,72.13054382324219,42312.062238769526,3,11,0,48,74130,3
100105,Groceries,62.190677642822266,2023-12-01,147,0,72.02108764648438,10587.099884033203,4,12,0,48,74277,3
100105,Groceries,62.190677642822266,2023-12-02,133,0,72.02108764648438,9578.804656982422,5,12,1,48,74410,3
100105,Groceries,62.190677642822266,2023-12-03,74,0,72.02108764648438,5329.560485839844,6,12,1,48,74484,3
100105,Groceries,62.190677642822266,2023-12-04,89,0,72.02108764648438,6409.876800537109,0,12,0,49,74573,3
100105,Groceries,62.190677642822266,2023-12-05,121,604,54.52598793029785,37050.65907913208,1,12,0,49,74694,3
100105,Groceries,62.190677642822266,2023-12-06,105,0,59.6619758605957,6264.507465362549,2,12,0,49,74799,3
100105,Groceries,62.190677642822266,2023-12-07,92,0,59.6619758605957,5488.901779174805,3,12,0,49,74891,3
100105,Groceries,62.190677642822266,2023-12-08,115,0,59.6619758605957,6861.127223968506,4,12,0,49,75006,3
100105,Groceries,62.190677642822266,2023-12-09,58,0,59.6619758605957,3460.394599914551,5,12,1,49,75064,3
100105,Groceries,62.190677642822266,2023-12-10,105,0,59.6619758605957,6264.507465362549,6,12,1,49,75169,3
100105,Groceries,62.190677642822266,2023-12-11,78,0,59.6619758605957,4653.634117126465,0,12,0,50,75247,3
100105,Groceries,62.190677642822266,2023-12-12,124,905,62.502645874023436,64742.70617675781,1,12,0,50,75371,3
100105,Groceries,62.190677642822266,2023-12-13,51,0,61.955291748046875,3159.7198791503906,2,12,0,50,75422,3
100105,Groceries,62.190677642822266,2023-12-14,187,0,61.955291748046875,11585.639556884766,3,12,0,50,75609,3
100105,Groceries,62.190677642822266,2023-12-15,70,0,61.955291748046875,4336.870422363281,4,12,0,50,75679,3
100105,Groceries,62.190677642822266,2023-12-16,114,0,61.955291748046875,7062.903259277344,5,12,1,50,75793,3
100105,Groceries,62.190677642822266,2023-12-17,132,0,61.955291748046875,8178.0985107421875,6,12,1,50,75925,3
100105,Groceries,62.190677642822266,2023-12-18,91,0,61.955291748046875,5637.931549072266,0,12,0,51,76016,3
100105,Groceries,62.190677642822266,2023-12-19,146,670,63.29205390930176,51854.83974151611,1,12,0,51,76162,3
100105,Groceries,62.190677642822266,2023-12-20,65,0,62.894107818603516,4088.1170082092285,2,12,0,51,76227,3
100105,Groceries,62.190677642822266,2023-12-21,62,0,62.894107818603516,3899.434684753418,3,12,0,51,76289,3
100105,Groceries,62.190677642822266,2023-12-22,140,0,62.894107818603516,8805.175094604492,4,12,0,51,76429,3
100105,Groceries,62.190677642822266,2023-12-23,46,0,62.894107818603516,2893.1289596557617,5,12,1,51,76475,3
100105,Groceries,62.190677642822266,2023-12-24,118,0,62.894107818603516,7421.504722595215,6,12,1,51,76593,3
100105,Groceries,62.190677642822266,2023-12-25,57,0,62.894107818603516,3584.9641456604004,0,12,0,52,76650,3
100105,Groceries,62.190677642822266,2023-12-26,100,610,62.32759506225586,44156.91901245117,1,12,0,52,76750,3
100105,Groceries,62.190677642822266,2023-12-27,68,0,62.51519012451172,4251.032928466797,2,12,0,52,76818,3
100105,Groceries,62.190677642822266,2023-12-28,71,0,62.51519012451172,4438.578498840332,3,12,0,52,76889,3
100105,Groceries,62.190677642822266,2023-12-29,59,0,62.51519012451172,3688.3962173461914,4,12,0,52,76948,3
100105,Groceries,62.190677642822266,2023-12-30,77,0,62.51519012451172,4813.669639587402,5,12,1,52,77025,3
100105,Groceries,62.190677642822266,2023-12-31,40,0,62.51519012451172,2500.6076049804688,6,12,1,52,77065,3
100105,Groceries,62.190677642822266,2024-01-01,45,0,62.51519012451172,2813.1835556030273,0,1,0,1,77110,3
100105,Groceries,62.190677642822266,2024-01-02,131,0,62.51519012451172,8189.489906311035,1,1,0,1,77241,3
100105,Groceries,62.190677642822266,2024-01-03,65,0,62.51519012451172,4063.4873580932617,2,1,0,1,77306,3
100105,Groceries,62.190677642822266,2024-01-04,45,0,62.51519012451172,2813.1835556030273,3,1,0,1,77351,3
100105,Groceries,62.190677642822266,2024-01-05,90,0,62.51519012451172,5626.367111206055,4,1,0,1,77441,3
100105,Groceries,62.190677642822266,2024-01-06,174,576,64.41875633239746,48519.587203674324,5,1,1,1,77615,3
100105,Groceries,62.190677642822266,2024-01-07,44,0,63.90751266479492,2811.9305572509766,6,1,1,1,77659,3
100105,Groceries,62.190677642822266,2024-01-08,70,0,63.90751266479492,4473.5258865356445,0,1,0,2,77729,3
100105,Groceries,62.190677642822266,2024-01-09,135,0,63.90751266479492,8627.514209747314,1,1,0,2,77864,3
100105,Groceries,62.190677642822266,2024-01-10,148,573,60.84454551696777,43433.48547302246,2,1,0,2,78012,3
100105,Groceries,62.190677642822266,2024-01-11,77,0,61.86909103393555,4763.920009613037,3,1,0,2,78089,3
100105,Groceries,62.190677642822266,2024-01-12,60,0,61.86909103393555,3712.145462036133,4,1,0,2,78149,3
100105,Groceries,62.190677642822266,2024-01-13,109,0,61.86909103393555,6743.730922698975,5,1,1,2,78258,3
100105,Groceries,62.190677642822266,2024-01-14,117,0,61.86909103393555,7238.683650970459,6,1,1,2,78375,3
100105,Groceries,62.190677642822266,2024-01-15,48,0,61.86909103393555,2969.7163696289062,0,1,0,3,78423,3
100105,Groceries,62.190677642822266,2024-01-16,158,428,59.84562088012696,34846.616198120115,1,1,0,3,78581,3
100105,Groceries,62.190677642822266,2024-01-17,167,0,60.671241760253906,10132.097373962402,2,1,0,3,78748,3
100105,Groceries,62.190677642822266,2024-01-18,136,528,68.80656875610352,46951.14670166016,3,1,0,3,78884,3
100105,Groceries,62.190677642822266,2024-01-19,62,0,65.58313751220703,4066.154525756836,4,1,0,3,78946,3
100105,Groceries,62.190677642822266,2024-01-20,150,0,65.58313751220703,9837.470626831055,5,1,1,3,79096,3
100105,Groceries,62.190677642822266,2024-01-21,137,946,60.625338821411134,64390.88283706665,6,1,1,3,79233,3
100105,Groceries,62.190677642822266,2024-01-22,49,0,62.190677642822266,3047.343204498291,0,1,0,4,79282,3
100105,Groceries,62.190677642822266,2024-01-23,85,0,62.190677642822266,5286.207599639893,1,1,0,4,79367,3
100105,Groceries,62.190677642822266,2024-01-24,82,0,62.190677642822266,5099.635566711426,2,1,0,4,79449,3
100105,Groceries,62.190677642822266,2024-01-25,107,0,62.190677642822266,6654.402507781982,3,1,0,4,79556,3
100105,Groceries,62.190677642822266,2024-01-26,151,0,62.190677642822266,9390.792324066162,4,1,0,4,79707,3
100105,Groceries,62.190677642822266,2024-01-27,114,0,62.190677642822266,7089.737251281738,5,1,1,4,79821,3
100105,Groceries,62.190677642822266,2024-01-28,70,0,62.190677642822266,4353.347434997559,6,1,1,4,79891,3
100105,Groceries,62.190677642822266,2024-01-29,78,0,62.190677642822266,4850.872856140137,0,1,0,5,79969,3
100105,Groceries,62.190677642822266,2024-01-30,29,0,62.190677642822266,1803.5296516418457,1,1,0,5,79998,3
100106,Toys,38.871063232421875,2022-01-01,60,209,35.52999938964844,9557.569926757813,5,1,1,52,60,4
100106,Toys,38.871063232421875,2022-01-02,77,172,36.605077590942386,9145.531949005126,6,1,1,52,137,4
100106,Toys,38.871063232421875,2022-01-03,72,281,36.34912162780762,12835.603514404296,0,1,0,1,209,4
100106,Toys,38.871063232421875,2022-01-05,143,0,36.328243255615234,5194.9387855529785,2,1,0,1,352,4
100106,Toys,38.871063232421875,2022-01-06,130,440,42.834969177246094,24941.391986083985,3,1,0,1,482,4
100106,Toys,38.871063232421875,2022-01-07,85,0,41.13993835449219,3496.894760131836,4,1,0,1,567,4
100106,Toys,38.871063232421875,2022-01-08,90,0,41.13993835449219,3702.594451904297,5,1,1,1,657,4
100106,Toys,38.871063232421875,2022-01-09,113,0,41.13993835449219,4648.813034057617,6,1,1,1,770,4
100106,Toys,38.871063232421875,2022-01-10,51,0,41.13993835449219,2098.1368560791016,0,1,0,2,821,4
100106,Toys,38.871063232421875,2022-01-11,85,0,41.13993835449219,3496.894760131836,1,1,0,2,906,4
100106,Toys,38.871063232421875,2022-01-12,121,384,43.342231292724605,22005.589972839356,2,1,0,2,1027,4
100106,Toys,38.871063232421875,2022-01-13,62,0,42.89446258544922,2659.4566802978516,3,1,0,2,1089,4
100106,Toys,38.871063232421875,2022-01-14,13,0,42.89446258544922,557.6280136108398,4,1,0,2,1102,4
100106,Toys,38.871063232421875,2022-01-15,62,0,42.89446258544922,2659.4566802978516,5,1,1,2,1164,4
100106,Toys,38.871063232421875,2022-01-16,121,390,43.97443534851074,22555.823354339598,6,1,1,2,1285,4
100106,Toys,38.871063232421875,2022-01-17,97,0,43.658870697021484,4234.910457611084,0,1,0,3,1382,4
100106,Toys,38.871063232421875,2022-01-18,99,0,43.658870697021484,4322.228199005127,1,1,0,3,1481,4
100106,Toys,38.871063232421875,2022-01-19,187,513,42.66599304199219,29776.221397705078,2,1,0,3,1668,4
100106,Toys,38.871063232421875,2022-01-20,95,0,42.941986083984375,4079.4886779785156,3,1,0,3,1763,4
100106,Toys,38.871063232421875,2022-01-21,84,0,42.941986083984375,3607.1268310546875,4,1,0,3,1847,4
100106,Toys,38.871063232421875,2022-01-22,105,0,42.941986083984375,4508.908538818359,5,1,1,3,1952,4
100106,Toys,38.871063232421875,2022-01-23,139,475,46.111413650512695,28647.93299484253,6,1,1,3,2091,4
100106,Toys,38.871063232421875,2022-01-24,52,0,45.11282730102539,2345.8670196533203,0,1,0,4,2143,4
100106,Toys,38.871063232421875,2022-01-25,36,0,45.11282730102539,1624.061782836914,1,1,0,4,2179,4
100106,Toys,38.871063232421875,2022-01-26,104,0,45.11282730102539,4691.734039306641,2,1,0,4,2283,4
100106,Toys,38.871063232421875,2022-01-27,108,0,45.11282730102539,4872.185348510742,3,1,0,4,2391,4
100106,Toys,38.871063232421875,2022-01-28,78,0,45.11282730102539,3518.8005294799805,4,1,0,4,2469,4
100106,Toys,38.871063232421875,2022-01-29,129,399,43.36778213500976,22742.18779083252,5,1,1,4,2598,4
100106,Toys,38.871063232421875,2022-01-30,86,0,43.94556427001953,3779.3185272216797,6,1,1,4,2684,4
100106,Toys,38.871063232421875,2022-01-31,77,0,43.94556427001953,3383.808448791504,0,1,0,5,2761,4
100106,Toys,38.871063232421875,2022-02-01,86,0,43.94556427001953,3779.3185272216797,1,2,0,5,2847,4
100106,Toys,38.871063232421875,2022-02-02,63,0,43.94556427001953,2768.5705490112305,2,2,0,5,2910,4
100106,Toys,38.871063232421875,2022-02-03,98,422,36.4889769744873,18261.79948699951,3,2,0,5,3008,4
100106,Toys,38.871063232421875,2022-02-04,56,0,38.68795394897461,2166.525421142578,4,2,0,5,3064,4
100106,Toys,38.871063232421875,2022-02-05,92,0,38.68795394897461,3559.291763305664,5,2,1,5,3156,4
100106,Toys,38.871063232421875,2022-02-06,74,0,38.68795394897461,2862.908592224121,6,2,1,5,3230,4
100106,Toys,38.871063232421875,2022-02-07,60,0,38.68795394897461,2321.2772369384766,0,2,0,6,3290,4
100106,Toys,38.871063232421875,2022-02-08,81,0,38.68795394897461,3133.7242698669434,1,2,0,6,3371,4
100106,Toys,38.871063232421875,2022-02-09,82,321,40.22511695861816,16331.389181213377,2,2,0,6,3453,4
100106,Toys,38.871063232421875,2022-02-10,153,0,39.72023391723633,6077.195789337158,3,2,0,6,3606,4
100106,Toys,38.871063232421875,2022-02-11,79,0,39.72023391723633,3137.89847946167,4,2,0,6,3685,4
100106,Toys,38.871063232421875,2022-02-12,67,279,39.383112792968745,13600.457114257812,5,2,1,6,3752,4
100106,Toys,38.871063232421875,2022-02-13,89,0,39.5062255859375,3516.0540771484375,6,2,1,6,3841,4
100106,Toys,38.871063232421875,2022-02-14,57,0,39.5062255859375,2251.8548583984375,0,2,0,7,3898,4
100106,Toys,38.871063232421875,2022-02-15,125,452,39.20138328552246,22589.315821380616,1,2,0,7,4023,4
100106,Toys,38.871063232421875,2022-02-16,93,0,39.29276657104492,3654.2272911071777,2,2,0,7,4116,4
100106,Toys,38.871063232421875,2022-02-17,130,0,39.29276657104492,5108.05965423584,3,2,0,7,4246,4
100106,Toys,38.871063232421875,2022-02-18,124,0,39.29276657104492,4872.30305480957,4,2,0,7,4370,4
100106,Toys,38.871063232421875,2022-02-19,82,0,39.29276657104492,3222.0068588256836,5,2,1,7,4452,4
100106,Toys,38.871063232421875,2022-02-20,54,255,36.493508453369145,11074.788912963868,6,2,1,7,4506,4
100106,Toys,38.871063232421875,2022-02-21,80,0,37.49701690673828,2999.7613525390625,0,2,0,8,4586,4
100106,Toys,38.871063232421875,2022-02-22,19,0,37.49701690673828,712.4433212280273,1,2,0,8,4605,4
100106,Toys,38.871063232421875,2022-02-23,136,363,40.994051437377934,20732.051990966796,2,2,0,8,4741,4
100106,Toys,38.871063232421875,2022-02-24,63,0,39.77810287475586,2506.020481109619,3,2,0,8,4804,4
100106,Toys,38.871063232421875,2022-02-25,95,0,39.77810287475586,3778.9197731018066,4,2,0,8,4899,4
100106,Toys,38.871063232421875,2022-02-26,54,0,39.77810287475586,2148.0175552368164,5,2,1,8,4953,4
100106,Toys,38.871063232421875,2022-02-27,173,446,37.90263954162597,23302.67328140259,6,2,1,8,5126,4
100106,Toys,38.871063232421875,2022-02-28,91,0,38.48527908325195,3502.1603965759277,0,2,0,9,5217,4
100106,Toys,38.871063232421875,2022-03-01,86,0,38.48527908325195,3309.734001159668,1,3,0,9,5303,4
100106,Toys,38.871063232421875,2022-03-02,88,0,38.48527908325195,3386.704559326172,2,3,0,9,5391,4
100106,Toys,38.871063232421875,2022-03-03,100,485,42.59037139892578,25384.92427978516,3,3,0,9,5491,4
100106,Toys,38.871063232421875,2022-03-04,236,0,41.37074279785156,9763.495300292969,4,3,0,9,5727,4
100106,Toys,38.871063232421875,2022-03-05,74,484,50.01539024353028,29206.07775604248,5,3,1,9,5801,4
100106,Toys,38.871063232421875,2022-03-06,144,0,46.85078048706055,6746.512390136719,6,3,1,9,5945,4
100106,Toys,38.871063232421875,2022-03-07,182,0,46.85078048706055,8526.84204864502,0,3,0,10,6127,4
100106,Toys,38.871063232421875,2022-03-08,146,0,46.85078048706055,6840.21395111084,1,3,0,10,6273,4
100106,Toys,38.871063232421875,2022-03-09,165,487,47.28372367858887,30876.088813934326,2,3,0,10,6438,4
100106,Toys,38.871063232421875,2022-03-10,62,0,47.137447357177734,2922.5217361450195,3,3,0,10,6500,4
100106,Toys,38.871063232421875,2022-03-11,95,0,47.137447357177734,4478.057498931885,4,3,0,10,6595,4
100106,Toys,38.871063232421875,2022-03-12,176,0,47.137447357177734,8296.190734863281,5,3,1,10,6771,4
100106,Toys,38.871063232421875,2022-03-13,112,549,49.6722713470459,33173.238781738284,6,3,1,10,6883,4
100106,Toys,38.871063232421875,2022-03-14,142,0,48.8945426940918,6943.025062561035,0,3,0,11,7025,4
100106,Toys,38.871063232421875,2022-03-15,105,0,48.8945426940918,5133.926982879639,1,3,0,11,7130,4
100106,Toys,38.871063232421875,2022-03-16,83,0,48.8945426940918,4058.247043609619,2,3,0,11,7213,4
100106,Toys,38.871063232421875,2022-03-17,84,0,48.8945426940918,4107.141586303711,3,3,0,11,7297,4
100106,Toys,38.871063232421875,2022-03-18,212,618,47.27299156188965,39044.548422241205,4,3,0,11,7509,4
100106,Toys,38.871063232421875,2022-03-19,47,0,47.7459831237793,2244.061206817627,5,3,1,11,7556,4
100106,Toys,38.871063232421875,2022-03-20,177,0,47.7459831237793,8451.039012908936,6,3,1,11,7733,4
100106,Toys,38.871063232421875,2022-03-21,60,0,47.7459831237793,2864.758987426758,0,3,0,12,7793,4
100106,Toys,38.871063232421875,2022-03-22,79,0,47.7459831237793,3771.9326667785645,1,3,0,12,7872,4
100106,Toys,38.871063232421875,2022-03-23,238,669,54.08005126953125,49847.93440429687,2,3,0,12,8110,4
100106,Toys,38.871063232421875,2022-03-24,195,0,52.2301025390625,10184.869995117188,3,3,0,12,8305,4
100106,Toys,38.871063232421875,2022-03-25,119,0,52.2301025390625,6215.3822021484375,4,3,0,12,8424,4
100106,Toys,38.871063232421875,2022-03-26,138,0,52.2301025390625,7207.754150390625,5,3,1,12,8562,4
100106,Toys,38.871063232421875,2022-03-27,207,540,49.59767173767089,36760.52609939575,6,3,1,12,8769,4
100106,Toys,38.871063232421875,2022-03-28,71,0,50.4653434753418,3583.0393867492676,0,3,0,13,8840,4
100106,Toys,38.871063232421875,2022-03-29,148,0,50.4653434753418,7468.870834350586,1,3,0,13,8988,4
100106,Toys,38.871063232421875,2022-03-30,57,0,50.4653434753418,2876.5245780944824,2,3,0,13,9045,4
100106,Toys,38.871063232421875,2022-03-31,124,0,50.4653434753418,6257.702590942383,3,3,0,13,9169,4
100106,Toys,38.871063232421875,2022-04-01,151,513,48.417666091918946,31918.49515975952,4,4,0,13,9320,4
100106,Toys,38.871063232421875,2022-04-02,142,0,49.05533218383789,6965.8571701049805,5,4,1,13,9462,4
100106,Toys,38.871063232421875,2022-04-03,102,0,49.05533218383789,5003.643882751465,6,4,1,13,9564,4
100106,Toys,38.871063232421875,2022-04-04,77,0,49.05533218383789,3777.2605781555176,0,4,0,14,9641,4
100106,Toys,38.871063232421875,2022-04-05,141,692,46.54192596435547,38399.193121948236,1,4,0,14,9782,4
100106,Toys,38.871063232421875,2022-04-06,101,0,47.21385192871094,4768.599044799805,2,4,0,14,9883,4
100106,Toys,38.871063232421875,2022-04-07,187,0,47.21385192871094,8828.990310668945,3,4,0,14,10070,4
100106,Toys,38.871063232421875,2022-04-08,75,0,47.21385192871094,3541.0388946533203,4,4,0,14,10145,4
100106,Toys,38.871063232421875,2022-04-09,82,0,47.21385192871094,3871.535858154297,5,4,1,14,10227,4
100106,Toys,38.871063232421875,2022-04-10,130,0,47.21385192871094,6137.800750732422,6,4,1,14,10357,4
100106,Toys,38.871063232421875,2022-04-11,80,0,47.21385192871094,3777.108154296875,0,4,0,15,10437,4
100106,Toys,38.871063232421875,2022-04-12,237,631,51.57773536682129,45184.06656387329,1,4,0,15,10674,4
100106,Toys,38.871063232421875,2022-04-13,123,0,50.52547073364258,6214.632900238037,2,4,0,15,10797,4
100106,Toys,38.871063232421875,2022-04-14,41,0,50.52547073364258,2071.5443000793457,3,4,0,15,10838,4
100106,Toys,38.871063232421875,2022-04-15,163,0,50.52547073364258,8235.65172958374,4,4,0,15,11001,4
100106,Toys,38.871063232421875,2022-04-16,55,0,50.52547073364258,2778.900890350342,5,4,1,15,11056,4
100106,Toys,38.871063232421875,2022-04-17,88,351,45.938887710571294,19720.36423706055,6,4,1,15,11144,4
100106,Toys,38.871063232421875,2022-04-18,187,0,47.63777542114258,8908.264003753662,0,4,0,16,11331,4
100106,Toys,38.871063232421875,2022-04-19,138,705,52.116668472290044,44588.29049835206,1,4,0,16,11469,4
100106,Toys,38.871063232421875,2022-04-20,187,0,50.96333694458008,9530.144008636475,2,4,0,16,11656,4
100106,Toys,38.871063232421875,2022-04-21,134,0,50.96333694458008,6829.0871505737305,3,4,0,16,11790,4
100106,Toys,38.871063232421875,2022-04-22,48,0,50.96333694458008,2446.2401733398438,4,4,0,16,11838,4
100106,Toys,38.871063232421875,2022-04-23,32,0,50.96333694458008,1630.8267822265625,5,4,1,16,11870,4
100106,Toys,38.871063232421875,2022-04-24,23,0,50.96333694458008,1172.1567497253418,6,4,1,16,11893,4
100106,Toys,38.871063232421875,2022-04-25,10,0,50.96333694458008,509.6333694458008,0,4,0,17,11903,4
100106,Toys,38.871063232421875,2022-04-26,59,0,50.96333694458008,3006.8368797302246,1,4,0,17,11962,4
100106,Toys,38.871063232421875,2022-04-27,28,0,50.96333694458008,1426.9734344482422,2,4,0,17,11990,4
100106,Toys,38.871063232421875,2022-04-28,38,0,50.96333694458008,1936.606803894043,3,4,0,17,12028,4
100106,Toys,38.871063232421875,2022-04-29,50,0,50.96333694458008,2548.166847229004,4,4,0,17,12078,4
100106,Toys,38.871063232421875,2022-04-30,91,0,50.96333694458008,4637.663661956787,5,4,1,17,12169,4
100106,Toys,38.871063232421875,2022-05-01,32,0,50.96333694458008,1630.8267822265625,6,5,1,17,12201,4
100106,Toys,38.871063232421875,2022-05-02,17,0,50.96333694458008,866.3767280578613,0,5,0,18,12218,4
100106,Toys,38.871063232421875,2022-05-03,47,0,50.96333694458008,2395.2768363952637,1,5,0,18,12265,4
100106,Toys,38.871063232421875,2022-05-04,12,0,50.96333694458008,611.5600433349609,2,5,0,18,12277,4
100106,Toys,38.871063232421875,2022-05-05,40,0,50.96333694458008,2038.5334777832031,3,5,0,18,12317,4
100106,Toys,38.871063232421875,2022-05-06,33,0,50.96333694458008,1681.7901191711426,4,5,0,18,12350,4
100106,Toys,38.871063232421875,2022-05-07,34,126,36.67562118530273,5329.382240600586,5,5,1,18,12384,4
100106,Toys,38.871063232421875,2022-05-08,19,0,42.53124237060547,808.0936050415039,6,5,1,18,12403,4
100106,Toys,38.871063232421875,2022-05-09,17,0,42.53124237060547,723.031120300293,0,5,0,19,12420,4
100106,Toys,38.871063232421875,2022-05-10,13,0,42.53124237060547,552.9061508178711,1,5,0,19,12433,4
100106,Toys,38.871063232421875,2022-05-11,24,0,42.53124237060547,1020.7498168945312,2,5,0,19,12457,4
100106,Toys,38.871063232421875,2022-05-12,29,0,42.53124237060547,1233.4060287475586,3,5,0,19,12486,4
100106,Toys,38.871063232421875,2022-05-13,9,0,42.53124237060547,382.7811813354492,4,5,0,19,12495,4
100106,Toys,38.871063232421875,2022-05-14,39,0,42.53124237060547,1658.7184524536133,5,5,1,19,12534,4
100106,Toys,38.871063232421875,2022-05-15,13,0,42.53124237060547,552.9061508178711,6,5,1,19,12547,4
100106,Toys,38.871063232421875,2022-05-16,13,0,42.53124237060547,552.9061508178711,0,5,0,20,12560,4
100106,Toys,38.871063232421875,2022-05-17,48,192,35.505907135009764,8327.607084960937,1,5,0,20,12608,4
100106,Toys,38.871063232421875,2022-05-18,36,0,36.85181427001953,1326.6653137207031,2,5,0,20,12644,4
100106,Toys,38.871063232421875,2022-05-19,7,279,35.31420524597168,9989.918873443603,3,5,0,20,12651,4
100106,Toys,38.871063232421875,2022-05-20,56,0,35.71841049194336,2000.2309875488281,4,5,0,20,12707,4
100106,Toys,38.871063232421875,2022-05-21,27,0,35.71841049194336,964.3970832824707,5,5,1,20,12734,4
100106,Toys,38.871063232421875,2022-05-22,25,0,35.71841049194336,892.960262298584,6,5,1,20,12759,4
100106,Toys,38.871063232421875,2022-05-23,29,0,35.71841049194336,1035.8339042663574,0,5,0,21,12788,4
100106,Toys,38.871063232421875,2022-05-24,29,0,35.71841049194336,1035.8339042663574,1,5,0,21,12817,4
100106,Toys,38.871063232421875,2022-05-25,22,0,35.71841049194336,785.8050308227539,2,5,0,21,12839,4
100106,Toys,38.871063232421875,2022-05-26,86,345,42.71501541137695,18937.232650756836,3,5,0,21,12925,4
100106,Toys,38.871063232421875,2022-05-27,111,0,40.680030822753906,4515.483421325684,4,5,0,21,13036,4
100106,Toys,38.871063232421875,2022-05-28,86,0,40.680030822753906,3498.482650756836,5,5,1,21,13122,4
100106,Toys,38.871063232421875,2022-05-29,79,0,40.680030822753906,3213.7224349975586,6,5,1,21,13201,4
100106,Toys,38.871063232421875,2022-05-30,62,240,36.5888037109375,10790.15166015625,0,5,0,22,13263,4
100106,Toys,38.871063232421875,2022-05-31,35,0,38.047607421875,1331.666259765625,1,5,0,22,13298,4
100106,Toys,38.871063232421875,2022-06-01,35,0,38.047607421875,1331.666259765625,2,6,0,22,13333,4
100106,Toys,38.871063232421875,2022-06-02,71,0,38.047607421875,2701.380126953125,3,6,0,22,13404,4
100106,Toys,38.871063232421875,2022-06-03,116,317,37.898285675048825,16400.25227661133,4,6,0,22,13520,4
100106,Toys,38.871063232421875,2022-06-04,123,0,37.946571350097656,4667.428276062012,5,6,1,22,13643,4
100106,Toys,38.871063232421875,2022-06-05,64,0,37.946571350097656,2428.58056640625,6,6,1,22,13707,4
100106,Toys,38.871063232421875,2022-06-06,93,357,35.593496856689455,15826.070415344237,0,6,0,23,13800,4
100106,Toys,38.871063232421875,2022-06-07,65,0,36.316993713378906,2360.604591369629,1,6,0,23,13865,4
100106,Toys,38.871063232421875,2022-06-08,132,486,47.79108215332032,30943.425688476564,2,6,0,23,13997,4
100106,Toys,38.871063232421875,2022-06-09,85,0,43.812164306640625,3724.033966064453,3,6,0,23,14082,4
100106,Toys,38.871063232421875,2022-06-10,92,0,43.812164306640625,4030.7191162109375,4,6,0,23,14174,4
100106,Toys,38.871063232421875,2022-06-11,117,0,43.812164306640625,5126.023223876953,5,6,1,23,14291,4
100106,Toys,38.871063232421875,2022-06-12,103,0,43.812164306640625,4512.652923583984,6,6,1,23,14394,4
100106,Toys,38.871063232421875,2022-06-13,84,0,43.812164306640625,3680.2218017578125,0,6,0,24,14478,4
100106,Toys,38.871063232421875,2022-06-14,107,421,41.44730339050293,21649.522925567628,1,6,0,24,14585,4
100106,Toys,38.871063232421875,2022-06-15,53,0,42.19460678100586,2236.3141593933105,2,6,0,24,14638,4
100106,Toys,38.871063232421875,2022-06-16,86,0,42.19460678100586,3628.736183166504,3,6,0,24,14724,4
100106,Toys,38.871063232421875,2022-06-17,114,0,42.19460678100586,4810.185173034668,4,6,0,24,14838,4
100106,Toys,38.871063232421875,2022-06-18,60,0,42.19460678100586,2531.6764068603516,5,6,1,24,14898,4
100106,Toys,38.871063232421875,2022-06-19,98,0,42.19460678100586,4135.071464538574,6,6,1,24,14996,4
100106,Toys,38.871063232421875,2022-06-20,52,0,42.19460678100586,2194.1195526123047,0,6,0,25,15048,4
100106,Toys,38.871063232421875,2022-06-21,140,440,50.071989898681636,29548.157171630857,1,6,0,25,15188,4
100106,Toys,38.871063232421875,2022-06-22,99,0,48.38397979736328,4790.013999938965,2,6,0,25,15287,4
100106,Toys,38.871063232421875,2022-06-23,1,0,48.38397979736328,48.38397979736328,3,6,0,25,15288,4
100106,Toys,38.871063232421875,2022-06-24,77,0,48.38397979736328,3725.5664443969727,4,6,0,25,15365,4
100106,Toys,38.871063232421875,2022-06-25,174,431,48.13405731201172,29102.07194458008,5,6,1,25,15539,4
100106,Toys,38.871063232421875,2022-06-26,112,0,48.20811462402344,5399.308837890625,6,6,1,25,15651,4
100106,Toys,38.871063232421875,2022-06-27,45,0,48.20811462402344,2169.3651580810547,0,6,0,26,15696,4
100106,Toys,38.871063232421875,2022-06-28,87,0,48.20811462402344,4194.105972290039,1,6,0,26,15783,4
100106,Toys,38.871063232421875,2022-06-29,46,0,48.20811462402344,2217.573272705078,2,6,0,26,15829,4
100106,Toys,38.871063232421875,2022-06-30,51,0,48.20811462402344,2458.6138458251953,3,6,0,26,15880,4
100106,Toys,38.871063232421875,2022-07-01,16,0,48.20811462402344,771.329833984375,4,7,0,26,15896,4
100106,Toys,38.871063232421875,2022-07-02,8,0,48.20811462402344,385.6649169921875,5,7,1,26,15904,4
100106,Toys,38.871063232421875,2022-07-03,52,0,48.20811462402344,2506.8219604492188,6,7,1,26,15956,4
100106,Toys,38.871063232421875,2022-07-04,10,0,48.20811462402344,482.0811462402344,0,7,0,27,15966,4
100106,Toys,38.871063232421875,2022-07-05,48,0,48.20811462402344,2313.989501953125,1,7,0,27,16014,4
100106,Toys,38.871063232421875,2022-07-06,17,0,48.20811462402344,819.5379486083984,2,7,0,27,16031,4
100106,Toys,38.871063232421875,2022-07-07,22,0,48.20811462402344,1060.5785217285156,3,7,0,27,16053,4
100106,Toys,38.871063232421875,2022-07-08,27,87,34.61569915771484,3637.4477545166014,4,7,0,27,16080,4
100106,Toys,38.871063232421875,2022-07-09,41,0,39.76139831542969,1630.2173309326172,5,7,1,27,16121,4
100106,Toys,38.871063232421875,2022-07-10,32,159,31.711434097290038,5768.4117822265625,6,7,1,27,16153,4
100106,Toys,38.871063232421875,2022-07-11,19,0,33.98286819458008,645.6744956970215,0,7,0,28,16172,4
100106,Toys,38.871063232421875,2022-07-12,13,0,33.98286819458008,441.777286529541,1,7,0,28,16185,4
100106,Toys,38.871063232421875,2022-07-13,12,0,33.98286819458008,407.79441833496094,2,7,0,28,16197,4
100106,Toys,38.871063232421875,2022-07-14,28,0,33.98286819458008,951.5203094482422,3,7,0,28,16225,4
100106,Toys,38.871063232421875,2022-07-15,4,0,33.98286819458008,135.9314727783203,4,7,0,28,16229,4
100106,Toys,38.871063232421875,2022-07-16,31,0,33.98286819458008,1053.4689140319824,5,7,1,28,16260,4
100106,Toys,38.871063232421875,2022-07-17,17,0,33.98286819458008,577.7087593078613,6,7,1,28,16277,4
100106,Toys,38.871063232421875,2022-07-18,45,139,31.12956451416016,5643.280806274414,0,7,0,29,16322,4
100106,Toys,38.871063232421875,2022-07-19,44,0,32.02912902832031,1409.2816772460938,1,7,0,29,16366,4
100106,Toys,38.871063232421875,2022-07-20,3,0,32.02912902832031,96.08738708496094,2,7,0,29,16369,4
100106,Toys,38.871063232421875,2022-07-21,15,0,32.02912902832031,480.4369354248047,3,7,0,29,16384,4
100106,Toys,38.871063232421875,2022-07-22,15,0,32.02912902832031,480.4369354248047,4,7,0,29,16399,4
100106,Toys,38.871063232421875,2022-07-23,23,111,32.61752777099609,4391.206277465821,5,7,1,29,16422,4
100106,Toys,38.871063232421875,2022-07-24,7,0,32.38505554199219,226.6953887939453,6,7,1,29,16429,4
100106,Toys,38.871063232421875,2022-07-25,93,280,32.37336212158203,12074.635354614256,0,7,0,30,16522,4
100106,Toys,38.871063232421875,2022-07-26,133,386,40.825429687500005,21933.374296875,1,7,0,30,16655,4
100106,Toys,38.871063232421875,2022-07-28,195,0,37.880859375,7386.767578125,3,7,0,30,16850,4
100106,Toys,38.871063232421875,2022-07-29,66,0,37.880859375,2500.13671875,4,7,0,30,16916,4
100106,Toys,38.871063232421875,2022-07-30,94,0,37.880859375,3560.80078125,5,7,1,30,17010,4
100106,Toys,38.871063232421875,2022-07-31,135,388,40.718208923339844,21501.006409301757,6,7,1,30,17145,4
100106,Toys,38.871063232421875,2022-08-01,111,0,39.90641784667969,4429.612380981445,0,8,0,31,17256,4
100106,Toys,38.871063232421875,2022-08-02,65,0,39.90641784667969,2593.9171600341797,1,8,0,31,17321,4
100106,Toys,38.871063232421875,2022-08-03,97,0,39.90641784667969,3870.9225311279297,2,8,0,31,17418,4
100106,Toys,38.871063232421875,2022-08-04,170,464,43.59052787780762,27894.959478454588,3,8,0,31,17588,4
100106,Toys,38.871063232421875,2022-08-05,74,0,42.711055755615234,3160.6181259155273,4,8,0,31,17662,4
100106,Toys,38.871063232421875,2022-08-06,47,0,42.711055755615234,2007.419620513916,5,8,1,31,17709,4
100106,Toys,38.871063232421875,2022-08-07,62,0,42.711055755615234,2648.0854568481445,6,8,1,31,17771,4
100106,Toys,38.871063232421875,2022-08-08,67,0,42.711055755615234,2861.6407356262207,0,8,0,32,17838,4
100106,Toys,38.871063232421875,2022-08-09,150,422,45.4280086517334,26194.80259552002,1,8,0,32,17988,4
100106,Toys,38.871063232421875,2022-08-10,72,0,44.6560173034668,3215.2332458496094,2,8,0,32,18060,4
100106,Toys,38.871063232421875,2022-08-11,56,0,44.6560173034668,2500.7369689941406,3,8,0,32,18116,4
100106,Toys,38.871063232421875,2022-08-12,115,0,44.6560173034668,5135.441989898682,4,8,0,32,18231,4
100106,Toys,38.871063232421875,2022-08-13,120,0,44.6560173034668,5358.722076416016,5,8,1,32,18351,4
100106,Toys,38.871063232421875,2022-08-14,96,338,38.849887161254884,16488.198334960936,6,8,1,32,18447,4
100106,Toys,38.871063232421875,2022-08-15,63,0,40.389774322509766,2544.5557823181152,0,8,0,33,18510,4
100106,Toys,38.871063232421875,2022-08-16,45,0,40.389774322509766,1817.5398445129395,1,8,0,33,18555,4
100106,Toys,38.871063232421875,2022-08-17,62,0,40.389774322509766,2504.1660079956055,2,8,0,33,18617,4
100106,Toys,38.871063232421875,2022-08-18,73,0,40.389774322509766,2948.453525543213,3,8,0,33,18690,4
100106,Toys,38.871063232421875,2022-08-19,57,243,39.084943008422854,11644.583502960204,4,8,0,33,18747,4
100106,Toys,38.871063232421875,2022-08-20,65,0,39.5198860168457,2568.7925910949707,5,8,1,33,18812,4
100106,Toys,38.871063232421875,2022-08-21,121,375,41.555018768310546,20780.194541931152,6,8,1,33,18933,4
100106,Toys,38.871063232421875,2022-08-22,124,0,40.890037536621094,5070.364654541016,0,8,0,34,19057,4
100106,Toys,38.871063232421875,2022-08-23,85,0,40.890037536621094,3475.653190612793,1,8,0,34,19142,4
100106,Toys,38.871063232421875,2022-08-24,89,0,40.890037536621094,3639.2133407592773,2,8,0,34,19231,4
100106,Toys,38.871063232421875,2022-08-25,126,409,46.68147590637207,25435.461928405763,3,8,0,34,19357,4
100106,Toys,38.871063232421875,2022-08-26,99,0,45.05295181274414,4460.24222946167,4,8,0,34,19456,4
100106,Toys,38.871063232421875,2022-08-27,88,0,45.05295181274414,3964.6597595214844,5,8,1,34,19544,4
100106,Toys,38.871063232421875,2022-08-28,39,0,45.05295181274414,1757.0651206970215,6,8,1,34,19583,4
100106,Toys,38.871063232421875,2022-08-29,121,372,41.47372032165528,20144.41031784058,0,8,0,35,19704,4
100106,Toys,38.871063232421875,2022-08-30,102,0,42.67744064331055,4353.098945617676,1,8,0,35,19806,4
100106,Toys,38.871063232421875,2022-08-31,95,0,42.67744064331055,4054.356861114502,2,8,0,35,19901,4
100106,Toys,38.871063232421875,2022-09-01,145,0,42.67744064331055,6188.228893280029,3,9,0,35,20046,4
100106,Toys,38.871063232421875,2022-09-02,143,406,41.362504730224614,22617.93635284424,4,9,0,35,20189,4
100106,Toys,38.871063232421875,2022-09-03,99,0,41.70500946044922,4128.795936584473,5,9,1,35,20288,4
100106,Toys,38.871063232421875,2022-09-04,44,396,47.76452301025391,21789.198024902344,6,9,1,35,20332,4
100106,Toys,38.871063232421875,2022-09-05,62,0,45.56904602050781,2825.2808532714844,0,9,0,36,20394,4
100106,Toys,38.871063232421875,2022-09-06,103,0,45.56904602050781,4693.611740112305,1,9,0,36,20497,4
100106,Toys,38.871063232421875,2022-09-07,116,0,45.56904602050781,5286.009338378906,2,9,0,36,20613,4
100106,Toys,38.871063232421875,2022-09-08,51,0,45.56904602050781,2324.0213470458984,3,9,0,36,20664,4
100106,Toys,38.871063232421875,2022-09-09,97,0,45.56904602050781,4420.197463989258,4,9,0,36,20761,4
100106,Toys,38.871063232421875,2022-09-10,72,0,45.56904602050781,3280.9713134765625,5,9,1,36,20833,4
100106,Toys,38.871063232421875,2022-09-11,61,0,45.56904602050781,2779.7118072509766,6,9,1,36,20894,4
100106,Toys,38.871063232421875,2022-09-12,99,420,41.18437049865723,21061.91535873413,0,9,0,37,20993,4
100106,Toys,38.871063232421875,2022-09-13,47,0,42.15874099731445,1981.4608268737793,1,9,0,37,21040,4
100106,Toys,38.871063232421875,2022-09-14,94,0,42.15874099731445,3962.9216537475586,2,9,0,37,21134,4
100106,Toys,38.871063232421875,2022-09-15,41,0,42.15874099731445,1728.5083808898926,3,9,0,37,21175,4
100106,Toys,38.871063232421875,2022-09-16,94,0,42.15874099731445,3962.9216537475586,4,9,0,37,21269,4
100106,Toys,38.871063232421875,2022-09-17,176,490,39.60528434753418,26196.480090332032,5,9,1,37,21445,4
100106,Toys,38.871063232421875,2022-09-18,63,0,40.18056869506836,2531.3758277893066,6,9,1,37,21508,4
100106,Toys,38.871063232421875,2022-09-19,46,0,40.18056869506836,1848.3061599731445,0,9,0,38,21554,4
100106,Toys,38.871063232421875,2022-09-20,69,0,40.18056869506836,2772.459239959717,1,9,0,38,21623,4
100106,Toys,38.871063232421875,2022-09-21,81,0,40.18056869506836,3254.626064300537,2,9,0,38,21704,4
100106,Toys,38.871063232421875,2022-09-22,120,379,39.18750518798828,19474.921245117188,3,9,0,38,21824,4
100106,Toys,38.871063232421875,2022-09-23,172,0,39.49501037597656,6793.141784667969,4,9,0,38,21996,4
100106,Toys,38.871063232421875,2022-09-24,48,0,39.49501037597656,1895.760498046875,5,9,1,38,22044,4
100106,Toys,38.871063232421875,2022-09-25,65,0,39.49501037597656,2567.1756744384766,6,9,1,38,22109,4
100106,Toys,38.871063232421875,2022-09-26,191,417,44.83846321105957,27592.092946624754,0,9,0,39,22300,4
100106,Toys,38.871063232421875,2022-09-27,89,0,43.37692642211914,3860.5464515686035,1,9,0,39,22389,4
100106,Toys,38.871063232421875,2022-09-28,34,0,43.37692642211914,1474.8154983520508,2,9,0,39,22423,4
100106,Toys,38.871063232421875,2022-09-29,93,0,43.37692642211914,4034.05415725708,3,9,0,39,22516,4
100106,Toys,38.871063232421875,2022-09-30,36,0,43.37692642211914,1561.569351196289,4,9,0,39,22552,4
100106,Toys,38.871063232421875,2022-10-01,77,283,42.743586196899415,15343.69227432251,5,10,1,39,22629,4
100106,Toys,38.871063232421875,2022-10-02,144,0,42.95717239379883,6185.832824707031,6,10,1,39,22773,4
100106,Toys,38.871063232421875,2022-10-03,67,315,42.66451957702637,16271.925623321535,0,10,0,40,22840,4
100106,Toys,38.871063232421875,2022-10-04,42,0,42.769039154052734,1796.2996444702148,1,10,0,40,22882,4
100106,Toys,38.871063232421875,2022-10-05,92,0,42.769039154052734,3934.7516021728516,2,10,0,40,22974,4
100106,Toys,38.871063232421875,2022-10-06,80,0,42.769039154052734,3421.5231323242188,3,10,0,40,23054,4
100106,Toys,38.871063232421875,2022-10-07,172,437,40.47135902404786,24461.197504272463,4,10,0,40,23226,4
100106,Toys,38.871063232421875,2022-10-08,81,0,41.1727180480957,3334.990161895752,5,10,1,40,23307,4
100106,Toys,38.871063232421875,2022-10-09,108,0,41.1727180480957,4446.653549194336,6,10,1,40,23415,4
100106,Toys,38.871063232421875,2022-10-10,131,382,38.96114677429199,19778.450454864505,0,10,0,41,23546,4
100106,Toys,38.871063232421875,2022-10-11,66,0,39.792293548583984,2626.291374206543,1,10,0,41,23612,4
100106,Toys,38.871063232421875,2022-10-12,88,0,39.792293548583984,3501.7218322753906,2,10,0,41,23700,4
100106,Toys,38.871063232421875,2022-10-13,188,0,39.792293548583984,7480.951187133789,3,10,0,41,23888,4
100106,Toys,38.871063232421875,2022-10-14,81,337,38.85987724304199,16158.980113372803,4,10,0,41,23969,4
100106,Toys,38.871063232421875,2022-10-15,49,0,39.189754486083984,1920.2979698181152,5,10,1,41,24018,4
100106,Toys,38.871063232421875,2022-10-16,67,0,39.189754486083984,2625.713550567627,6,10,1,41,24085,4
100106,Toys,38.871063232421875,2022-10-17,64,0,39.189754486083984,2508.144287109375,0,10,0,42,24149,4
100106,Toys,38.871063232421875,2022-10-18,94,0,39.189754486083984,3683.8369216918945,1,10,0,42,24243,4
100106,Toys,38.871063232421875,2022-10-19,94,0,39.189754486083984,3683.8369216918945,2,10,0,42,24337,4
100106,Toys,38.871063232421875,2022-10-20,107,366,41.87279144287109,19986.407368774417,3,10,0,42,24444,4
100106,Toys,38.871063232421875,2022-10-21,54,0,41.17558288574219,2223.481475830078,4,10,0,42,24498,4
100106,Toys,38.871063232421875,2022-10-22,86,0,41.17558288574219,3541.100128173828,5,10,1,42,24584,4
100106,Toys,38.871063232421875,2022-10-23,97,0,41.17558288574219,3994.031539916992,6,10,1,42,24681,4
100106,Toys,38.871063232421875,2022-10-24,208,592,42.002334671020506,33662.41122314453,0,10,0,43,24889,4
100106,Toys,38.871063232421875,2022-10-25,71,0,41.844669342041016,2970.971523284912,1,10,0,43,24960,4
100106,Toys,38.871063232421875,2022-10-27,40,0,41.844669342041016,1673.7867736816406,3,10,0,43,25000,4
100106,Toys,38.871063232421875,2022-10-28,75,0,41.844669342041016,3138.350200653076,4,10,0,43,25075,4
100106,Toys,38.871063232421875,2022-10-29,145,0,41.844669342041016,6067.477054595947,5,10,1,43,25220,4
100106,Toys,38.871063232421875,2022-10-30,85,0,41.844669342041016,3556.7968940734863,6,10,1,43,25305,4
100106,Toys,38.871063232421875,2022-10-31,85,252,43.248339157104496,14651.787656707764,0,10,0,44,25390,4
100106,Toys,38.871063232421875,2022-11-01,104,0,42.786678314208984,4449.814544677734,1,11,0,44,25494,4
100106,Toys,38.871063232421875,2022-11-02,58,0,42.786678314208984,2481.627342224121,2,11,0,44,25552,4
100106,Toys,38.871063232421875,2022-11-03,70,0,42.786678314208984,2995.067481994629,3,11,0,44,25622,4
100106,Toys,38.871063232421875,2022-11-04,101,459,41.279387130737305,23027.176200408936,4,11,0,44,25723,4
100106,Toys,38.871063232421875,2022-11-05,81,0,41.52877426147461,3363.8307151794434,5,11,1,44,25804,4
100106,Toys,38.871063232421875,2022-11-07,91,0,41.52877426147461,3779.1184577941895,0,11,0,45,25895,4
100106,Toys,38.871063232421875,2022-11-08,220,698,46.97402923583984,43665.15286376953,1,11,0,45,26115,4
100106,Toys,38.871063232421875,2022-11-09,61,0,45.83805847167969,2796.121566772461,2,11,0,45,26176,4
100106,Toys,38.871063232421875,2022-11-10,76,0,45.83805847167969,3483.6924438476562,3,11,0,45,26252,4
100106,Toys,38.871063232421875,2022-11-11,67,0,45.83805847167969,3071.149917602539,4,11,0,45,26319,4
100106,Toys,38.871063232421875,2022-11-12,182,0,45.83805847167969,8342.526641845703,5,11,1,45,26501,4
100106,Toys,38.871063232421875,2022-11-13,70,0,45.83805847167969,3208.664093017578,6,11,1,45,26571,4
100106,Toys,38.871063232421875,2022-11-14,91,292,39.83406242370606,14773.229361114501,0,11,0,46,26662,4
100106,Toys,38.871063232421875,2022-11-15,71,0,42.23812484741211,2998.9068641662598,1,11,0,46,26733,4
100106,Toys,38.871063232421875,2022-11-16,84,0,42.23812484741211,3548.002487182617,2,11,0,46,26817,4
100106,Toys,38.871063232421875,2022-11-17,70,0,42.23812484741211,2956.6687393188477,3,11,0,46,26887,4
100106,Toys,38.871063232421875,2022-11-18,53,0,42.23812484741211,2238.620616912842,4,11,0,46,26940,4
100106,Toys,38.871063232421875,2022-11-19,50,0,42.23812484741211,2111.9062423706055,5,11,1,46,26990,4
100106,Toys,38.871063232421875,2022-11-20,103,234,35.90024810791016,11799.67111022949,6,11,1,46,27093,4
100106,Toys,38.871063232421875,2022-11-21,160,533,44.85799034118652,31758.736909179686,0,11,0,47,27253,4
100106,Toys,38.871063232421875,2022-11-23,107,0,43.05598068237305,4606.989933013916,2,11,0,47,27360,4
100106,Toys,38.871063232421875,2022-11-24,202,0,43.05598068237305,8697.308097839355,3,11,0,47,27562,4
100106,Toys,38.871063232421875,2022-11-25,99,0,43.05598068237305,4262.542087554932,4,11,0,47,27661,4
100106,Toys,38.871063232421875,2022-11-26,95,377,41.81143196105957,19621.792072601318,5,11,1,47,27756,4
100106,Toys,38.871063232421875,2022-11-27,65,0,42.21286392211914,2743.836154937744,6,11,1,47,27821,4
100106,Toys,38.871063232421875,2022-11-28,50,0,42.21286392211914,2110.643196105957,0,11,0,48,27871,4
100106,Toys,38.871063232421875,2022-11-29,95,0,42.21286392211914,4010.2220726013184,1,11,0,48,27966,4
100106,Toys,38.871063232421875,2022-11-30,103,0,42.21286392211914,4347.9249839782715,2,11,0,48,28069,4
100106,Toys,38.871063232421875,2022-12-01,46,0,42.21286392211914,1941.7917404174805,3,12,0,48,28115,4
100106,Toys,38.871063232421875,2022-12-02,49,0,42.21286392211914,2068.430332183838,4,12,0,48,28164,4
100106,Toys,38.871063232421875,2022-12-03,44,0,42.21286392211914,1857.3660125732422,5,12,1,48,28208,4
100106,Toys,38.871063232421875,2022-12-04,134,300,41.82331489562988,18135.82839202881,6,12,1,48,28342,4
100106,Toys,38.871063232421875,2022-12-05,55,447,41.747945404052736,20938.673994445802,0,12,0,49,28397,4
100106,Toys,38.871063232421875,2022-12-07,55,0,41.79589080810547,2298.773994445801,2,12,0,49,28452,4
100106,Toys,38.871063232421875,2022-12-08,67,0,41.79589080810547,2800.3246841430664,3,12,0,49,28519,4
100106,Toys,38.871063232421875,2022-12-09,68,0,41.79589080810547,2842.120574951172,4,12,0,49,28587,4
100106,Toys,38.871063232421875,2022-12-10,77,0,41.79589080810547,3218.283592224121,5,12,1,49,28664,4
100106,Toys,38.871063232421875,2022-12-11,51,0,41.79589080810547,2131.590431213379,6,12,1,49,28715,4
100106,Toys,38.871063232421875,2022-12-12,69,0,41.79589080810547,2883.9164657592773,0,12,0,50,28784,4
100106,Toys,38.871063232421875,2022-12-13,56,0,41.79589080810547,2340.5698852539062,1,12,0,50,28840,4
100106,Toys,38.871063232421875,2022-12-14,84,0,41.79589080810547,3510.8548278808594,2,12,0,50,28924,4
100106,Toys,38.871063232421875,2022-12-15,72,301,34.82554290771485,12562.718178710938,3,12,0,50,28996,4
100106,Toys,38.871063232421875,2022-12-16,58,0,36.69108581542969,2128.082977294922,4,12,0,50,29054,4
100106,Toys,38.871063232421875,2022-12-17,90,319,37.21204574584961,15265.058234252929,5,12,1,50,29144,4
100106,Toys,38.871063232421875,2022-12-18,127,0,37.01409149169922,4700.789619445801,6,12,1,50,29271,4
100106,Toys,38.871063232421875,2022-12-19,80,0,37.01409149169922,2961.1273193359375,0,12,0,51,29351,4
100106,Toys,38.871063232421875,2022-12-20,64,0,37.01409149169922,2368.90185546875,1,12,0,51,29415,4
100106,Toys,38.871063232421875,2022-12-21,116,401,38.6760652923584,20139.14714782715,2,12,0,51,29531,4
100106,Toys,38.871063232421875,2022-12-22,96,0,38.1721305847168,3664.5245361328125,3,12,0,51,29627,4
100106,Toys,38.871063232421875,2022-12-23,81,0,38.1721305847168,3091.9425773620605,4,12,0,51,29708,4
100106,Toys,38.871063232421875,2022-12-24,58,0,38.1721305847168,2213.983573913574,5,12,1,51,29766,4
100106,Toys,38.871063232421875,2022-12-25,108,0,38.1721305847168,4122.590103149414,6,12,1,51,29874,4
100106,Toys,38.871063232421875,2022-12-26,63,275,39.13635955810547,13298.821304321289,0,12,0,52,29937,4
100106,Toys,38.871063232421875,2022-12-27,61,0,38.80271911621094,2366.965866088867,1,12,0,52,29998,4
100106,Toys,38.871063232421875,2022-12-28,44,0,38.80271911621094,1707.3196411132812,2,12,0,52,30042,4
100106,Toys,38.871063232421875,2022-12-29,107,0,38.80271911621094,4151.89094543457,3,12,0,52,30149,4
100106,Toys,38.871063232421875,2022-12-30,21,0,38.80271911621094,814.8571014404297,4,12,0,52,30170,4
100106,Toys,38.871063232421875,2022-12-31,120,375,40.492661209106444,20157.938690185547,5,12,1,52,30290,4
100106,Toys,38.871063232421875,2023-01-01,103,0,40.04532241821289,4124.668209075928,6,1,1,52,30393,4
100106,Toys,38.871063232421875,2023-01-02,47,0,40.04532241821289,1882.1301536560059,0,1,0,1,30440,4
100106,Toys,38.871063232421875,2023-01-03,74,0,40.04532241821289,2963.353858947754,1,1,0,1,30514,4
100106,Toys,38.871063232421875,2023-01-04,141,441,43.30947525024414,25455.27202056885,2,1,0,1,30655,4
100106,Toys,38.871063232421875,2023-01-05,112,0,42.47895050048828,4757.6424560546875,3,1,0,1,30767,4
100106,Toys,38.871063232421875,2023-01-06,48,0,42.47895050048828,2038.9896240234375,4,1,0,1,30815,4
100106,Toys,38.871063232421875,2023-01-07,73,0,42.47895050048828,3100.9633865356445,5,1,1,1,30888,4
100106,Toys,38.871063232421875,2023-01-08,25,0,42.47895050048828,1061.973762512207,6,1,1,1,30913,4
100106,Toys,38.871063232421875,2023-01-09,59,0,42.47895050048828,2506.2580795288086,0,1,0,2,30972,4
100106,Toys,38.871063232421875,2023-01-10,166,391,48.7257502746582,27514.699091186525,1,1,0,2,31138,4
100106,Toys,38.871063232421875,2023-01-11,68,0,47.061500549316406,3200.1820373535156,2,1,0,2,31206,4
100106,Toys,38.871063232421875,2023-01-12,50,0,47.061500549316406,2353.0750274658203,3,1,0,2,31256,4
100106,Toys,38.871063232421875,2023-01-13,54,0,47.061500549316406,2541.321029663086,4,1,0,2,31310,4
100106,Toys,38.871063232421875,2023-01-14,86,0,47.061500549316406,4047.289047241211,5,1,1,2,31396,4
100106,Toys,38.871063232421875,2023-01-15,70,221,40.739711380004884,11509.509593200684,6,1,1,2,31466,4
100106,Toys,38.871063232421875,2023-01-16,70,0,43.029422760009766,3012.0595932006836,0,1,0,3,31536,4
100106,Toys,38.871063232421875,2023-01-17,38,0,43.029422760009766,1635.118064880371,1,1,0,3,31574,4
100106,Toys,38.871063232421875,2023-01-18,78,364,37.539339523315434,16140.696965637208,2,1,0,3,31652,4
100106,Toys,38.871063232421875,2023-01-19,112,0,39.11867904663086,4381.292053222656,3,1,0,3,31764,4
100106,Toys,38.871063232421875,2023-01-20,104,0,39.11867904663086,4068.3426208496094,4,1,0,3,31868,4
100106,Toys,38.871063232421875,2023-01-21,141,586,46.815914459228516,34846.88787750244,5,1,1,3,32009,4
100106,Toys,38.871063232421875,2023-01-22,87,0,44.99182891845703,3914.2891159057617,6,1,1,3,32096,4
100106,Toys,38.871063232421875,2023-01-23,116,0,44.99182891845703,5219.052154541016,0,1,0,4,32212,4
100106,Toys,38.871063232421875,2023-01-24,56,0,44.99182891845703,2519.5424194335938,1,1,0,4,32268,4
100106,Toys,38.871063232421875,2023-01-25,68,0,44.99182891845703,3059.444366455078,2,1,0,4,32336,4
100106,Toys,38.871063232421875,2023-01-26,123,0,44.99182891845703,5533.994956970215,3,1,0,4,32459,4
100106,Toys,38.871063232421875,2023-01-27,138,334,42.4933667755127,19885.689230041506,4,1,0,4,32597,4
100106,Toys,38.871063232421875,2023-01-28,106,0,43.36673355102539,4596.873756408691,5,1,1,4,32703,4
100106,Toys,38.871063232421875,2023-01-29,21,0,43.36673355102539,910.7014045715332,6,1,1,4,32724,4
100106,Toys,38.871063232421875,2023-01-30,60,0,43.36673355102539,2602.0040130615234,0,1,0,5,32784,4
100106,Toys,38.871063232421875,2023-01-31,27,0,43.36673355102539,1170.9018058776855,1,1,0,5,32811,4
100106,Toys,38.871063232421875,2023-02-01,5,0,43.36673355102539,216.83366775512695,2,2,0,5,32816,4
100106,Toys,38.871063232421875,2023-02-02,24,0,43.36673355102539,1040.8016052246094,3,2,0,5,32840,4
100106,Toys,38.871063232421875,2023-02-03,20,0,43.36673355102539,867.3346710205078,4,2,0,5,32860,4
100106,Toys,38.871063232421875,2023-02-04,45,0,43.36673355102539,1951.5030097961426,5,2,1,5,32905,4
100106,Toys,38.871063232421875,2023-02-05,18,0,43.36673355102539,780.601203918457,6,2,1,5,32923,4
100106,Toys,38.871063232421875,2023-02-06,34,0,43.36673355102539,1474.4689407348633,0,2,0,6,32957,4
100106,Toys,38.871063232421875,2023-02-07,41,194,39.015414505004884,8945.9439894104,1,2,0,6,32998,4
100106,Toys,38.871063232421875,2023-02-08,34,0,40.470829010009766,1376.008186340332,2,2,0,6,33032,4
100106,Toys,38.871063232421875,2023-02-09,12,0,40.470829010009766,485.6499481201172,3,2,0,6,33044,4
100106,Toys,38.871063232421875,2023-02-10,4,0,40.470829010009766,161.88331604003906,4,2,0,6,33048,4
100106,Toys,38.871063232421875,2023-02-11,51,0,40.470829010009766,2064.012279510498,5,2,1,6,33099,4
100106,Toys,38.871063232421875,2023-02-12,16,0,40.470829010009766,647.5332641601562,6,2,1,6,33115,4
100106,Toys,38.871063232421875,2023-02-13,42,0,40.470829010009766,1699.7748184204102,0,2,0,7,33157,4
100106,Toys,38.871063232421875,2023-02-14,4,0,40.470829010009766,161.88331604003906,1,2,0,7,33161,4
100106,Toys,38.871063232421875,2023-02-15,61,218,35.824248046875,9777.638261718748,2,2,0,7,33222,4
100106,Toys,38.871063232421875,2023-02-16,40,0,37.20849609375,1488.33984375,3,2,0,7,33262,4
100106,Toys,38.871063232421875,2023-02-17,60,0,37.20849609375,2232.509765625,4,2,0,7,33322,4
100106,Toys,38.871063232421875,2023-02-18,18,0,37.20849609375,669.7529296875,5,2,1,7,33340,4
100106,Toys,38.871063232421875,2023-02-19,27,0,37.20849609375,1004.62939453125,6,2,1,7,33367,4
100106,Toys,38.871063232421875,2023-02-20,45,0,37.20849609375,1674.38232421875,0,2,0,8,33412,4
100106,Toys,38.871063232421875,2023-02-21,21,0,37.20849609375,781.37841796875,1,2,0,8,33433,4
100106,Toys,38.871063232421875,2023-02-22,19,0,37.20849609375,706.96142578125,2,2,0,8,33452,4
100106,Toys,38.871063232421875,2023-02-23,34,141,35.862592926025386,6235.016318969726,3,2,0,8,33486,4
100106,Toys,38.871063232421875,2023-02-24,16,0,36.24518585205078,579.9229736328125,4,2,0,8,33502,4
100106,Toys,38.871063232421875,2023-02-25,32,0,36.24518585205078,1159.845947265625,5,2,1,8,33534,4
100106,Toys,38.871063232421875,2023-02-26,39,149,35.25208885192871,6587.562930450439,6,2,1,8,33573,4
100106,Toys,38.871063232421875,2023-02-27,23,0,35.61417770385742,819.1260871887207,0,2,0,9,33596,4
100106,Toys,38.871063232421875,2023-02-28,35,0,35.61417770385742,1246.4962196350098,1,2,0,9,33631,4
100106,Toys,38.871063232421875,2023-03-01,145,673,43.56058570861816,36228.88985549926,2,3,0,9,33776,4
100106,Toys,38.871063232421875,2023-03-02,78,0,42.43117141723633,3309.6313705444336,3,3,0,9,33854,4
100106,Toys,38.871063232421875,2023-03-04,116,0,42.43117141723633,4922.015884399414,5,3,1,9,33970,4
100106,Toys,38.871063232421875,2023-03-05,82,0,42.43117141723633,3479.356056213379,6,3,1,9,34052,4
100106,Toys,38.871063232421875,2023-03-06,192,574,41.331761245727535,31537.216318359373,0,3,0,10,34244,4
100106,Toys,38.871063232421875,2023-03-07,78,0,41.65352249145508,3248.974754333496,1,3,0,10,34322,4
100106,Toys,38.871063232421875,2023-03-08,68,0,41.65352249145508,2832.4395294189453,2,3,0,10,34390,4
100106,Toys,38.871063232421875,2023-03-09,127,0,41.65352249145508,5289.997356414795,3,3,0,10,34517,4
100106,Toys,38.871063232421875,2023-03-10,73,0,41.65352249145508,3040.7071418762207,4,3,0,10,34590,4
100106,Toys,38.871063232421875,2023-03-11,122,0,41.65352249145508,5081.7297439575195,5,3,1,10,34712,4
100106,Toys,38.871063232421875,2023-03-12,97,0,41.65352249145508,4040.3916816711426,6,3,1,10,34809,4
100106,Toys,38.871063232421875,2023-03-13,35,0,41.65352249145508,1457.8732872009277,0,3,0,11,34844,4
100106,Toys,38.871063232421875,2023-03-14,181,478,40.016779861450196,26268.064309844973,1,3,0,11,35025,4
100106,Toys,38.871063232421875,2023-03-15,37,0,40.36355972290039,1493.4517097473145,2,3,0,11,35062,4
100106,Toys,38.871063232421875,2023-03-16,39,0,40.36355972290039,1574.1788291931152,3,3,0,11,35101,4
100106,Toys,38.871063232421875,2023-03-17,69,0,40.36355972290039,2785.085620880127,4,3,0,11,35170,4
100106,Toys,38.871063232421875,2023-03-18,87,367,39.07211654663086,17609.34827911377,5,3,1,11,35257,4
100106,Toys,38.871063232421875,2023-03-19,88,0,39.53423309326172,3479.0125122070312,6,3,1,11,35345,4
100106,Toys,38.871063232421875,2023-03-20,131,0,39.53423309326172,5178.984535217285,0,3,0,12,35476,4
100106,Toys,38.871063232421875,2023-03-21,70,0,39.53423309326172,2767.3963165283203,1,3,0,12,35546,4
100106,Toys,38.871063232421875,2023-03-22,92,389,46.22730827331543,22910.32472229004,2,3,0,12,35638,4
100106,Toys,38.871063232421875,2023-03-23,85,0,43.95461654663086,3736.142406463623,3,3,0,12,35723,4
100106,Toys,38.871063232421875,2023-03-24,45,0,43.95461654663086,1977.9577445983887,4,3,0,12,35768,4
100106,Toys,38.871063232421875,2023-03-25,203,691,48.033404693603515,43520.922305603024,5,3,1,12,35971,4
100106,Toys,38.871063232421875,2023-03-26,132,0,46.84680938720703,6183.778839111328,6,3,1,12,36103,4
100106,Toys,38.871063232421875,2023-03-27,152,0,46.84680938720703,7120.715026855469,0,3,0,13,36255,4
100106,Toys,38.871063232421875,2023-03-28,173,0,46.84680938720703,8104.498023986816,1,3,0,13,36428,4
100106,Toys,38.871063232421875,2023-03-29,141,540,52.29749977111817,36389.65493545533,2,3,0,13,36569,4
100106,Toys,38.871063232421875,2023-03-30,89,0,50.35499954223633,4481.594959259033,3,3,0,13,36658,4
100106,Toys,38.871063232421875,2023-03-31,130,0,50.35499954223633,6546.149940490723,4,3,0,13,36788,4
100106,Toys,38.871063232421875,2023-04-01,61,0,50.35499954223633,3071.654972076416,5,4,1,13,36849,4
100106,Toys,38.871063232421875,2023-04-02,106,0,50.35499954223633,5337.629951477051,6,4,1,13,36955,4
100106,Toys,38.871063232421875,2023-04-03,117,0,50.35499954223633,5891.53494644165,0,4,0,14,37072,4
100106,Toys,38.871063232421875,2023-04-04,115,0,50.35499954223633,5790.824947357178,1,4,0,14,37187,4
100106,Toys,38.871063232421875,2023-04-05,76,0,50.35499954223633,3826.979965209961,2,4,0,14,37263,4
100106,Toys,38.871063232421875,2023-04-06,132,545,42.5070556640625,28072.2626953125,3,4,0,14,37395,4
100106,Toys,38.871063232421875,2023-04-07,65,0,44.214111328125,2873.917236328125,4,4,0,14,37460,4
100106,Toys,38.871063232421875,2023-04-08,58,0,44.214111328125,2564.41845703125,5,4,1,14,37518,4
100106,Toys,38.871063232421875,2023-04-09,119,0,44.214111328125,5261.479248046875,6,4,1,14,37637,4
100106,Toys,38.871063232421875,2023-04-10,62,0,44.214111328125,2741.27490234375,0,4,0,15,37699,4
100106,Toys,38.871063232421875,2023-04-11,128,478,44.433828353881836,26950.06005859375,1,4,0,15,37827,4
100106,Toys,38.871063232421875,2023-04-12,19,0,44.36765670776367,842.9854774475098,2,4,0,15,37846,4
100106,Toys,38.871063232421875,2023-04-13,12,0,44.36765670776367,532.4118804931641,3,4,0,15,37858,4
100106,Toys,38.871063232421875,2023-04-14,10,0,44.36765670776367,443.6765670776367,4,4,0,15,37868,4
100106,Toys,38.871063232421875,2023-04-15,33,0,44.36765670776367,1464.1326713562012,5,4,1,15,37901,4
100106,Toys,38.871063232421875,2023-04-16,39,0,44.36765670776367,1730.3386116027832,6,4,1,15,37940,4
100106,Toys,38.871063232421875,2023-04-17,6,0,44.36765670776367,266.20594024658203,0,4,0,16,37946,4
100106,Toys,38.871063232421875,2023-04-18,19,0,44.36765670776367,842.9854774475098,1,4,0,16,37965,4
100106,Toys,38.871063232421875,2023-04-19,15,0,44.36765670776367,665.5148506164551,2,4,0,16,37980,4
100106,Toys,38.871063232421875,2023-04-20,77,0,44.36765670776367,3416.3095664978027,3,4,0,16,38057,4
100106,Toys,38.871063232421875,2023-04-21,45,0,44.36765670776367,1996.5445518493652,4,4,0,16,38102,4
100106,Toys,38.871063232421875,2023-04-22,18,0,44.36765670776367,798.6178207397461,5,4,1,16,38120,4
100106,Toys,38.871063232421875,2023-04-23,8,0,44.36765670776367,354.9412536621094,6,4,1,16,38128,4
100106,Toys,38.871063232421875,2023-04-24,51,0,44.36765670776367,2262.7504920959473,0,4,0,17,38179,4
100106,Toys,38.871063232421875,2023-04-25,46,0,44.36765670776367,2040.912208557129,1,4,0,17,38225,4
100106,Toys,38.871063232421875,2023-04-26,28,0,44.36765670776367,1242.2943878173828,2,4,0,17,38253,4
100106,Toys,38.871063232421875,2023-04-27,17,0,44.36765670776367,754.2501640319824,3,4,0,17,38270,4
100106,Toys,38.871063232421875,2023-04-28,12,0,44.36765670776367,532.4118804931641,4,4,0,17,38282,4
100106,Toys,38.871063232421875,2023-04-29,36,0,44.36765670776367,1597.2356414794922,5,4,1,17,38318,4
100106,Toys,38.871063232421875,2023-04-30,25,0,44.36765670776367,1109.1914176940918,6,4,1,17,38343,4
100106,Toys,38.871063232421875,2023-05-01,15,0,44.36765670776367,665.5148506164551,0,5,0,18,38358,4
100106,Toys,38.871063232421875,2023-05-02,13,0,44.36765670776367,576.7795372009277,1,5,0,18,38371,4
100106,Toys,38.871063232421875,2023-05-03,44,0,44.36765670776367,1952.1768951416016,2,5,0,18,38415,4
100106,Toys,38.871063232421875,2023-05-04,32,0,44.36765670776367,1419.7650146484375,3,5,0,18,38447,4
100106,Toys,38.871063232421875,2023-05-05,45,140,32.27057991027832,5583.352191925049,4,5,0,18,38492,4
100106,Toys,38.871063232421875,2023-05-06,34,0,36.34115982055664,1235.5994338989258,5,5,1,18,38526,4
100106,Toys,38.871063232421875,2023-05-07,45,0,36.34115982055664,1635.3521919250488,6,5,1,18,38571,4
100106,Toys,38.871063232421875,2023-05-08,12,0,36.34115982055664,436.0939178466797,0,5,0,19,38583,4
100106,Toys,38.871063232421875,2023-05-09,21,0,36.34115982055664,763.1643562316895,1,5,0,19,38604,4
100106,Toys,38.871063232421875,2023-05-10,40,138,31.476435165405274,5454.194813232422,2,5,0,19,38644,4
100106,Toys,38.871063232421875,2023-05-11,56,0,32.99287033081055,1847.6007385253906,3,5,0,19,38700,4
100106,Toys,38.871063232421875,2023-05-12,15,0,32.99287033081055,494.8930549621582,4,5,0,19,38715,4
100106,Toys,38.871063232421875,2023-05-13,152,463,46.00523178100586,28863.830461425783,5,5,1,19,38867,4
100106,Toys,38.871063232421875,2023-05-16,122,645,44.391595458984376,34078.89929199219,1,5,0,20,38989,4
100106,Toys,38.871063232421875,2023-05-17,90,0,44.33319091796875,3989.9871826171875,2,5,0,20,39079,4
100106,Toys,38.871063232421875,2023-05-18,110,0,44.33319091796875,4876.6510009765625,3,5,0,20,39189,4
100106,Toys,38.871063232421875,2023-05-19,59,0,44.33319091796875,2615.6582641601562,4,5,0,20,39248,4
100106,Toys,38.871063232421875,2023-05-20,124,0,44.33319091796875,5497.315673828125,5,5,1,20,39372,4
100106,Toys,38.871063232421875,2023-05-21,152,0,44.33319091796875,6738.64501953125,6,5,1,20,39524,4
100106,Toys,38.871063232421875,2023-05-22,166,422,46.5633277130127,27578.064800720218,0,5,0,21,39690,4
100106,Toys,38.871063232421875,2023-05-23,110,0,45.78665542602539,5036.532096862793,1,5,0,21,39800,4
100106,Toys,38.871063232421875,2023-05-24,117,0,45.78665542602539,5357.038684844971,2,5,0,21,39917,4
100106,Toys,38.871063232421875,2023-05-25,107,0,45.78665542602539,4899.172130584717,3,5,0,21,40024,4
100106,Toys,38.871063232421875,2023-05-26,100,339,45.22081733703614,19803.943467407225,4,5,0,21,40124,4
100106,Toys,38.871063232421875,2023-05-27,147,0,45.421634674072266,6676.980297088623,5,5,1,21,40271,4
100106,Toys,38.871063232421875,2023-05-28,118,509,42.84721710205078,26549.583236083985,6,5,1,21,40389,4
100106,Toys,38.871063232421875,2023-05-29,24,0,43.65443420410156,1047.7064208984375,0,5,0,22,40413,4
100106,Toys,38.871063232421875,2023-05-30,50,0,43.65443420410156,2182.721710205078,1,5,0,22,40463,4
100106,Toys,38.871063232421875,2023-05-31,97,0,43.65443420410156,4234.480117797852,2,5,0,22,40560,4
100106,Toys,38.871063232421875,2023-06-01,62,0,43.65443420410156,2706.574920654297,3,6,0,22,40622,4
100106,Toys,38.871063232421875,2023-06-02,40,0,43.65443420410156,1746.1773681640625,4,6,0,22,40662,4
100106,Toys,38.871063232421875,2023-06-03,81,0,43.65443420410156,3536.0091705322266,5,6,1,22,40743,4
100106,Toys,38.871063232421875,2023-06-04,100,0,43.65443420410156,4365.443420410156,6,6,1,22,40843,4
100106,Toys,38.871063232421875,2023-06-05,47,0,43.65443420410156,2051.7584075927734,0,6,0,23,40890,4
100106,Toys,38.871063232421875,2023-06-06,82,0,43.65443420410156,3579.663604736328,1,6,0,23,40972,4
100106,Toys,38.871063232421875,2023-06-07,145,538,44.48243446350098,30447.355994415284,2,6,0,23,41117,4
100106,Toys,38.871063232421875,2023-06-08,63,0,44.31486892700195,2791.836742401123,3,6,0,23,41180,4
100106,Toys,38.871063232421875,2023-06-09,65,0,44.31486892700195,2880.466480255127,4,6,0,23,41245,4
100106,Toys,38.871063232421875,2023-06-10,30,0,44.31486892700195,1329.4460678100586,5,6,1,23,41275,4
100106,Toys,38.871063232421875,2023-06-11,128,0,44.31486892700195,5672.30322265625,6,6,1,23,41403,4
100106,Toys,38.871063232421875,2023-06-12,84,0,44.31486892700195,3722.448989868164,0,6,0,24,41487,4
100106,Toys,38.871063232421875,2023-06-13,83,303,42.17290626525879,16124.102440032959,1,6,0,24,41570,4
100106,Toys,38.871063232421875,2023-06-14,100,0,42.87581253051758,4287.581253051758,2,6,0,24,41670,4
100106,Toys,38.871063232421875,2023-06-15,113,457,45.316575088500976,26093.06597000122,3,6,0,24,41783,4
100106,Toys,38.871063232421875,2023-06-16,158,0,44.55315017700195,7039.397727966309,4,6,0,24,41941,4
100106,Toys,38.871063232421875,2023-06-17,145,0,44.55315017700195,6460.206775665283,5,6,1,24,42086,4
100106,Toys,38.871063232421875,2023-06-18,44,0,44.55315017700195,1960.338607788086,6,6,1,24,42130,4
100106,Toys,38.871063232421875,2023-06-19,62,0,44.55315017700195,2762.295310974121,0,6,0,25,42192,4
100106,Toys,38.871063232421875,2023-06-20,132,306,36.188717193603516,15320.181339111328,1,6,0,25,42324,4
100106,Toys,38.871063232421875,2023-06-21,71,0,39.23743438720703,2785.857841491699,2,6,0,25,42395,4
100106,Toys,38.871063232421875,2023-06-22,81,0,39.23743438720703,3178.2321853637695,3,6,0,25,42476,4
100106,Toys,38.871063232421875,2023-06-23,109,499,36.228597717285155,21707.73430236816,4,6,0,25,42585,4
100106,Toys,38.871063232421875,2023-06-24,68,0,37.04719543457031,2519.2092895507812,5,6,1,25,42653,4
100106,Toys,38.871063232421875,2023-06-25,57,0,37.04719543457031,2111.690139770508,6,6,1,25,42710,4
100106,Toys,38.871063232421875,2023-06-26,94,0,37.04719543457031,3482.4363708496094,0,6,0,26,42804,4
100106,Toys,38.871063232421875,2023-06-27,48,0,37.04719543457031,1778.265380859375,1,6,0,26,42852,4
100106,Toys,38.871063232421875,2023-06-28,146,0,37.04719543457031,5408.890533447266,2,6,0,26,42998,4
100106,Toys,38.871063232421875,2023-06-29,73,0,37.04719543457031,2704.445266723633,3,6,0,26,43071,4
100106,Toys,38.871063232421875,2023-06-30,97,278,38.09993133544922,14350.836679077149,4,6,0,26,43168,4
100106,Toys,38.871063232421875,2023-07-01,85,0,37.74986267089844,3208.738327026367,5,7,1,26,43253,4
100106,Toys,38.871063232421875,2023-07-02,95,656,49.5482502746582,38675.92755218506,6,7,1,26,43348,4
100106,Toys,38.871063232421875,2023-07-03,38,0,46.936500549316406,1783.5870208740234,0,7,0,27,43386,4
100106,Toys,38.871063232421875,2023-07-04,86,0,46.936500549316406,4036.539047241211,1,7,0,27,43472,4
100106,Toys,38.871063232421875,2023-07-05,105,0,46.936500549316406,4928.332557678223,2,7,0,27,43577,4
100106,Toys,38.871063232421875,2023-07-06,32,0,46.936500549316406,1501.968017578125,3,7,0,27,43609,4
100106,Toys,38.871063232421875,2023-07-07,120,0,46.936500549316406,5632.380065917969,4,7,0,27,43729,4
100106,Toys,38.871063232421875,2023-07-08,165,0,46.936500549316406,7744.522590637207,5,7,1,27,43894,4
100106,Toys,38.871063232421875,2023-07-09,97,0,46.936500549316406,4552.840553283691,6,7,1,27,43991,4
100106,Toys,38.871063232421875,2023-07-10,87,242,40.345001754760744,12889.880305328368,0,7,0,28,44078,4
100106,Toys,38.871063232421875,2023-07-11,130,0,42.820003509521484,5566.600456237793,1,7,0,28,44208,4
100106,Toys,38.871063232421875,2023-07-12,74,349,43.33081352233887,18372.710401306154,2,7,0,28,44282,4
100106,Toys,38.871063232421875,2023-07-13,47,0,43.171627044677734,2029.0664710998535,3,7,0,28,44329,4
100106,Toys,38.871063232421875,2023-07-14,72,0,43.171627044677734,3108.357147216797,4,7,0,28,44401,4
100106,Toys,38.871063232421875,2023-07-15,53,0,43.171627044677734,2288.09623336792,5,7,1,28,44454,4
100106,Toys,38.871063232421875,2023-07-16,63,0,43.171627044677734,2719.8125038146973,6,7,1,28,44517,4
100106,Toys,38.871063232421875,2023-07-17,71,0,43.171627044677734,3065.185520172119,0,7,0,29,44588,4
100106,Toys,38.871063232421875,2023-07-18,74,0,43.171627044677734,3194.7004013061523,1,7,0,29,44662,4
100106,Toys,38.871063232421875,2023-07-19,74,220,34.553334121704104,9750.853450012208,2,7,0,29,44736,4
100106,Toys,38.871063232421875,2023-07-20,58,0,37.3466682434082,2166.106758117676,3,7,0,29,44794,4
100106,Toys,38.871063232421875,2023-07-21,72,0,37.3466682434082,2688.9601135253906,4,7,0,29,44866,4
100106,Toys,38.871063232421875,2023-07-22,128,324,42.7406485748291,19593.04603515625,5,7,1,29,44994,4
100106,Toys,38.871063232421875,2023-07-23,99,0,41.3412971496582,4092.788417816162,6,7,1,29,45093,4
100106,Toys,38.871063232421875,2023-07-24,0,353,41.34,14593.02,0,7,0,30,45093,4
100106,Toys,38.871063232421875,2023-07-25,141,0,41.34062194824219,5829.027694702148,1,7,0,30,45234,4
100106,Toys,38.871063232421875,2023-07-26,176,571,49.96510063171387,38412.11542236328,2,7,0,30,45410,4
100106,Toys,38.871063232421875,2023-07-27,141,0,47.210201263427734,6656.638378143311,3,7,0,30,45551,4
100106,Toys,38.871063232421875,2023-07-28,147,0,47.210201263427734,6939.899585723877,4,7,0,30,45698,4
100106,Toys,38.871063232421875,2023-07-29,122,0,47.210201263427734,5759.644554138184,5,7,1,30,45820,4
100106,Toys,38.871063232421875,2023-07-30,44,0,47.210201263427734,2077.2488555908203,6,7,1,30,45864,4
100106,Toys,38.871063232421875,2023-07-31,66,0,47.210201263427734,3115.8732833862305,0,7,0,31,45930,4
100106,Toys,38.871063232421875,2023-08-01,189,552,42.844389038085936,31317.759056396484,1,8,0,31,46119,4
100106,Toys,38.871063232421875,2023-08-02,104,0,44.028778076171875,4578.992919921875,2,8,0,31,46223,4
100106,Toys,38.871063232421875,2023-08-03,62,0,44.028778076171875,2729.7842407226562,3,8,0,31,46285,4
100106,Toys,38.871063232421875,2023-08-04,76,0,44.028778076171875,3346.1871337890625,4,8,0,31,46361,4
100106,Toys,38.871063232421875,2023-08-05,113,0,44.028778076171875,4975.251922607422,5,8,1,31,46474,4
100106,Toys,38.871063232421875,2023-08-06,136,0,44.028778076171875,5987.913818359375,6,8,1,31,46610,4
100106,Toys,38.871063232421875,2023-08-07,81,440,42.115555953979495,21775.070064544678,0,8,0,32,46691,4
100106,Toys,38.871063232421875,2023-08-08,63,0,42.581111907958984,2682.610050201416,1,8,0,32,46754,4
100106,Toys,38.871063232421875,2023-08-09,86,0,42.581111907958984,3661.9756240844727,2,8,0,32,46840,4
100106,Toys,38.871063232421875,2023-08-10,107,0,42.581111907958984,4556.178974151611,3,8,0,32,46947,4
100106,Toys,38.871063232421875,2023-08-11,79,0,42.581111907958984,3363.9078407287598,4,8,0,32,47026,4
100106,Toys,38.871063232421875,2023-08-12,144,461,42.64423187255859,25804.758779296873,5,8,1,32,47170,4
100106,Toys,38.871063232421875,2023-08-13,108,0,42.62846374511719,4603.874084472656,6,8,1,32,47278,4
100106,Toys,38.871063232421875,2023-08-14,55,0,42.62846374511719,2344.5655059814453,0,8,0,33,47333,4
100106,Toys,38.871063232421875,2023-08-15,105,0,42.62846374511719,4475.988693237305,1,8,0,33,47438,4
100106,Toys,38.871063232421875,2023-08-16,84,376,42.59178451538086,19588.779798583986,2,8,0,33,47522,4
100106,Toys,38.871063232421875,2023-08-17,91,0,42.60356903076172,3876.9247817993164,3,8,0,33,47613,4
100106,Toys,38.871063232421875,2023-08-18,132,0,42.60356903076172,5623.671112060547,4,8,0,33,47745,4
100106,Toys,38.871063232421875,2023-08-19,211,446,44.31705337524414,29246.246524353028,5,8,1,33,47956,4
100106,Toys,38.871063232421875,2023-08-20,95,0,43.76410675048828,4157.590141296387,6,8,1,33,48051,4
100106,Toys,38.871063232421875,2023-08-21,119,0,43.76410675048828,5207.9287033081055,0,8,0,34,48170,4
100106,Toys,38.871063232421875,2023-08-22,55,0,43.76410675048828,2407.0258712768555,1,8,0,34,48225,4
100106,Toys,38.871063232421875,2023-08-23,54,0,43.76410675048828,2363.261764526367,2,8,0,34,48279,4
100106,Toys,38.871063232421875,2023-08-24,67,0,43.76410675048828,2932.195152282715,3,8,0,34,48346,4
100106,Toys,38.871063232421875,2023-08-25,101,230,39.519809341430665,12878.551486968994,4,8,0,34,48447,4
100106,Toys,38.871063232421875,2023-08-26,43,0,41.08961868286133,1766.853603363037,5,8,1,34,48490,4
100106,Toys,38.871063232421875,2023-08-27,126,453,42.93845794677735,25031.91140258789,6,8,1,34,48616,4
100106,Toys,38.871063232421875,2023-08-28,47,0,42.41691589355469,1993.5950469970703,0,8,0,35,48663,4
100106,Toys,38.871063232421875,2023-08-29,41,0,42.41691589355469,1739.0935516357422,1,8,0,35,48704,4
100106,Toys,38.871063232421875,2023-08-30,119,0,42.41691589355469,5047.612991333008,2,8,0,35,48823,4
100106,Toys,38.871063232421875,2023-08-31,88,0,42.41691589355469,3732.6885986328125,3,8,0,35,48911,4
100106,Toys,38.871063232421875,2023-09-01,78,0,42.41691589355469,3308.5194396972656,4,9,0,35,48989,4
100106,Toys,38.871063232421875,2023-09-02,107,377,42.698080673217774,20687.989264068605,5,9,1,35,49096,4
100106,Toys,38.871063232421875,2023-09-03,54,0,42.61616134643555,2301.2727127075195,6,9,1,35,49150,4
100106,Toys,38.871063232421875,2023-09-04,88,0,42.61616134643555,3750.222198486328,0,9,0,36,49238,4
100106,Toys,38.871063232421875,2023-09-05,60,0,42.61616134643555,2556.969680786133,1,9,0,36,49298,4
100106,Toys,38.871063232421875,2023-09-06,58,0,42.61616134643555,2471.7373580932617,2,9,0,36,49356,4
100106,Toys,38.871063232421875,2023-09-07,83,0,42.61616134643555,3537.1413917541504,3,9,0,36,49439,4
100106,Toys,38.871063232421875,2023-09-08,104,255,39.28642295837402,13944.305975341797,4,9,0,36,49543,4
100106,Toys,38.871063232421875,2023-09-09,83,365,39.88046775817871,17821.197647857665,5,9,1,36,49626,4
100106,Toys,38.871063232421875,2023-09-10,50,0,40.04093551635742,2002.046775817871,6,9,1,36,49676,4
100106,Toys,38.871063232421875,2023-09-11,91,0,40.04093551635742,3643.7251319885254,0,9,0,37,49767,4
100106,Toys,38.871063232421875,2023-09-12,49,0,40.04093551635742,1962.0058403015137,1,9,0,37,49816,4
100106,Toys,38.871063232421875,2023-09-13,74,0,40.04093551635742,2963.029228210449,2,9,0,37,49890,4
100106,Toys,38.871063232421875,2023-09-14,73,0,40.04093551635742,2922.988292694092,3,9,0,37,49963,4
100106,Toys,38.871063232421875,2023-09-15,93,304,41.266351318359376,16474.241345214847,4,9,0,37,50056,4
100106,Toys,38.871063232421875,2023-09-16,54,0,40.83270263671875,2204.9659423828125,5,9,1,37,50110,4
100106,Toys,38.871063232421875,2023-09-17,136,0,40.83270263671875,5553.24755859375,6,9,1,37,50246,4
100106,Toys,38.871063232421875,2023-09-18,46,0,40.83270263671875,1878.3043212890625,0,9,0,38,50292,4
100106,Toys,38.871063232421875,2023-09-19,83,280,38.97070816040039,14016.207554626466,1,9,0,38,50375,4
100106,Toys,38.871063232421875,2023-09-20,86,0,39.63141632080078,3408.301803588867,2,9,0,38,50461,4
100106,Toys,38.871063232421875,2023-09-21,63,0,39.63141632080078,2496.779228210449,3,9,0,38,50524,4
100106,Toys,38.871063232421875,2023-09-22,137,470,44.58052322387695,27513.083363342284,4,9,0,38,50661,4
100106,Toys,38.871063232421875,2023-09-23,117,0,43.221046447753906,5056.862434387207,5,9,1,38,50778,4
100106,Toys,38.871063232421875,2023-09-24,66,0,43.221046447753906,2852.589065551758,6,9,1,38,50844,4
100106,Toys,38.871063232421875,2023-09-25,136,0,43.221046447753906,5878.062316894531,0,9,0,39,50980,4
100106,Toys,38.871063232421875,2023-09-26,95,0,43.221046447753906,4105.999412536621,1,9,0,39,51075,4
100106,Toys,38.871063232421875,2023-09-27,134,477,43.80037101745606,26806.489432678223,2,9,0,39,51209,4
100106,Toys,38.871063232421875,2023-09-28,68,0,43.67074203491211,2969.6104583740234,3,9,0,39,51277,4
100106,Toys,38.871063232421875,2023-09-29,73,0,43.67074203491211,3187.964168548584,4,9,0,39,51350,4
100106,Toys,38.871063232421875,2023-09-30,95,0,43.67074203491211,4148.72049331665,5,9,1,39,51445,4
100106,Toys,38.871063232421875,2023-10-01,105,0,43.67074203491211,4585.4279136657715,6,10,1,39,51550,4
100106,Toys,38.871063232421875,2023-10-02,49,0,43.67074203491211,2139.8663597106934,0,10,0,40,51599,4
100106,Toys,38.871063232421875,2023-10-03,109,239,43.8138005065918,15253.20851043701,1,10,0,40,51708,4
100106,Toys,38.871063232421875,2023-10-04,88,0,43.767601013183594,3851.5488891601562,2,10,0,40,51796,4
100106,Toys,38.871063232421875,2023-10-05,31,205,39.224055252075196,8942.971425628662,3,10,0,40,51827,4
100106,Toys,38.871063232421875,2023-10-06,87,0,41.02811050415039,3569.445613861084,4,10,0,40,51914,4
100106,Toys,38.871063232421875,2023-10-07,22,0,41.02811050415039,902.6184310913086,5,10,1,40,51936,4
100106,Toys,38.871063232421875,2023-10-08,31,0,41.02811050415039,1271.871425628662,6,10,1,40,51967,4
100106,Toys,38.871063232421875,2023-10-09,29,0,41.02811050415039,1189.8152046203613,0,10,0,41,51996,4
100106,Toys,38.871063232421875,2023-10-10,15,0,41.02811050415039,615.4216575622559,1,10,0,41,52011,4
100106,Toys,38.871063232421875,2023-10-11,25,0,41.02811050415039,1025.7027626037598,2,10,0,41,52036,4
100106,Toys,38.871063232421875,2023-10-12,33,0,41.02811050415039,1353.927646636963,3,10,0,41,52069,4
100106,Toys,38.871063232421875,2023-10-13,39,0,41.02811050415039,1600.0963096618652,4,10,0,41,52108,4
100106,Toys,38.871063232421875,2023-10-14,40,0,41.02811050415039,1641.1244201660156,5,10,1,41,52148,4
100106,Toys,38.871063232421875,2023-10-15,25,93,33.519045486450196,3751.9922743225097,6,10,1,41,52173,4
100106,Toys,38.871063232421875,2023-10-16,36,0,36.50809097290039,1314.291275024414,0,10,0,42,52209,4
100106,Toys,38.871063232421875,2023-10-17,35,0,36.50809097290039,1277.7831840515137,1,10,0,42,52244,4
100106,Toys,38.871063232421875,2023-10-18,36,86,29.060609817504883,3392.3639068603516,2,10,0,42,52280,4
100106,Toys,38.871063232421875,2023-10-19,29,153,28.524531478881833,5032.182825775146,3,10,0,42,52309,4
100106,Toys,38.871063232421875,2023-10-20,41,0,29.809062957763672,1222.1715812683105,4,10,0,42,52350,4
100106,Toys,38.871063232421875,2023-10-21,25,0,29.809062957763672,745.2265739440918,5,10,1,42,52375,4
100106,Toys,38.871063232421875,2023-10-22,41,0,29.809062957763672,1222.1715812683105,6,10,1,42,52416,4
100106,Toys,38.871063232421875,2023-10-23,19,0,29.809062957763672,566.3721961975098,0,10,0,43,52435,4
100106,Toys,38.871063232421875,2023-10-24,24,0,29.809062957763672,715.4175109863281,1,10,0,43,52459,4
100106,Toys,38.871063232421875,2023-10-25,98,463,40.83600059509277,23450.656116638183,2,10,0,43,52557,4
100106,Toys,38.871063232421875,2023-10-26,43,0,39.35200119018555,1692.1360511779785,3,10,0,43,52600,4
100106,Toys,38.871063232421875,2023-10-27,3,0,39.35200119018555,118.05600357055664,4,10,0,43,52603,4
100106,Toys,38.871063232421875,2023-10-28,100,373,42.25736099243164,20291.482198486327,5,10,1,43,52703,4
100106,Toys,38.871063232421875,2023-10-29,114,0,41.14472198486328,4690.498306274414,6,10,1,43,52817,4
100106,Toys,38.871063232421875,2023-10-30,75,0,41.14472198486328,3085.854148864746,0,10,0,44,52892,4
100106,Toys,38.871063232421875,2023-10-31,76,0,41.14472198486328,3126.9988708496094,1,10,0,44,52968,4
100106,Toys,38.871063232421875,2023-11-01,98,0,41.14472198486328,4032.1827545166016,2,11,0,44,53066,4
100106,Toys,38.871063232421875,2023-11-02,57,0,41.14472198486328,2345.249153137207,3,11,0,44,53123,4
100106,Toys,38.871063232421875,2023-11-03,69,0,41.14472198486328,2838.9858169555664,4,11,0,44,53192,4
100106,Toys,38.871063232421875,2023-11-04,68,0,41.14472198486328,2797.841094970703,5,11,1,44,53260,4
100106,Toys,38.871063232421875,2023-11-05,87,352,39.11205825805664,17060.998136901857,6,11,1,44,53347,4
100106,Toys,38.871063232421875,2023-11-06,92,0,39.52411651611328,3636.218719482422,0,11,0,45,53439,4
100106,Toys,38.871063232421875,2023-11-08,72,0,39.52411651611328,2845.7363891601562,2,11,0,45,53511,4
100106,Toys,38.871063232421875,2023-11-09,100,392,36.97169151306152,17993.938302612303,3,11,0,45,53611,4
100106,Toys,38.871063232421875,2023-11-10,97,0,37.64338302612305,3651.4081535339355,4,11,0,45,53708,4
100106,Toys,38.871063232421875,2023-11-11,60,0,37.64338302612305,2258.602981567383,5,11,1,45,53768,4
100106,Toys,38.871063232421875,2023-11-12,83,0,37.64338302612305,3124.400791168213,6,11,1,45,53851,4
100106,Toys,38.871063232421875,2023-11-13,77,0,37.64338302612305,2898.5404930114746,0,11,0,46,53928,4
100106,Toys,38.871063232421875,2023-11-14,81,0,37.64338302612305,3049.114025115967,1,11,0,46,54009,4
100106,Toys,38.871063232421875,2023-11-15,99,510,42.912185516357425,26449.09273223877,2,11,0,46,54108,4
100106,Toys,38.871063232421875,2023-11-16,75,0,42.144371032714844,3160.8278274536133,3,11,0,46,54183,4
100106,Toys,38.871063232421875,2023-11-18,22,0,42.144371032714844,927.1761627197266,5,11,1,46,54205,4
100106,Toys,38.871063232421875,2023-11-19,68,0,42.144371032714844,2865.8172302246094,6,11,1,46,54273,4
100106,Toys,38.871063232421875,2023-11-20,97,0,42.144371032714844,4088.00399017334,0,11,0,47,54370,4
100106,Toys,38.871063232421875,2023-11-21,86,401,42.76252243041992,20881.253858032225,1,11,0,47,54456,4
100106,Toys,38.871063232421875,2023-11-22,190,0,42.585044860839844,8091.15852355957,2,11,0,47,54646,4
100106,Toys,38.871063232421875,2023-11-23,47,0,42.585044860839844,2001.4971084594727,3,11,0,47,54693,4
100106,Toys,38.871063232421875,2023-11-24,66,0,42.585044860839844,2810.6129608154297,4,11,0,47,54759,4
100106,Toys,38.871063232421875,2023-11-25,35,0,42.585044860839844,1490.4765701293945,5,11,1,47,54794,4
100106,Toys,38.871063232421875,2023-11-26,73,325,44.010010223388676,17629.381492614746,6,11,1,47,54867,4
100106,Toys,38.871063232421875,2023-11-27,91,0,43.560020446777344,3963.9618606567383,0,11,0,48,54958,4
100106,Toys,38.871063232421875,2023-11-28,69,0,43.560020446777344,3005.6414108276367,1,11,0,48,55027,4
100106,Toys,38.871063232421875,2023-11-29,104,0,43.560020446777344,4530.242126464844,2,11,0,48,55131,4
100106,Toys,38.871063232421875,2023-11-30,64,0,43.560020446777344,2787.84130859375,3,11,0,48,55195,4
100106,Toys,38.871063232421875,2023-12-01,57,209,39.10455551147461,10165.519328308106,4,12,0,48,55252,4
100106,Toys,38.871063232421875,2023-12-02,149,462,45.57746124267578,28293.083450317383,5,12,1,48,55401,4
100106,Toys,38.871063232421875,2023-12-03,18,0,44.15492248535156,794.7886047363281,6,12,1,48,55419,4
100106,Toys,38.871063232421875,2023-12-04,94,0,44.15492248535156,4150.562713623047,0,12,0,49,55513,4
100106,Toys,38.871063232421875,2023-12-05,106,0,44.15492248535156,4680.421783447266,1,12,0,49,55619,4
100106,Toys,38.871063232421875,2023-12-06,200,685,47.567043991088866,42520.21759643555,2,12,0,49,55819,4
100106,Toys,38.871063232421875,2023-12-07,53,0,46.694087982177734,2474.78666305542,3,12,0,49,55872,4
100106,Toys,38.871063232421875,2023-12-08,218,0,46.694087982177734,10179.311180114746,4,12,0,49,56090,4
100106,Toys,38.871063232421875,2023-12-09,90,0,46.694087982177734,4202.467918395996,5,12,1,49,56180,4
100106,Toys,38.871063232421875,2023-12-10,100,0,46.694087982177734,4669.408798217773,6,12,1,49,56280,4
100106,Toys,38.871063232421875,2023-12-11,76,0,46.694087982177734,3548.750686645508,0,12,0,50,56356,4
100106,Toys,38.871063232421875,2023-12-12,97,506,38.8320280456543,22474.183440856934,1,12,0,50,56453,4
100106,Toys,38.871063232421875,2023-12-13,74,0,41.134056091308594,3043.920150756836,2,12,0,50,56527,4
100106,Toys,38.871063232421875,2023-12-14,171,0,41.134056091308594,7033.9235916137695,3,12,0,50,56698,4
100106,Toys,38.871063232421875,2023-12-15,181,0,41.134056091308594,7445.2641525268555,4,12,0,50,56879,4
100106,Toys,38.871063232421875,2023-12-16,82,0,41.134056091308594,3372.9925994873047,5,12,1,50,56961,4
100106,Toys,38.871063232421875,2023-12-17,78,252,40.21637886047363,13209.395102233886,6,12,1,50,57039,4
100106,Toys,38.871063232421875,2023-12-18,124,0,40.572757720947266,5031.021957397461,0,12,0,51,57163,4
100106,Toys,38.871063232421875,2023-12-19,96,0,40.572757720947266,3894.9847412109375,1,12,0,51,57259,4
100106,Toys,38.871063232421875,2023-12-20,70,269,39.19493125915527,13194.560376281737,2,12,0,51,57329,4
100106,Toys,38.871063232421875,2023-12-21,143,0,39.65986251831055,5671.360340118408,3,12,0,51,57472,4
100106,Toys,38.871063232421875,2023-12-22,61,0,39.65986251831055,2419.2516136169434,4,12,0,51,57533,4
100106,Toys,38.871063232421875,2023-12-23,61,0,39.65986251831055,2419.2516136169434,5,12,1,51,57594,4
100106,Toys,38.871063232421875,2023-12-24,59,179,38.40218421936035,9084.25773788452,6,12,1,51,57653,4
100106,Toys,38.871063232421875,2023-12-25,67,366,38.54028388977051,16657.95804122925,0,12,0,52,57720,4
100106,Toys,38.871063232421875,2023-12-26,43,0,38.640567779541016,1661.5444145202637,1,12,0,52,57763,4
100106,Toys,38.871063232421875,2023-12-27,49,0,38.640567779541016,1893.3878211975098,2,12,0,52,57812,4
100106,Toys,38.871063232421875,2023-12-28,37,0,38.640567779541016,1429.7010078430176,3,12,0,52,57849,4
100106,Toys,38.871063232421875,2023-12-29,11,0,38.640567779541016,425.0462455749512,4,12,0,52,57860,4
100106,Toys,38.871063232421875,2023-12-30,20,0,38.640567779541016,772.8113555908203,5,12,1,52,57880,4
100106,Toys,38.871063232421875,2023-12-31,43,0,38.640567779541016,1661.5444145202637,6,12,1,52,57923,4
100106,Toys,38.871063232421875,2024-01-01,18,0,38.640567779541016,695.5302200317383,0,1,0,1,57941,4
100106,Toys,38.871063232421875,2024-01-02,91,0,38.640567779541016,3516.2916679382324,1,1,0,1,58032,4
100106,Toys,38.871063232421875,2024-01-03,26,0,38.640567779541016,1004.6547622680664,2,1,0,1,58058,4
100106,Toys,38.871063232421875,2024-01-04,25,0,38.640567779541016,966.0141944885254,3,1,0,1,58083,4
100106,Toys,38.871063232421875,2024-01-05,16,0,38.640567779541016,618.2490844726562,4,1,0,1,58099,4
100106,Toys,38.871063232421875,2024-01-06,28,0,38.640567779541016,1081.9358978271484,5,1,1,1,58127,4
100106,Toys,38.871063232421875,2024-01-07,34,0,38.640567779541016,1313.7793045043945,6,1,1,1,58161,4
100106,Toys,38.871063232421875,2024-01-08,22,0,38.640567779541016,850.0924911499023,0,1,0,2,58183,4
100106,Toys,38.871063232421875,2024-01-09,72,240,37.65976913452148,11707.886755371093,1,1,0,2,58255,4
100106,Toys,38.871063232421875,2024-01-10,50,0,37.90953826904297,1895.4769134521484,2,1,0,2,58305,4
100106,Toys,38.871063232421875,2024-01-11,42,274,39.29072845458984,12524.741190185547,3,1,0,2,58347,4
100106,Toys,38.871063232421875,2024-01-12,70,0,38.82145690917969,2717.501983642578,4,1,0,2,58417,4
100106,Toys,38.871063232421875,2024-01-13,68,0,38.82145690917969,2639.8590698242188,5,1,1,2,58485,4
100106,Toys,38.871063232421875,2024-01-14,73,0,38.82145690917969,2833.966354370117,6,1,1,2,58558,4
100106,Toys,38.871063232421875,2024-01-15,73,0,38.82145690917969,2833.966354370117,0,1,0,3,58631,4
100106,Toys,38.871063232421875,2024-01-16,57,0,38.82145690917969,2212.823043823242,1,1,0,3,58688,4
100106,Toys,38.871063232421875,2024-01-17,60,143,35.47231338500977,7096.107606201172,2,1,0,3,58748,4
100106,Toys,38.871063232421875,2024-01-18,42,0,36.73462677001953,1542.8543243408203,3,1,0,3,58790,4
100106,Toys,38.871063232421875,2024-01-19,46,0,36.73462677001953,1689.7928314208984,4,1,0,3,58836,4
100106,Toys,38.871063232421875,2024-01-20,95,255,42.83772735595703,15235.168197631836,5,1,1,3,58931,4
100106,Toys,38.871063232421875,2024-01-21,56,0,41.32545471191406,2314.2254638671875,6,1,1,3,58987,4
100106,Toys,38.871063232421875,2024-01-22,17,282,43.267981719970706,13104.611378479003,0,1,0,4,59004,4
100106,Toys,38.871063232421875,2024-01-23,127,0,42.635963439941406,5414.767356872559,1,1,0,4,59131,4
100106,Toys,38.871063232421875,2024-01-24,34,0,42.635963439941406,1449.6227569580078,2,1,0,4,59165,4
100106,Toys,38.871063232421875,2024-01-25,151,528,37.530531616210936,24977.850548095703,3,1,0,4,59316,4
100106,Toys,38.871063232421875,2024-01-26,60,0,38.871063232421875,2332.2637939453125,4,1,0,4,59376,4
100106,Toys,38.871063232421875,2024-01-27,80,0,38.871063232421875,3109.68505859375,5,1,1,4,59456,4
100106,Toys,38.871063232421875,2024-01-28,107,0,38.871063232421875,4159.203765869141,6,1,1,4,59563,4
100106,Toys,38.871063232421875,2024-01-29,70,0,38.871063232421875,2720.9744262695312,0,1,0,5,59633,4
100106,Toys,38.871063232421875,2024-01-30,81,0,38.871063232421875,3148.556121826172,1,1,0,5,59714,4
100107,Groceries,27.601043701171875,2022-01-01,81,453,23.269999275207518,12426.179882583618,5,1,1,52,81,3
100107,Groceries,27.601043701171875,2022-01-02,37,497,26.374545440673828,14472.916362609863,6,1,1,52,118,3
100107,Groceries,27.601043701171875,2022-01-05,97,0,25.529090881347656,2476.3218154907227,2,1,0,1,215,3
100107,Groceries,27.601043701171875,2022-01-06,110,0,25.529090881347656,2808.199996948242,3,1,0,1,325,3
100107,Groceries,27.601043701171875,2022-01-07,87,0,25.529090881347656,2221.030906677246,4,1,0,1,412,3
100107,Groceries,27.601043701171875,2022-01-08,174,650,25.885635490417478,21379.441150665283,5,1,1,1,586,3
100107,Groceries,27.601043701171875,2022-01-09,65,0,25.78127098083496,1675.7826137542725,6,1,1,1,651,3
100107,Groceries,27.601043701171875,2022-01-10,166,0,25.78127098083496,4279.6909828186035,0,1,0,2,817,3
100107,Groceries,27.601043701171875,2022-01-11,133,0,25.78127098083496,3428.90904045105,1,1,0,2,950,3
100107,Groceries,27.601043701171875,2022-01-12,25,0,25.78127098083496,644.531774520874,2,1,0,2,975,3
100107,Groceries,27.601043701171875,2022-01-13,170,730,26.757396125793456,24245.514682769775,3,1,0,2,1145,3
100107,Groceries,27.601043701171875,2022-01-14,176,0,26.464792251586914,4657.803436279297,4,1,0,2,1321,3
100107,Groceries,27.601043701171875,2022-01-15,74,0,26.464792251586914,1958.3946266174316,5,1,1,2,1395,3
100107,Groceries,27.601043701171875,2022-01-16,60,0,26.464792251586914,1587.8875350952148,6,1,1,2,1455,3
100107,Groceries,27.601043701171875,2022-01-17,111,0,26.464792251586914,2937.5919399261475,0,1,0,3,1566,3
100107,Groceries,27.601043701171875,2022-01-18,91,0,26.464792251586914,2408.296094894409,1,1,0,3,1657,3
100107,Groceries,27.601043701171875,2022-01-19,83,0,26.464792251586914,2196.577756881714,2,1,0,3,1740,3
100107,Groceries,27.601043701171875,2022-01-20,100,0,26.464792251586914,2646.4792251586914,3,1,0,3,1840,3
100107,Groceries,27.601043701171875,2022-01-21,248,791,30.24583465576172,31910.953989257814,4,1,0,3,2088,3
100107,Groceries,27.601043701171875,2022-01-22,120,0,29.351669311523438,3522.2003173828125,5,1,1,3,2208,3
100107,Groceries,27.601043701171875,2022-01-23,90,0,29.351669311523438,2641.6502380371094,6,1,1,3,2298,3
100107,Groceries,27.601043701171875,2022-01-24,32,0,29.351669311523438,939.25341796875,0,1,0,4,2330,3
100107,Groceries,27.601043701171875,2022-01-25,174,0,29.351669311523438,5107.190460205078,1,1,0,4,2504,3
100107,Groceries,27.601043701171875,2022-01-26,76,0,29.351669311523438,2230.7268676757812,2,1,0,4,2580,3
100107,Groceries,27.601043701171875,2022-01-27,175,677,28.759155197143556,24417.884319000244,3,1,0,4,2755,3
100107,Groceries,27.601043701171875,2022-01-28,100,0,28.92831039428711,2892.831039428711,4,1,0,4,2855,3
100107,Groceries,27.601043701171875,2022-01-29,106,0,28.92831039428711,3066.4009017944336,5,1,1,4,2961,3
100107,Groceries,27.601043701171875,2022-01-30,51,0,28.92831039428711,1475.3438301086426,6,1,1,4,3012,3
100107,Groceries,27.601043701171875,2022-01-31,170,0,28.92831039428711,4917.812767028809,0,1,0,5,3182,3
100107,Groceries,27.601043701171875,2022-02-01,112,0,28.92831039428711,3239.9707641601562,1,2,0,5,3294,3
100107,Groceries,27.601043701171875,2022-02-02,5,0,28.92831039428711,144.64155197143555,2,2,0,5,3299,3
100107,Groceries,27.601043701171875,2022-02-03,110,0,28.92831039428711,3182.114143371582,3,2,0,5,3409,3
100107,Groceries,27.601043701171875,2022-02-04,119,384,26.025849723815917,12832.40223426819,4,2,0,5,3528,3
100107,Groceries,27.601043701171875,2022-02-05,82,0,27.001699447631836,2214.1393547058105,5,2,1,5,3610,3
100107,Groceries,27.601043701171875,2022-02-06,132,426,26.914875450134275,15008.247118835448,6,2,1,5,3742,3
100107,Groceries,27.601043701171875,2022-02-07,56,0,26.949750900268555,1509.186050415039,0,2,0,6,3798,3
100107,Groceries,27.601043701171875,2022-02-08,53,0,26.949750900268555,1428.3367977142334,1,2,0,6,3851,3
100107,Groceries,27.601043701171875,2022-02-09,128,0,26.949750900268555,3449.568115234375,2,2,0,6,3979,3
100107,Groceries,27.601043701171875,2022-02-10,106,569,27.156428565979006,18364.65285598755,3,2,0,6,4085,3
100107,Groceries,27.601043701171875,2022-02-11,171,0,27.082857131958008,4631.168569564819,4,2,0,6,4256,3
100107,Groceries,27.601043701171875,2022-02-12,97,0,27.082857131958008,2627.0371417999268,5,2,1,6,4353,3
100107,Groceries,27.601043701171875,2022-02-13,61,0,27.082857131958008,1652.0542850494385,6,2,1,6,4414,3
100107,Groceries,27.601043701171875,2022-02-14,84,0,27.082857131958008,2274.9599990844727,0,2,0,7,4498,3
100107,Groceries,27.601043701171875,2022-02-15,118,480,23.34748020172119,13401.605327606201,1,2,0,7,4616,3
100107,Groceries,27.601043701171875,2022-02-16,56,0,24.894960403442383,1394.1177825927734,2,2,0,7,4672,3
100107,Groceries,27.601043701171875,2022-02-17,92,0,24.894960403442383,2290.336357116699,3,2,0,7,4764,3
100107,Groceries,27.601043701171875,2022-02-18,114,0,24.894960403442383,2838.0254859924316,4,2,0,7,4878,3
100107,Groceries,27.601043701171875,2022-02-19,146,0,24.894960403442383,3634.664218902588,5,2,1,7,5024,3
100107,Groceries,27.601043701171875,2022-02-20,208,722,29.290413322448728,27928.631942138672,6,2,1,7,5232,3
100107,Groceries,27.601043701171875,2022-02-21,38,0,27.95082664489746,1062.1314125061035,0,2,0,8,5270,3
100107,Groceries,27.601043701171875,2022-02-22,35,0,27.95082664489746,978.2789325714111,1,2,0,8,5305,3
100107,Groceries,27.601043701171875,2022-02-23,73,0,27.95082664489746,2040.4103450775146,2,2,0,8,5378,3
100107,Groceries,27.601043701171875,2022-02-24,161,0,27.95082664489746,4500.083089828491,3,2,0,8,5539,3
100107,Groceries,27.601043701171875,2022-02-25,128,0,27.95082664489746,3577.705810546875,4,2,0,8,5667,3
100107,Groceries,27.601043701171875,2022-02-26,97,0,27.95082664489746,2711.2301845550537,5,2,1,8,5764,3
100107,Groceries,27.601043701171875,2022-02-27,86,558,25.94326042175293,16370.800792541504,6,2,1,8,5850,3
100107,Groceries,27.601043701171875,2022-02-28,190,0,26.65652084350586,5064.738960266113,0,2,0,9,6040,3
100107,Groceries,27.601043701171875,2022-03-01,111,0,26.65652084350586,2958.8738136291504,1,3,0,9,6151,3
100107,Groceries,27.601043701171875,2022-03-02,102,0,26.65652084350586,2718.9651260375977,2,3,0,9,6253,3
100107,Groceries,27.601043701171875,2022-03-03,183,575,27.18347114562988,20682.110439300537,3,3,0,9,6436,3
100107,Groceries,27.601043701171875,2022-03-04,111,0,26.986942291259766,2995.550594329834,4,3,0,9,6547,3
100107,Groceries,27.601043701171875,2022-03-05,161,0,26.986942291259766,4344.897708892822,5,3,1,9,6708,3
100107,Groceries,27.601043701171875,2022-03-06,85,0,26.986942291259766,2293.89009475708,6,3,1,9,6793,3
100107,Groceries,27.601043701171875,2022-03-07,71,0,26.986942291259766,1916.0729026794434,0,3,0,10,6864,3
100107,Groceries,27.601043701171875,2022-03-08,37,0,26.986942291259766,998.5168647766113,1,3,0,10,6901,3
100107,Groceries,27.601043701171875,2022-03-09,103,0,26.986942291259766,2779.655055999756,2,3,0,10,7004,3
100107,Groceries,27.601043701171875,2022-03-10,112,529,24.693860626220705,15518.574780273437,3,3,0,10,7116,3
100107,Groceries,27.601043701171875,2022-03-11,219,0,25.437721252441406,5570.860954284668,4,3,0,10,7335,3
100107,Groceries,27.601043701171875,2022-03-12,130,0,25.437721252441406,3306.903762817383,5,3,1,10,7465,3
100107,Groceries,27.601043701171875,2022-03-13,47,422,26.435335083007814,12549.921497802734,6,3,1,10,7512,3
100107,Groceries,27.601043701171875,2022-03-14,46,0,26.030670166015625,1197.4108276367188,0,3,0,11,7558,3
100107,Groceries,27.601043701171875,2022-03-15,55,0,26.030670166015625,1431.6868591308594,1,3,0,11,7613,3
100107,Groceries,27.601043701171875,2022-03-16,110,0,26.030670166015625,2863.3737182617188,2,3,0,11,7723,3
100107,Groceries,27.601043701171875,2022-03-17,135,731,30.341358680725097,27139.006843795774,3,3,0,11,7858,3
100107,Groceries,27.601043701171875,2022-03-18,75,0,28.892717361450195,2166.9538021087646,4,3,0,11,7933,3
100107,Groceries,27.601043701171875,2022-03-19,61,0,28.892717361450195,1762.455759048462,5,3,1,11,7994,3
100107,Groceries,27.601043701171875,2022-03-20,190,0,28.892717361450195,5489.616298675537,6,3,1,11,8184,3
100107,Groceries,27.601043701171875,2022-03-21,150,0,28.892717361450195,4333.907604217529,0,3,0,12,8334,3
100107,Groceries,27.601043701171875,2022-03-22,58,0,28.892717361450195,1675.7776069641113,1,3,0,12,8392,3
100107,Groceries,27.601043701171875,2022-03-23,130,0,28.892717361450195,3756.0532569885254,2,3,0,12,8522,3
100107,Groceries,27.601043701171875,2022-03-24,117,770,26.282866592407224,22795.16078262329,3,3,0,12,8639,3
100107,Groceries,27.601043701171875,2022-03-25,77,0,27.075733184814453,2084.831455230713,4,3,0,12,8716,3
100107,Groceries,27.601043701171875,2022-03-26,69,0,27.075733184814453,1868.2255897521973,5,3,1,12,8785,3
100107,Groceries,27.601043701171875,2022-03-27,145,0,27.075733184814453,3925.9813117980957,6,3,1,12,8930,3
100107,Groceries,27.601043701171875,2022-03-28,131,0,27.075733184814453,3546.9210472106934,0,3,0,13,9061,3
100107,Groceries,27.601043701171875,2022-03-29,81,0,27.075733184814453,2193.1343879699707,1,3,0,13,9142,3
100107,Groceries,27.601043701171875,2022-03-30,87,0,27.075733184814453,2355.5887870788574,2,3,0,13,9229,3
100107,Groceries,27.601043701171875,2022-03-31,112,0,27.075733184814453,3032.4821166992188,3,3,0,13,9341,3
100107,Groceries,27.601043701171875,2022-04-01,192,693,29.964255981445312,26967.134296875,4,4,0,13,9533,3
100107,Groceries,27.601043701171875,2022-04-02,80,0,29.068511962890625,2325.48095703125,5,4,1,13,9613,3
100107,Groceries,27.601043701171875,2022-04-03,80,0,29.068511962890625,2325.48095703125,6,4,1,13,9693,3
100107,Groceries,27.601043701171875,2022-04-04,142,0,29.068511962890625,4127.728698730469,0,4,0,14,9835,3
100107,Groceries,27.601043701171875,2022-04-05,83,0,29.068511962890625,2412.686492919922,1,4,0,14,9918,3
100107,Groceries,27.601043701171875,2022-04-06,142,1006,27.296117935180664,30924.57749359131,2,4,0,14,10060,3
100107,Groceries,27.601043701171875,2022-04-07,192,0,27.772235870361328,5332.269287109375,3,4,0,14,10252,3
100107,Groceries,27.601043701171875,2022-04-08,49,0,27.772235870361328,1360.839557647705,4,4,0,14,10301,3
100107,Groceries,27.601043701171875,2022-04-09,129,0,27.772235870361328,3582.6184272766113,5,4,1,14,10430,3
100107,Groceries,27.601043701171875,2022-04-10,156,0,27.772235870361328,4332.468795776367,6,4,1,14,10586,3
100107,Groceries,27.601043701171875,2022-04-11,84,0,27.772235870361328,2332.8678131103516,0,4,0,15,10670,3
100107,Groceries,27.601043701171875,2022-04-12,139,0,27.772235870361328,3860.3407859802246,1,4,0,15,10809,3
100107,Groceries,27.601043701171875,2022-04-13,81,0,27.772235870361328,2249.5511054992676,2,4,0,15,10890,3
100107,Groceries,27.601043701171875,2022-04-14,94,0,27.772235870361328,2610.590171813965,3,4,0,15,10984,3
100107,Groceries,27.601043701171875,2022-04-15,70,0,27.772235870361328,1944.056510925293,4,4,0,15,11054,3
100107,Groceries,27.601043701171875,2022-04-16,81,0,27.772235870361328,2249.5511054992676,5,4,1,15,11135,3
100107,Groceries,27.601043701171875,2022-04-17,42,0,27.772235870361328,1166.4339065551758,6,4,1,15,11177,3
100107,Groceries,27.601043701171875,2022-04-18,71,483,21.78424514770508,11242.72281097412,0,4,0,16,11248,3
100107,Groceries,27.601043701171875,2022-04-19,35,0,23.788490295410156,832.5971603393555,1,4,0,16,11283,3
100107,Groceries,27.601043701171875,2022-04-20,170,1174,30.37877197265625,42607.38247070312,2,4,0,16,11453,3
100107,Groceries,27.601043701171875,2022-04-21,53,0,28.6075439453125,1516.1998291015625,3,4,0,16,11506,3
100107,Groceries,27.601043701171875,2022-04-22,105,0,28.6075439453125,3003.7921142578125,4,4,0,16,11611,3
100107,Groceries,27.601043701171875,2022-04-23,95,0,28.6075439453125,2717.7166748046875,5,4,1,16,11706,3
100107,Groceries,27.601043701171875,2022-04-24,30,0,28.6075439453125,858.226318359375,6,4,1,16,11736,3
100107,Groceries,27.601043701171875,2022-04-25,77,0,28.6075439453125,2202.7808837890625,0,4,0,17,11813,3
100107,Groceries,27.601043701171875,2022-04-26,87,0,28.6075439453125,2488.8563232421875,1,4,0,17,11900,3
100107,Groceries,27.601043701171875,2022-04-27,43,0,28.6075439453125,1230.1243896484375,2,4,0,17,11943,3
100107,Groceries,27.601043701171875,2022-04-28,63,0,28.6075439453125,1802.2752685546875,3,4,0,17,12006,3
100107,Groceries,27.601043701171875,2022-04-29,54,0,28.6075439453125,1544.807373046875,4,4,0,17,12060,3
100107,Groceries,27.601043701171875,2022-04-30,57,0,28.6075439453125,1630.6300048828125,5,4,1,17,12117,3
100107,Groceries,27.601043701171875,2022-05-01,71,0,28.6075439453125,2031.1356201171875,6,5,1,17,12188,3
100107,Groceries,27.601043701171875,2022-05-02,37,0,28.6075439453125,1058.4791259765625,0,5,0,18,12225,3
100107,Groceries,27.601043701171875,2022-05-03,52,0,28.6075439453125,1487.59228515625,1,5,0,18,12277,3
100107,Groceries,27.601043701171875,2022-05-04,75,0,28.6075439453125,2145.5657958984375,2,5,0,18,12352,3
100107,Groceries,27.601043701171875,2022-05-05,66,0,28.6075439453125,1888.097900390625,3,5,0,18,12418,3
100107,Groceries,27.601043701171875,2022-05-06,64,0,28.6075439453125,1830.8828125,4,5,0,18,12482,3
100107,Groceries,27.601043701171875,2022-05-07,64,0,28.6075439453125,1830.8828125,5,5,1,18,12546,3
100107,Groceries,27.601043701171875,2022-05-08,31,0,28.6075439453125,886.8338623046875,6,5,1,18,12577,3
100107,Groceries,27.601043701171875,2022-05-09,75,0,28.6075439453125,2145.5657958984375,0,5,0,19,12652,3
100107,Groceries,27.601043701171875,2022-05-10,91,0,28.6075439453125,2603.2864990234375,1,5,0,19,12743,3
100107,Groceries,27.601043701171875,2022-05-11,145,428,23.932439231872557,13180.557377243042,2,5,0,19,12888,3
100107,Groceries,27.601043701171875,2022-05-12,108,0,25.814878463745117,2788.0068740844727,3,5,0,19,12996,3
100107,Groceries,27.601043701171875,2022-05-13,51,0,25.814878463745117,1316.558801651001,4,5,0,19,13047,3
100107,Groceries,27.601043701171875,2022-05-14,62,0,25.814878463745117,1600.5224647521973,5,5,1,19,13109,3
100107,Groceries,27.601043701171875,2022-05-15,99,746,25.526479454040526,21513.922931900026,6,5,1,19,13208,3
100107,Groceries,27.601043701171875,2022-05-16,51,0,25.612958908081055,1306.2609043121338,0,5,0,20,13259,3
100107,Groceries,27.601043701171875,2022-05-17,33,0,25.612958908081055,845.2276439666748,1,5,0,20,13292,3
100107,Groceries,27.601043701171875,2022-05-18,45,0,25.612958908081055,1152.5831508636475,2,5,0,20,13337,3
100107,Groceries,27.601043701171875,2022-05-19,118,0,25.612958908081055,3022.3291511535645,3,5,0,20,13455,3
100107,Groceries,27.601043701171875,2022-05-20,80,0,25.612958908081055,2049.0367126464844,4,5,0,20,13535,3
100107,Groceries,27.601043701171875,2022-05-21,53,0,25.612958908081055,1357.486822128296,5,5,1,20,13588,3
100107,Groceries,27.601043701171875,2022-05-22,67,0,25.612958908081055,1716.0682468414307,6,5,1,20,13655,3
100107,Groceries,27.601043701171875,2022-05-23,66,0,25.612958908081055,1690.4552879333496,0,5,0,21,13721,3
100107,Groceries,27.601043701171875,2022-05-24,104,0,25.612958908081055,2663.7477264404297,1,5,0,21,13825,3
100107,Groceries,27.601043701171875,2022-05-25,74,0,25.612958908081055,1895.358959197998,2,5,0,21,13899,3
100107,Groceries,27.601043701171875,2022-05-26,61,0,25.612958908081055,1562.3904933929443,3,5,0,21,13960,3
100107,Groceries,27.601043701171875,2022-05-27,112,597,28.223324432373047,20401.574672851562,4,5,0,21,14072,3
100107,Groceries,27.601043701171875,2022-05-28,98,0,27.416648864746094,2686.831588745117,5,5,1,21,14170,3
100107,Groceries,27.601043701171875,2022-05-29,99,0,27.416648864746094,2714.2482376098633,6,5,1,21,14269,3
100107,Groceries,27.601043701171875,2022-05-30,132,0,27.416648864746094,3618.9976501464844,0,5,0,22,14401,3
100107,Groceries,27.601043701171875,2022-05-31,133,0,27.416648864746094,3646.4142990112305,1,5,0,22,14534,3
100107,Groceries,27.601043701171875,2022-06-01,94,0,27.416648864746094,2577.164993286133,2,6,0,22,14628,3
100107,Groceries,27.601043701171875,2022-06-02,115,521,28.528078613281252,18282.678081054688,3,6,0,22,14743,3
100107,Groceries,27.601043701171875,2022-06-03,185,0,28.1861572265625,5214.4390869140625,4,6,0,22,14928,3
100107,Groceries,27.601043701171875,2022-06-04,161,775,32.39220413208008,31109.809730529785,5,6,1,22,15089,3
100107,Groceries,27.601043701171875,2022-06-05,2,0,31.104408264160156,62.20881652832031,6,6,1,22,15091,3
100107,Groceries,27.601043701171875,2022-06-06,58,0,31.104408264160156,1804.055679321289,0,6,0,23,15149,3
100107,Groceries,27.601043701171875,2022-06-07,54,0,31.104408264160156,1679.6380462646484,1,6,0,23,15203,3
100107,Groceries,27.601043701171875,2022-06-08,169,0,31.104408264160156,5256.644996643066,2,6,0,23,15372,3
100107,Groceries,27.601043701171875,2022-06-09,223,0,31.104408264160156,6936.283042907715,3,6,0,23,15595,3
100107,Groceries,27.601043701171875,2022-06-10,116,0,31.104408264160156,3608.111358642578,4,6,0,23,15711,3
100107,Groceries,27.601043701171875,2022-06-11,165,619,29.534478416442873,22903.297877426146,5,6,1,23,15876,3
100107,Groceries,27.601043701171875,2022-06-12,143,0,30.088956832885742,4302.720827102661,6,6,1,23,16019,3
100107,Groceries,27.601043701171875,2022-06-13,78,0,30.088956832885742,2346.938632965088,0,6,0,24,16097,3
100107,Groceries,27.601043701171875,2022-06-14,86,0,30.088956832885742,2587.650287628174,1,6,0,24,16183,3
100107,Groceries,27.601043701171875,2022-06-15,91,0,30.088956832885742,2738.0950717926025,2,6,0,24,16274,3
100107,Groceries,27.601043701171875,2022-06-16,104,0,30.088956832885742,3129.251510620117,3,6,0,24,16378,3
100107,Groceries,27.601043701171875,2022-06-17,112,626,28.785432624816895,21019.836907958987,4,6,0,24,16490,3
100107,Groceries,27.601043701171875,2022-06-18,80,0,29.22086524963379,2337.669219970703,5,6,1,24,16570,3
100107,Groceries,27.601043701171875,2022-06-19,105,0,29.22086524963379,3068.190851211548,6,6,1,24,16675,3
100107,Groceries,27.601043701171875,2022-06-20,112,0,29.22086524963379,3272.7369079589844,0,6,0,25,16787,3
100107,Groceries,27.601043701171875,2022-06-21,92,0,29.22086524963379,2688.3196029663086,1,6,0,25,16879,3
100107,Groceries,27.601043701171875,2022-06-22,110,0,29.22086524963379,3214.295177459717,2,6,0,25,16989,3
100107,Groceries,27.601043701171875,2022-06-23,110,702,29.745273666381834,24250.680206604004,3,6,0,25,17099,3
100107,Groceries,27.601043701171875,2022-06-24,56,0,29.580547332763672,1656.5106506347656,4,6,0,25,17155,3
100107,Groceries,27.601043701171875,2022-06-25,99,0,29.580547332763672,2928.4741859436035,5,6,1,25,17254,3
100107,Groceries,27.601043701171875,2022-06-26,77,0,29.580547332763672,2277.7021446228027,6,6,1,25,17331,3
100107,Groceries,27.601043701171875,2022-06-27,197,0,29.580547332763672,5827.367824554443,0,6,0,26,17528,3
100107,Groceries,27.601043701171875,2022-06-28,92,0,29.580547332763672,2721.410354614258,1,6,0,26,17620,3
100107,Groceries,27.601043701171875,2022-06-29,90,0,29.580547332763672,2662.2492599487305,2,6,0,26,17710,3
100107,Groceries,27.601043701171875,2022-06-30,24,0,29.580547332763672,709.9331359863281,3,6,0,26,17734,3
100107,Groceries,27.601043701171875,2022-07-01,22,0,29.580547332763672,650.7720413208008,4,7,0,26,17756,3
100107,Groceries,27.601043701171875,2022-07-02,105,0,29.580547332763672,3105.9574699401855,5,7,1,26,17861,3
100107,Groceries,27.601043701171875,2022-07-03,50,0,29.580547332763672,1479.0273666381836,6,7,1,26,17911,3
100107,Groceries,27.601043701171875,2022-07-04,88,330,24.88427677154541,9957.732711791992,0,7,0,27,17999,3
100107,Groceries,27.601043701171875,2022-07-05,59,0,26.71855354309082,1576.3946590423584,1,7,0,27,18058,3
100107,Groceries,27.601043701171875,2022-07-06,110,0,26.71855354309082,2939.0408897399902,2,7,0,27,18168,3
100107,Groceries,27.601043701171875,2022-07-07,73,0,26.71855354309082,1950.4544086456299,3,7,0,27,18241,3
100107,Groceries,27.601043701171875,2022-07-08,59,410,26.2048250579834,12228.699356842042,4,7,0,27,18300,3
100107,Groceries,27.601043701171875,2022-07-09,100,0,26.379650115966797,2637.9650115966797,5,7,1,27,18400,3
100107,Groceries,27.601043701171875,2022-07-10,80,0,26.379650115966797,2110.3720092773438,6,7,1,27,18480,3
100107,Groceries,27.601043701171875,2022-07-11,104,0,26.379650115966797,2743.483612060547,0,7,0,28,18584,3
100107,Groceries,27.601043701171875,2022-07-12,95,0,26.379650115966797,2506.0667610168457,1,7,0,28,18679,3
100107,Groceries,27.601043701171875,2022-07-13,103,605,23.482906112670896,16268.018659210205,2,7,0,28,18782,3
100107,Groceries,27.601043701171875,2022-07-14,36,0,24.195812225341797,871.0492401123047,3,7,0,28,18818,3
100107,Groceries,27.601043701171875,2022-07-15,144,0,24.195812225341797,3484.1969604492188,4,7,0,28,18962,3
100107,Groceries,27.601043701171875,2022-07-16,112,0,24.195812225341797,2709.9309692382812,5,7,1,28,19074,3
100107,Groceries,27.601043701171875,2022-07-17,72,0,24.195812225341797,1742.0984802246094,6,7,1,28,19146,3
100107,Groceries,27.601043701171875,2022-07-18,102,0,24.195812225341797,2467.9728469848633,0,7,0,29,19248,3
100107,Groceries,27.601043701171875,2022-07-19,61,0,24.195812225341797,1475.9445457458496,1,7,0,29,19309,3
100107,Groceries,27.601043701171875,2022-07-20,63,300,23.228843383789062,8344.654266357422,2,7,0,29,19372,3
100107,Groceries,27.601043701171875,2022-07-21,37,0,23.597686767578125,873.1144104003906,3,7,0,29,19409,3
100107,Groceries,27.601043701171875,2022-07-22,90,0,23.597686767578125,2123.7918090820312,4,7,0,29,19499,3
100107,Groceries,27.601043701171875,2022-07-23,92,0,23.597686767578125,2170.9871826171875,5,7,1,29,19591,3
100107,Groceries,27.601043701171875,2022-07-24,109,595,26.039584465026856,18623.669413375857,6,7,1,29,19700,3
100107,Groceries,27.601043701171875,2022-07-25,163,0,25.43916893005371,4146.584535598755,0,7,0,30,19863,3
100107,Groceries,27.601043701171875,2022-07-26,116,1015,30.315187492370605,35423.54349822998,1,7,0,30,19979,3
100107,Groceries,27.601043701171875,2022-07-28,89,0,29.05037498474121,2585.483373641968,3,7,0,30,20068,3
100107,Groceries,27.601043701171875,2022-07-29,70,0,29.05037498474121,2033.5262489318848,4,7,0,30,20138,3
100107,Groceries,27.601043701171875,2022-07-30,68,0,29.05037498474121,1975.4254989624023,5,7,1,30,20206,3
100107,Groceries,27.601043701171875,2022-07-31,234,0,29.05037498474121,6797.787746429443,6,7,1,30,20440,3
100107,Groceries,27.601043701171875,2022-08-01,43,0,29.05037498474121,1249.166124343872,0,8,0,31,20483,3
100107,Groceries,27.601043701171875,2022-08-02,130,0,29.05037498474121,3776.5487480163574,1,8,0,31,20613,3
100107,Groceries,27.601043701171875,2022-08-03,135,0,29.05037498474121,3921.8006229400635,2,8,0,31,20748,3
100107,Groceries,27.601043701171875,2022-08-04,100,0,29.05037498474121,2905.037498474121,3,8,0,31,20848,3
100107,Groceries,27.601043701171875,2022-08-05,146,0,29.05037498474121,4241.354747772217,4,8,0,31,20994,3
100107,Groceries,27.601043701171875,2022-08-06,60,0,29.05037498474121,1743.0224990844727,5,8,1,31,21054,3
100107,Groceries,27.601043701171875,2022-08-07,125,617,29.602899322509764,22047.56483062744,6,8,1,31,21179,3
100107,Groceries,27.601043701171875,2022-08-08,173,0,29.43579864501953,5092.393165588379,0,8,0,32,21352,3
100107,Groceries,27.601043701171875,2022-08-09,189,0,29.43579864501953,5563.365943908691,1,8,0,32,21541,3
100107,Groceries,27.601043701171875,2022-08-10,48,0,29.43579864501953,1412.9183349609375,2,8,0,32,21589,3
100107,Groceries,27.601043701171875,2022-08-11,78,0,29.43579864501953,2295.9922943115234,3,8,0,32,21667,3
100107,Groceries,27.601043701171875,2022-08-12,168,792,30.34832290649414,29278.95649658203,4,8,0,32,21835,3
100107,Groceries,27.601043701171875,2022-08-13,119,0,30.11664581298828,3583.8808517456055,5,8,1,32,21954,3
100107,Groceries,27.601043701171875,2022-08-14,124,0,30.11664581298828,3734.464080810547,6,8,1,32,22078,3
100107,Groceries,27.601043701171875,2022-08-15,128,0,30.11664581298828,3854.9306640625,0,8,0,33,22206,3
100107,Groceries,27.601043701171875,2022-08-16,106,0,30.11664581298828,3192.364456176758,1,8,0,33,22312,3
100107,Groceries,27.601043701171875,2022-08-17,147,836,32.5980874633789,32541.3177142334,2,8,0,33,22459,3
100107,Groceries,27.601043701171875,2022-08-18,91,0,31.876174926757812,2900.731918334961,3,8,0,33,22550,3
100107,Groceries,27.601043701171875,2022-08-19,92,0,31.876174926757812,2932.6080932617188,4,8,0,33,22642,3
100107,Groceries,27.601043701171875,2022-08-20,107,0,31.876174926757812,3410.750717163086,5,8,1,33,22749,3
100107,Groceries,27.601043701171875,2022-08-21,174,0,31.876174926757812,5546.454437255859,6,8,1,33,22923,3
100107,Groceries,27.601043701171875,2022-08-22,85,0,31.876174926757812,2709.474868774414,0,8,0,34,23008,3
100107,Groceries,27.601043701171875,2022-08-23,49,0,31.876174926757812,1561.9325714111328,1,8,0,34,23057,3
100107,Groceries,27.601043701171875,2022-08-24,140,0,31.876174926757812,4462.664489746094,2,8,0,34,23197,3
100107,Groceries,27.601043701171875,2022-08-25,128,652,30.87768497467041,23912.887353515627,3,8,0,34,23325,3
100107,Groceries,27.601043701171875,2022-08-26,118,0,31.20536994934082,3682.233654022217,4,8,0,34,23443,3
100107,Groceries,27.601043701171875,2022-08-27,213,0,31.20536994934082,6646.743799209595,5,8,1,34,23656,3
100107,Groceries,27.601043701171875,2022-08-28,148,0,31.20536994934082,4618.394752502441,6,8,1,34,23804,3
100107,Groceries,27.601043701171875,2022-08-29,110,0,31.20536994934082,3432.5906944274902,0,8,0,35,23914,3
100107,Groceries,27.601043701171875,2022-08-30,78,0,31.20536994934082,2434.018856048584,1,8,0,35,23992,3
100107,Groceries,27.601043701171875,2022-08-31,107,449,25.798734130859373,13687.889104003905,2,8,0,35,24099,3
100107,Groceries,27.601043701171875,2022-09-01,68,0,27.71746826171875,1884.787841796875,3,9,0,35,24167,3
100107,Groceries,27.601043701171875,2022-09-02,38,0,27.71746826171875,1053.2637939453125,4,9,0,35,24205,3
100107,Groceries,27.601043701171875,2022-09-03,178,0,27.71746826171875,4933.7093505859375,5,9,1,35,24383,3
100107,Groceries,27.601043701171875,2022-09-04,168,1204,29.835092773437502,41342.871171875,6,9,1,35,24551,3
100107,Groceries,27.601043701171875,2022-09-05,41,0,29.440185546875,1207.047607421875,0,9,0,36,24592,3
100107,Groceries,27.601043701171875,2022-09-06,166,0,29.440185546875,4887.07080078125,1,9,0,36,24758,3
100107,Groceries,27.601043701171875,2022-09-07,134,0,29.440185546875,3944.98486328125,2,9,0,36,24892,3
100107,Groceries,27.601043701171875,2022-09-08,68,0,29.440185546875,2001.9326171875,3,9,0,36,24960,3
100107,Groceries,27.601043701171875,2022-09-09,97,0,29.440185546875,2855.697998046875,4,9,0,36,25057,3
100107,Groceries,27.601043701171875,2022-09-10,216,0,29.440185546875,6359.080078125,5,9,1,36,25273,3
100107,Groceries,27.601043701171875,2022-09-11,104,0,29.440185546875,3061.779296875,6,9,1,36,25377,3
100107,Groceries,27.601043701171875,2022-09-12,93,0,29.440185546875,2737.937255859375,0,9,0,37,25470,3
100107,Groceries,27.601043701171875,2022-09-13,47,0,29.440185546875,1383.688720703125,1,9,0,37,25517,3
100107,Groceries,27.601043701171875,2022-09-14,51,0,29.440185546875,1501.449462890625,2,9,0,37,25568,3
100107,Groceries,27.601043701171875,2022-09-15,68,0,29.440185546875,2001.9326171875,3,9,0,37,25636,3
100107,Groceries,27.601043701171875,2022-09-16,188,755,25.151611366271972,23110.36587371826,4,9,0,37,25824,3
100107,Groceries,27.601043701171875,2022-09-17,125,0,26.223222732543945,3277.902841567993,5,9,1,37,25949,3
100107,Groceries,27.601043701171875,2022-09-18,95,0,26.223222732543945,2491.206159591675,6,9,1,37,26044,3
100107,Groceries,27.601043701171875,2022-09-19,95,0,26.223222732543945,2491.206159591675,0,9,0,38,26139,3
100107,Groceries,27.601043701171875,2022-09-20,98,0,26.223222732543945,2569.8758277893066,1,9,0,38,26237,3
100107,Groceries,27.601043701171875,2022-09-21,152,0,26.223222732543945,3985.9298553466797,2,9,0,38,26389,3
100107,Groceries,27.601043701171875,2022-09-22,58,0,26.223222732543945,1520.9469184875488,3,9,0,38,26447,3
100107,Groceries,27.601043701171875,2022-09-23,155,521,27.52054317474365,18746.428384170533,4,9,0,38,26602,3
100107,Groceries,27.601043701171875,2022-09-24,160,0,27.131086349487305,4340.973815917969,5,9,1,38,26762,3
100107,Groceries,27.601043701171875,2022-09-25,109,0,27.131086349487305,2957.288412094116,6,9,1,38,26871,3
100107,Groceries,27.601043701171875,2022-09-26,23,774,31.19359302520752,25654.655279159546,0,9,0,39,26894,3
100107,Groceries,27.601043701171875,2022-09-27,103,0,30.13718605041504,3104.130163192749,1,9,0,39,26997,3
100107,Groceries,27.601043701171875,2022-09-28,40,0,30.13718605041504,1205.4874420166016,2,9,0,39,27037,3
100107,Groceries,27.601043701171875,2022-09-29,84,0,30.13718605041504,2531.5236282348633,3,9,0,39,27121,3
100107,Groceries,27.601043701171875,2022-09-30,124,0,30.13718605041504,3737.011070251465,4,9,0,39,27245,3
100107,Groceries,27.601043701171875,2022-10-01,140,0,30.13718605041504,4219.2060470581055,5,10,1,39,27385,3
100107,Groceries,27.601043701171875,2022-10-02,141,0,30.13718605041504,4249.3432331085205,6,10,1,39,27526,3
100107,Groceries,27.601043701171875,2022-10-03,137,641,27.491757316589357,20934.101504745482,0,10,0,40,27663,3
100107,Groceries,27.601043701171875,2022-10-04,68,0,28.39351463317871,1930.7589950561523,1,10,0,40,27731,3
100107,Groceries,27.601043701171875,2022-10-05,54,0,28.39351463317871,1533.2497901916504,2,10,0,40,27785,3
100107,Groceries,27.601043701171875,2022-10-06,100,0,28.39351463317871,2839.351463317871,3,10,0,40,27885,3
100107,Groceries,27.601043701171875,2022-10-07,85,0,28.39351463317871,2413.4487438201904,4,10,0,40,27970,3
100107,Groceries,27.601043701171875,2022-10-08,118,0,28.39351463317871,3350.434726715088,5,10,1,40,28088,3
100107,Groceries,27.601043701171875,2022-10-09,61,0,28.39351463317871,1732.0043926239014,6,10,1,40,28149,3
100107,Groceries,27.601043701171875,2022-10-10,146,649,28.844730377197266,23009.6612701416,0,10,0,41,28295,3
100107,Groceries,27.601043701171875,2022-10-11,103,0,28.68946075439453,2955.0144577026367,1,10,0,41,28398,3
100107,Groceries,27.601043701171875,2022-10-12,157,0,28.68946075439453,4504.245338439941,2,10,0,41,28555,3
100107,Groceries,27.601043701171875,2022-10-13,92,0,28.68946075439453,2639.430389404297,3,10,0,41,28647,3
100107,Groceries,27.601043701171875,2022-10-14,114,0,28.68946075439453,3270.5985260009766,4,10,0,41,28761,3
100107,Groceries,27.601043701171875,2022-10-15,94,0,28.68946075439453,2696.809310913086,5,10,1,41,28855,3
100107,Groceries,27.601043701171875,2022-10-16,99,0,28.68946075439453,2840.2566146850586,6,10,1,41,28954,3
100107,Groceries,27.601043701171875,2022-10-17,83,468,25.37207778930664,13521.064913024902,0,10,0,42,29037,3
100107,Groceries,27.601043701171875,2022-10-18,202,0,26.56415557861328,5365.959426879883,1,10,0,42,29239,3
100107,Groceries,27.601043701171875,2022-10-19,63,0,26.56415557861328,1673.5418014526367,2,10,0,42,29302,3
100107,Groceries,27.601043701171875,2022-10-20,85,0,26.56415557861328,2257.953224182129,3,10,0,42,29387,3
100107,Groceries,27.601043701171875,2022-10-21,82,0,26.56415557861328,2178.260757446289,4,10,0,42,29469,3
100107,Groceries,27.601043701171875,2022-10-22,107,0,26.56415557861328,2842.364646911621,5,10,1,42,29576,3
100107,Groceries,27.601043701171875,2022-10-23,289,924,29.276514282226564,35800.37525512696,6,10,1,42,29865,3
100107,Groceries,27.601043701171875,2022-10-24,82,0,28.823028564453125,2363.4883422851562,0,10,0,43,29947,3
100107,Groceries,27.601043701171875,2022-10-27,70,0,28.823028564453125,2017.6119995117188,3,10,0,43,30017,3
100107,Groceries,27.601043701171875,2022-10-28,148,0,28.823028564453125,4265.8082275390625,4,10,0,43,30165,3
100107,Groceries,27.601043701171875,2022-10-29,135,657,32.09605895996094,26017.215919189453,5,10,1,43,30300,3
100107,Groceries,27.601043701171875,2022-10-30,51,0,30.952117919921875,1578.5580139160156,6,10,1,43,30351,3
100107,Groceries,27.601043701171875,2022-10-31,57,0,30.952117919921875,1764.2707214355469,0,10,0,44,30408,3
100107,Groceries,27.601043701171875,2022-11-01,155,0,30.952117919921875,4797.578277587891,1,11,0,44,30563,3
100107,Groceries,27.601043701171875,2022-11-02,60,0,30.952117919921875,1857.1270751953125,2,11,0,44,30623,3
100107,Groceries,27.601043701171875,2022-11-03,89,0,30.952117919921875,2754.738494873047,3,11,0,44,30712,3
100107,Groceries,27.601043701171875,2022-11-04,187,826,32.42351062774658,33155.88297477722,4,11,0,44,30899,3
100107,Groceries,27.601043701171875,2022-11-05,94,0,31.937021255493164,3002.0799980163574,5,11,1,44,30993,3
100107,Groceries,27.601043701171875,2022-11-06,79,0,31.937021255493164,2523.02467918396,6,11,1,44,31072,3
100107,Groceries,27.601043701171875,2022-11-07,75,0,31.937021255493164,2395.2765941619873,0,11,0,45,31147,3
100107,Groceries,27.601043701171875,2022-11-08,113,0,31.937021255493164,3608.8834018707275,1,11,0,45,31260,3
100107,Groceries,27.601043701171875,2022-11-09,89,0,31.937021255493164,2842.3948917388916,2,11,0,45,31349,3
100107,Groceries,27.601043701171875,2022-11-10,59,0,31.937021255493164,1884.2842540740967,3,11,0,45,31408,3
100107,Groceries,27.601043701171875,2022-11-11,96,0,31.937021255493164,3065.9540405273438,4,11,0,45,31504,3
100107,Groceries,27.601043701171875,2022-11-12,224,783,31.857852973937987,32065.288132324218,5,11,1,45,31728,3
100107,Groceries,27.601043701171875,2022-11-13,101,0,31.885705947875977,3220.4563007354736,6,11,1,45,31829,3
100107,Groceries,27.601043701171875,2022-11-14,55,0,31.885705947875977,1753.7138271331787,0,11,0,46,31884,3
100107,Groceries,27.601043701171875,2022-11-15,157,0,31.885705947875977,5006.055833816528,1,11,0,46,32041,3
100107,Groceries,27.601043701171875,2022-11-16,184,0,31.885705947875977,5866.96989440918,2,11,0,46,32225,3
100107,Groceries,27.601043701171875,2022-11-17,70,0,31.885705947875977,2231.9994163513184,3,11,0,46,32295,3
100107,Groceries,27.601043701171875,2022-11-18,100,0,31.885705947875977,3188.5705947875977,4,11,0,46,32395,3
100107,Groceries,27.601043701171875,2022-11-19,142,0,31.885705947875977,4527.770244598389,5,11,1,46,32537,3
100107,Groceries,27.601043701171875,2022-11-20,116,0,31.885705947875977,3698.7418899536133,6,11,1,46,32653,3
100107,Groceries,27.601043701171875,2022-11-21,84,446,25.867033004760742,12943.161544799805,0,11,0,47,32737,3
100107,Groceries,27.601043701171875,2022-11-22,70,0,27.984066009521484,1958.884620666504,1,11,0,47,32807,3
100107,Groceries,27.601043701171875,2022-11-23,122,0,27.984066009521484,3414.056053161621,2,11,0,47,32929,3
100107,Groceries,27.601043701171875,2022-11-24,199,892,30.362089157104492,33567.11148452759,3,11,0,47,33128,3
100107,Groceries,27.601043701171875,2022-11-25,79,0,29.724178314208984,2348.2100868225098,4,11,0,47,33207,3
100107,Groceries,27.601043701171875,2022-11-26,177,0,29.724178314208984,5261.17956161499,5,11,1,47,33384,3
100107,Groceries,27.601043701171875,2022-11-27,111,0,29.724178314208984,3299.3837928771973,6,11,1,47,33495,3
100107,Groceries,27.601043701171875,2022-11-28,74,0,29.724178314208984,2199.589195251465,0,11,0,48,33569,3
100107,Groceries,27.601043701171875,2022-11-29,47,0,29.724178314208984,1397.0363807678223,1,11,0,48,33616,3
100107,Groceries,27.601043701171875,2022-11-30,174,0,29.724178314208984,5172.007026672363,2,11,0,48,33790,3
100107,Groceries,27.601043701171875,2022-12-01,77,0,29.724178314208984,2288.761730194092,3,12,0,48,33867,3
100107,Groceries,27.601043701171875,2022-12-02,162,777,27.86331455230713,25841.81391494751,4,12,0,48,34029,3
100107,Groceries,27.601043701171875,2022-12-03,95,0,28.386629104614258,2696.7297649383545,5,12,1,48,34124,3
100107,Groceries,27.601043701171875,2022-12-04,161,0,28.386629104614258,4570.2472858428955,6,12,1,48,34285,3
100107,Groceries,27.601043701171875,2022-12-05,187,0,28.386629104614258,5308.299642562866,0,12,0,49,34472,3
100107,Groceries,27.601043701171875,2022-12-06,195,0,28.386629104614258,5535.39267539978,1,12,0,49,34667,3
100107,Groceries,27.601043701171875,2022-12-07,127,0,28.386629104614258,3605.1018962860107,2,12,0,49,34794,3
100107,Groceries,27.601043701171875,2022-12-08,132,461,25.926482849121093,15105.781472167968,3,12,0,49,34926,3
100107,Groceries,27.601043701171875,2022-12-09,113,0,26.742965698242188,3021.955123901367,4,12,0,49,35039,3
100107,Groceries,27.601043701171875,2022-12-10,185,610,28.820637969970704,23226.63604888916,5,12,1,49,35224,3
100107,Groceries,27.601043701171875,2022-12-11,28,0,28.081275939941406,786.2757263183594,6,12,1,49,35252,3
100107,Groceries,27.601043701171875,2022-12-12,100,0,28.081275939941406,2808.1275939941406,0,12,0,50,35352,3
100107,Groceries,27.601043701171875,2022-12-13,134,0,28.081275939941406,3762.8909759521484,1,12,0,50,35486,3
100107,Groceries,27.601043701171875,2022-12-14,158,839,27.88524070739746,27757.156063537597,2,12,0,50,35644,3
100107,Groceries,27.601043701171875,2022-12-15,126,0,27.950481414794922,3521.76065826416,3,12,0,50,35770,3
100107,Groceries,27.601043701171875,2022-12-16,109,0,27.950481414794922,3046.6024742126465,4,12,0,50,35879,3
100107,Groceries,27.601043701171875,2022-12-17,132,0,27.950481414794922,3689.4635467529297,5,12,1,50,36011,3
100107,Groceries,27.601043701171875,2022-12-18,339,1091,31.005126266479493,45130.595608673095,6,12,1,50,36350,3
100107,Groceries,27.601043701171875,2022-12-19,86,0,29.950252532958984,2575.7217178344727,0,12,0,51,36436,3
100107,Groceries,27.601043701171875,2022-12-20,140,0,29.950252532958984,4193.035354614258,1,12,0,51,36576,3
100107,Groceries,27.601043701171875,2022-12-21,187,0,29.950252532958984,5600.69722366333,2,12,0,51,36763,3
100107,Groceries,27.601043701171875,2022-12-22,181,0,29.950252532958984,5420.995708465576,3,12,0,51,36944,3
100107,Groceries,27.601043701171875,2022-12-23,135,0,29.950252532958984,4043.284091949463,4,12,0,51,37079,3
100107,Groceries,27.601043701171875,2022-12-24,175,0,29.950252532958984,5241.294193267822,5,12,1,51,37254,3
100107,Groceries,27.601043701171875,2022-12-25,80,0,29.950252532958984,2396.0202026367188,6,12,1,51,37334,3
100107,Groceries,27.601043701171875,2022-12-26,97,0,29.950252532958984,2905.1744956970215,0,12,0,52,37431,3
100107,Groceries,27.601043701171875,2022-12-27,94,0,29.950252532958984,2815.3237380981445,1,12,0,52,37525,3
100107,Groceries,27.601043701171875,2022-12-28,182,710,32.55664226531982,29506.937784576414,2,12,0,52,37707,3
100107,Groceries,27.601043701171875,2022-12-29,91,0,31.67328453063965,2882.268892288208,3,12,0,52,37798,3
100107,Groceries,27.601043701171875,2022-12-30,27,0,31.67328453063965,855.1786823272705,4,12,0,52,37825,3
100107,Groceries,27.601043701171875,2022-12-31,109,0,31.67328453063965,3452.3880138397217,5,12,1,52,37934,3
100107,Groceries,27.601043701171875,2023-01-01,164,0,31.67328453063965,5194.418663024902,6,1,1,52,38098,3
100107,Groceries,27.601043701171875,2023-01-02,82,0,31.67328453063965,2597.209331512451,0,1,0,1,38180,3
100107,Groceries,27.601043701171875,2023-01-03,77,0,31.67328453063965,2438.842908859253,1,1,0,1,38257,3
100107,Groceries,27.601043701171875,2023-01-04,115,0,31.67328453063965,3642.4277210235596,2,1,0,1,38372,3
100107,Groceries,27.601043701171875,2023-01-05,11,0,31.67328453063965,348.40612983703613,3,1,0,1,38383,3
100107,Groceries,27.601043701171875,2023-01-06,109,0,31.67328453063965,3452.3880138397217,4,1,0,1,38492,3
100107,Groceries,27.601043701171875,2023-01-07,114,415,25.606391983032225,12884.667372131347,5,1,1,1,38606,3
100107,Groceries,27.601043701171875,2023-01-08,117,0,27.802783966064453,3252.925724029541,6,1,1,1,38723,3
100107,Groceries,27.601043701171875,2023-01-09,120,0,27.802783966064453,3336.3340759277344,0,1,0,2,38843,3
100107,Groceries,27.601043701171875,2023-01-10,120,600,27.49492950439453,19750.783081054688,1,1,0,2,38963,3
100107,Groceries,27.601043701171875,2023-01-11,108,0,27.589859008789062,2979.7047729492188,2,1,0,2,39071,3
100107,Groceries,27.601043701171875,2023-01-12,98,0,27.589859008789062,2703.806182861328,3,1,0,2,39169,3
100107,Groceries,27.601043701171875,2023-01-13,115,0,27.589859008789062,3172.833786010742,4,1,0,2,39284,3
100107,Groceries,27.601043701171875,2023-01-14,166,0,27.589859008789062,4579.916595458984,5,1,1,2,39450,3
100107,Groceries,27.601043701171875,2023-01-15,62,0,27.589859008789062,1710.5712585449219,6,1,1,2,39512,3
100107,Groceries,27.601043701171875,2023-01-16,93,591,29.952049789428713,20819.841260833742,0,1,0,3,39605,3
100107,Groceries,27.601043701171875,2023-01-17,99,0,29.284099578857422,2899.1258583068848,1,1,0,3,39704,3
100107,Groceries,27.601043701171875,2023-01-18,46,0,29.284099578857422,1347.0685806274414,2,1,0,3,39750,3
100107,Groceries,27.601043701171875,2023-01-19,79,0,29.284099578857422,2313.4438667297363,3,1,0,3,39829,3
100107,Groceries,27.601043701171875,2023-01-20,221,871,28.888073692321775,31469.028572006224,4,1,0,3,40050,3
100107,Groceries,27.601043701171875,2023-01-21,69,0,29.006147384643555,2001.4241695404053,5,1,1,3,40119,3
100107,Groceries,27.601043701171875,2023-01-22,169,0,29.006147384643555,4902.038908004761,6,1,1,3,40288,3
100107,Groceries,27.601043701171875,2023-01-23,114,0,29.006147384643555,3306.7008018493652,0,1,0,4,40402,3
100107,Groceries,27.601043701171875,2023-01-24,45,0,29.006147384643555,1305.27663230896,1,1,0,4,40447,3
100107,Groceries,27.601043701171875,2023-01-25,136,0,29.006147384643555,3944.8360443115234,2,1,0,4,40583,3
100107,Groceries,27.601043701171875,2023-01-26,75,0,29.006147384643555,2175.4610538482666,3,1,0,4,40658,3
100107,Groceries,27.601043701171875,2023-01-27,121,0,29.006147384643555,3509.74383354187,4,1,0,4,40779,3
100107,Groceries,27.601043701171875,2023-01-28,88,0,29.006147384643555,2552.540969848633,5,1,1,4,40867,3
100107,Groceries,27.601043701171875,2023-01-29,100,0,29.006147384643555,2900.6147384643555,6,1,1,4,40967,3
100107,Groceries,27.601043701171875,2023-01-30,58,0,29.006147384643555,1682.3565483093262,0,1,0,5,41025,3
100107,Groceries,27.601043701171875,2023-01-31,85,0,29.006147384643555,2465.522527694702,1,1,0,5,41110,3
100107,Groceries,27.601043701171875,2023-02-01,98,388,21.145423316955565,9596.502970123292,2,2,0,5,41208,3
100107,Groceries,27.601043701171875,2023-02-02,47,0,23.490846633911133,1104.0697917938232,3,2,0,5,41255,3
100107,Groceries,27.601043701171875,2023-02-03,75,0,23.490846633911133,1761.813497543335,4,2,0,5,41330,3
100107,Groceries,27.601043701171875,2023-02-04,98,0,23.490846633911133,2302.102970123291,5,2,1,5,41428,3
100107,Groceries,27.601043701171875,2023-02-05,82,431,23.20925289154053,11875.197474212648,6,2,1,5,41510,3
100107,Groceries,27.601043701171875,2023-02-06,94,0,23.298505783081055,2190.059543609619,0,2,0,6,41604,3
100107,Groceries,27.601043701171875,2023-02-07,105,0,23.298505783081055,2446.3431072235107,1,2,0,6,41709,3
100107,Groceries,27.601043701171875,2023-02-08,70,0,23.298505783081055,1630.8954048156738,2,2,0,6,41779,3
100107,Groceries,27.601043701171875,2023-02-09,110,0,23.298505783081055,2562.835636138916,3,2,0,6,41889,3
100107,Groceries,27.601043701171875,2023-02-10,62,0,23.298505783081055,1444.5073585510254,4,2,0,6,41951,3
100107,Groceries,27.601043701171875,2023-02-11,45,213,22.18658290863037,5645.752461776733,5,2,1,6,41996,3
100107,Groceries,27.601043701171875,2023-02-12,102,403,23.99994659423828,12270.48910522461,6,2,1,6,42098,3
100107,Groceries,27.601043701171875,2023-02-13,59,0,23.499893188476562,1386.4936981201172,0,2,0,7,42157,3
100107,Groceries,27.601043701171875,2023-02-14,82,0,23.499893188476562,1926.9912414550781,1,2,0,7,42239,3
100107,Groceries,27.601043701171875,2023-02-15,33,0,23.499893188476562,775.4964752197266,2,2,0,7,42272,3
100107,Groceries,27.601043701171875,2023-02-16,45,0,23.499893188476562,1057.4951934814453,3,2,0,7,42317,3
100107,Groceries,27.601043701171875,2023-02-17,62,0,23.499893188476562,1456.9933776855469,4,2,0,7,42379,3
100107,Groceries,27.601043701171875,2023-02-18,33,0,23.499893188476562,775.4964752197266,5,2,1,7,42412,3
100107,Groceries,27.601043701171875,2023-02-19,51,0,23.499893188476562,1198.4945526123047,6,2,1,7,42463,3
100107,Groceries,27.601043701171875,2023-02-20,101,396,21.89811592102051,10721.669416046143,0,2,0,8,42564,3
100107,Groceries,27.601043701171875,2023-02-21,32,0,22.446231842041016,718.2794189453125,1,2,0,8,42596,3
100107,Groceries,27.601043701171875,2023-02-22,106,0,22.446231842041016,2379.3005752563477,2,2,0,8,42702,3
100107,Groceries,27.601043701171875,2023-02-23,99,0,22.446231842041016,2222.1769523620605,3,2,0,8,42801,3
100107,Groceries,27.601043701171875,2023-02-24,81,0,22.446231842041016,1818.1447792053223,4,2,0,8,42882,3
100107,Groceries,27.601043701171875,2023-02-25,150,724,24.182360076904295,21346.40802307129,5,2,1,8,43032,3
100107,Groceries,27.601043701171875,2023-02-26,58,0,23.814720153808594,1381.2537689208984,6,2,1,8,43090,3
100107,Groceries,27.601043701171875,2023-02-27,88,0,23.814720153808594,2095.6953735351562,0,2,0,9,43178,3
100107,Groceries,27.601043701171875,2023-02-28,91,0,23.814720153808594,2167.139533996582,1,2,0,9,43269,3
100107,Groceries,27.601043701171875,2023-03-01,129,0,23.814720153808594,3072.0988998413086,2,3,0,9,43398,3
100107,Groceries,27.601043701171875,2023-03-02,104,0,23.814720153808594,2476.7308959960938,3,3,0,9,43502,3
100107,Groceries,27.601043701171875,2023-03-03,114,433,24.464339828491212,13457.169480895996,4,3,0,9,43616,3
100107,Groceries,27.601043701171875,2023-03-04,76,0,24.228679656982422,1841.379653930664,5,3,1,9,43692,3
100107,Groceries,27.601043701171875,2023-03-05,139,0,24.228679656982422,3367.7864723205566,6,3,1,9,43831,3
100107,Groceries,27.601043701171875,2023-03-06,99,571,28.718605880737307,19969.003964385985,0,3,0,10,43930,3
100107,Groceries,27.601043701171875,2023-03-07,144,0,27.17721176147461,3913.5184936523438,1,3,0,10,44074,3
100107,Groceries,27.601043701171875,2023-03-08,73,0,27.17721176147461,1983.9364585876465,2,3,0,10,44147,3
100107,Groceries,27.601043701171875,2023-03-09,70,0,27.17721176147461,1902.4048233032227,3,3,0,10,44217,3
100107,Groceries,27.601043701171875,2023-03-10,142,0,27.17721176147461,3859.1640701293945,4,3,0,10,44359,3
100107,Groceries,27.601043701171875,2023-03-11,159,659,26.712045936584474,21774.430607833863,5,3,1,10,44518,3
100107,Groceries,27.601043701171875,2023-03-12,129,0,26.864091873168945,3465.467851638794,6,3,1,10,44647,3
100107,Groceries,27.601043701171875,2023-03-13,67,0,26.864091873168945,1799.8941555023193,0,3,0,11,44714,3
100107,Groceries,27.601043701171875,2023-03-14,151,0,26.864091873168945,4056.4778728485107,1,3,0,11,44865,3
100107,Groceries,27.601043701171875,2023-03-15,158,0,26.864091873168945,4244.526515960693,2,3,0,11,45023,3
100107,Groceries,27.601043701171875,2023-03-16,220,858,29.711044540405275,32519.09959777832,3,3,0,11,45243,3
100107,Groceries,27.601043701171875,2023-03-17,164,0,28.942089080810547,4746.50260925293,4,3,0,11,45407,3
100107,Groceries,27.601043701171875,2023-03-18,108,0,28.942089080810547,3125.745620727539,5,3,1,11,45515,3
100107,Groceries,27.601043701171875,2023-03-19,91,0,28.942089080810547,2633.7301063537598,6,3,1,11,45606,3
100107,Groceries,27.601043701171875,2023-03-20,59,0,28.942089080810547,1707.5832557678223,0,3,0,12,45665,3
100107,Groceries,27.601043701171875,2023-03-21,138,0,28.942089080810547,3994.0082931518555,1,3,0,12,45803,3
100107,Groceries,27.601043701171875,2023-03-22,67,0,28.942089080810547,1939.1199684143066,2,3,0,12,45870,3
100107,Groceries,27.601043701171875,2023-03-23,130,0,28.942089080810547,3762.471580505371,3,3,0,12,46000,3
100107,Groceries,27.601043701171875,2023-03-24,154,793,31.204598312377932,29905.656280212403,4,3,0,12,46154,3
100107,Groceries,27.601043701171875,2023-03-25,114,0,30.64919662475586,3494.008415222168,5,3,1,12,46268,3
100107,Groceries,27.601043701171875,2023-03-26,93,0,30.64919662475586,2850.375286102295,6,3,1,12,46361,3
100107,Groceries,27.601043701171875,2023-03-27,102,0,30.64919662475586,3126.2180557250977,0,3,0,13,46463,3
100107,Groceries,27.601043701171875,2023-03-28,137,0,30.64919662475586,4198.939937591553,1,3,0,13,46600,3
100107,Groceries,27.601043701171875,2023-03-29,95,0,30.64919662475586,2911.6736793518066,2,3,0,13,46695,3
100107,Groceries,27.601043701171875,2023-03-30,128,813,32.83959648132324,31313.336699218748,3,3,0,13,46823,3
100107,Groceries,27.601043701171875,2023-03-31,104,0,32.239192962646484,3352.8760681152344,4,3,0,13,46927,3
100107,Groceries,27.601043701171875,2023-04-01,58,0,32.239192962646484,1869.873191833496,5,4,1,13,46985,3
100107,Groceries,27.601043701171875,2023-04-02,135,0,32.239192962646484,4352.291049957275,6,4,1,13,47120,3
100107,Groceries,27.601043701171875,2023-04-03,42,0,32.239192962646484,1354.0461044311523,0,4,0,14,47162,3
100107,Groceries,27.601043701171875,2023-04-04,73,0,32.239192962646484,2353.4610862731934,1,4,0,14,47235,3
100107,Groceries,27.601043701171875,2023-04-05,121,0,32.239192962646484,3900.9423484802246,2,4,0,14,47356,3
100107,Groceries,27.601043701171875,2023-04-06,191,720,26.279434661865235,22845.83404083252,3,4,0,14,47547,3
100107,Groceries,27.601043701171875,2023-04-07,150,0,28.34886932373047,4252.33039855957,4,4,0,14,47697,3
100107,Groceries,27.601043701171875,2023-04-08,66,0,28.34886932373047,1871.025375366211,5,4,1,14,47763,3
100107,Groceries,27.601043701171875,2023-04-09,80,0,28.34886932373047,2267.9095458984375,6,4,1,14,47843,3
100107,Groceries,27.601043701171875,2023-04-10,124,0,28.34886932373047,3515.259796142578,0,4,0,15,47967,3
100107,Groceries,27.601043701171875,2023-04-11,155,945,30.25636260986328,33758.872409057614,1,4,0,15,48122,3
100107,Groceries,27.601043701171875,2023-04-12,32,0,29.652725219726562,948.88720703125,2,4,0,15,48154,3
100107,Groceries,27.601043701171875,2023-04-13,19,0,29.652725219726562,563.4017791748047,3,4,0,15,48173,3
100107,Groceries,27.601043701171875,2023-04-14,110,0,29.652725219726562,3261.799774169922,4,4,0,15,48283,3
100107,Groceries,27.601043701171875,2023-04-15,47,0,29.652725219726562,1393.6780853271484,5,4,1,15,48330,3
100107,Groceries,27.601043701171875,2023-04-16,49,0,29.652725219726562,1452.9835357666016,6,4,1,15,48379,3
100107,Groceries,27.601043701171875,2023-04-17,85,0,29.652725219726562,2520.481643676758,0,4,0,16,48464,3
100107,Groceries,27.601043701171875,2023-04-18,100,0,29.652725219726562,2965.2725219726562,1,4,0,16,48564,3
100107,Groceries,27.601043701171875,2023-04-19,108,0,29.652725219726562,3202.4943237304688,2,4,0,16,48672,3
100107,Groceries,27.601043701171875,2023-04-20,94,0,29.652725219726562,2787.356170654297,3,4,0,16,48766,3
100107,Groceries,27.601043701171875,2023-04-21,17,0,29.652725219726562,504.09632873535156,4,4,0,16,48783,3
100107,Groceries,27.601043701171875,2023-04-22,44,0,29.652725219726562,1304.7199096679688,5,4,1,16,48827,3
100107,Groceries,27.601043701171875,2023-04-23,76,0,29.652725219726562,2253.6071166992188,6,4,1,16,48903,3
100107,Groceries,27.601043701171875,2023-04-24,62,0,29.652725219726562,1838.4689636230469,0,4,0,17,48965,3
100107,Groceries,27.601043701171875,2023-04-25,61,0,29.652725219726562,1808.8162384033203,1,4,0,17,49026,3
100107,Groceries,27.601043701171875,2023-04-26,50,0,29.652725219726562,1482.6362609863281,2,4,0,17,49076,3
100107,Groceries,27.601043701171875,2023-04-27,25,0,29.652725219726562,741.3181304931641,3,4,0,17,49101,3
100107,Groceries,27.601043701171875,2023-04-28,94,0,29.652725219726562,2787.356170654297,4,4,0,17,49195,3
100107,Groceries,27.601043701171875,2023-04-29,25,0,29.652725219726562,741.3181304931641,5,4,1,17,49220,3
100107,Groceries,27.601043701171875,2023-04-30,60,0,29.652725219726562,1779.1635131835938,6,4,1,17,49280,3
100107,Groceries,27.601043701171875,2023-05-01,105,531,24.677630577087402,15010.122421188355,0,5,0,18,49385,3
100107,Groceries,27.601043701171875,2023-05-02,140,0,26.285261154174805,3679.9365615844727,1,5,0,18,49525,3
100107,Groceries,27.601043701171875,2023-05-03,26,0,26.285261154174805,683.4167900085449,2,5,0,18,49551,3
100107,Groceries,27.601043701171875,2023-05-04,166,0,26.285261154174805,4363.353351593018,3,5,0,18,49717,3
100107,Groceries,27.601043701171875,2023-05-05,43,0,26.285261154174805,1130.2662296295166,4,5,0,18,49760,3
100107,Groceries,27.601043701171875,2023-05-06,86,0,26.285261154174805,2260.532459259033,5,5,1,18,49846,3
100107,Groceries,27.601043701171875,2023-05-07,59,0,26.285261154174805,1550.8304080963135,6,5,1,18,49905,3
100107,Groceries,27.601043701171875,2023-05-08,105,391,25.070001792907714,12314.60037651062,0,5,0,19,50010,3
100107,Groceries,27.601043701171875,2023-05-09,82,0,25.49000358581543,2090.1802940368652,1,5,0,19,50092,3
100107,Groceries,27.601043701171875,2023-05-10,48,0,25.49000358581543,1223.5201721191406,2,5,0,19,50140,3
100107,Groceries,27.601043701171875,2023-05-11,53,0,25.49000358581543,1350.9701900482178,3,5,0,19,50193,3
100107,Groceries,27.601043701171875,2023-05-12,108,557,22.611296272277833,14627.339994812011,4,5,0,19,50301,3
100107,Groceries,27.601043701171875,2023-05-13,62,0,23.522592544555664,1458.4007377624512,5,5,1,19,50363,3
100107,Groceries,27.601043701171875,2023-05-14,107,0,23.522592544555664,2516.917402267456,6,5,1,19,50470,3
100107,Groceries,27.601043701171875,2023-05-15,104,0,23.522592544555664,2446.349624633789,0,5,0,20,50574,3
100107,Groceries,27.601043701171875,2023-05-16,168,716,29.47175987243652,27115.191317138673,1,5,0,20,50742,3
100107,Groceries,27.601043701171875,2023-05-17,88,0,27.533519744873047,2422.949737548828,2,5,0,20,50830,3
100107,Groceries,27.601043701171875,2023-05-18,216,0,27.533519744873047,5947.240264892578,3,5,0,20,51046,3
100107,Groceries,27.601043701171875,2023-05-19,57,0,27.533519744873047,1569.4106254577637,4,5,0,20,51103,3
100107,Groceries,27.601043701171875,2023-05-20,95,0,27.533519744873047,2615.6843757629395,5,5,1,20,51198,3
100107,Groceries,27.601043701171875,2023-05-21,183,710,26.46875469207764,23436.994217300416,6,5,1,20,51381,3
100107,Groceries,27.601043701171875,2023-05-22,101,0,26.847509384155273,2711.5984477996826,0,5,0,21,51482,3
100107,Groceries,27.601043701171875,2023-05-23,117,0,26.847509384155273,3141.158597946167,1,5,0,21,51599,3
100107,Groceries,27.601043701171875,2023-05-24,134,0,26.847509384155273,3597.5662574768066,2,5,0,21,51733,3
100107,Groceries,27.601043701171875,2023-05-25,56,0,26.847509384155273,1503.4605255126953,3,5,0,21,51789,3
100107,Groceries,27.601043701171875,2023-05-26,94,0,26.847509384155273,2523.6658821105957,4,5,0,21,51883,3
100107,Groceries,27.601043701171875,2023-05-27,54,0,26.847509384155273,1449.7655067443848,5,5,1,21,51937,3
100107,Groceries,27.601043701171875,2023-05-28,123,830,27.32174144744873,26142.438396072386,6,5,1,21,52060,3
100107,Groceries,27.601043701171875,2023-05-29,62,0,27.17348289489746,1684.7559394836426,0,5,0,22,52122,3
100107,Groceries,27.601043701171875,2023-05-30,141,0,27.17348289489746,3831.461088180542,1,5,0,22,52263,3
100107,Groceries,27.601043701171875,2023-05-31,61,0,27.17348289489746,1657.5824565887451,2,5,0,22,52324,3
100107,Groceries,27.601043701171875,2023-06-01,41,0,27.17348289489746,1114.112798690796,3,6,0,22,52365,3
100107,Groceries,27.601043701171875,2023-06-02,53,0,27.17348289489746,1440.1945934295654,4,6,0,22,52418,3
100107,Groceries,27.601043701171875,2023-06-03,137,0,27.17348289489746,3722.767156600952,5,6,1,22,52555,3
100107,Groceries,27.601043701171875,2023-06-04,140,0,27.17348289489746,3804.2876052856445,6,6,1,22,52695,3
100107,Groceries,27.601043701171875,2023-06-05,174,0,27.17348289489746,4728.186023712158,0,6,0,23,52869,3
100107,Groceries,27.601043701171875,2023-06-06,112,0,27.17348289489746,3043.4300842285156,1,6,0,23,52981,3
100107,Groceries,27.601043701171875,2023-06-07,88,0,27.17348289489746,2391.2664947509766,2,6,0,23,53069,3
100107,Groceries,27.601043701171875,2023-06-08,67,454,24.85251811981201,12649.19742805481,3,6,0,23,53136,3
100107,Groceries,27.601043701171875,2023-06-09,171,0,25.625036239624023,4381.881196975708,4,6,0,23,53307,3
100107,Groceries,27.601043701171875,2023-06-10,43,0,25.625036239624023,1101.876558303833,5,6,1,23,53350,3
100107,Groceries,27.601043701171875,2023-06-11,172,1169,32.73778068542481,45399.07655578614,6,6,1,23,53522,3
100107,Groceries,27.601043701171875,2023-06-12,223,0,31.23556137084961,6965.530185699463,0,6,0,24,53745,3
100107,Groceries,27.601043701171875,2023-06-13,115,0,31.23556137084961,3592.089557647705,1,6,0,24,53860,3
100107,Groceries,27.601043701171875,2023-06-14,74,0,31.23556137084961,2311.431541442871,2,6,0,24,53934,3
100107,Groceries,27.601043701171875,2023-06-15,80,0,31.23556137084961,2498.8449096679688,3,6,0,24,54014,3
100107,Groceries,27.601043701171875,2023-06-16,132,0,31.23556137084961,4123.094100952148,4,6,0,24,54146,3
100107,Groceries,27.601043701171875,2023-06-17,213,0,31.23556137084961,6653.174571990967,5,6,1,24,54359,3
100107,Groceries,27.601043701171875,2023-06-18,163,855,25.603544273376464,24837.115433120725,6,6,1,24,54522,3
100107,Groceries,27.601043701171875,2023-06-19,113,0,27.37708854675293,3093.611005783081,0,6,0,25,54635,3
100107,Groceries,27.601043701171875,2023-06-20,72,0,27.37708854675293,1971.150375366211,1,6,0,25,54707,3
100107,Groceries,27.601043701171875,2023-06-21,83,0,27.37708854675293,2272.298349380493,2,6,0,25,54790,3
100107,Groceries,27.601043701171875,2023-06-22,74,0,27.37708854675293,2025.9045524597168,3,6,0,25,54864,3
100107,Groceries,27.601043701171875,2023-06-23,177,0,27.37708854675293,4845.744672775269,4,6,0,25,55041,3
100107,Groceries,27.601043701171875,2023-06-24,75,0,27.37708854675293,2053.2816410064697,5,6,1,25,55116,3
100107,Groceries,27.601043701171875,2023-06-25,126,0,27.37708854675293,3449.513156890869,6,6,1,25,55242,3
100107,Groceries,27.601043701171875,2023-06-26,177,829,29.1224174118042,29654.175763778687,0,6,0,26,55419,3
100107,Groceries,27.601043701171875,2023-06-27,92,0,28.5748348236084,2628.8848037719727,1,6,0,26,55511,3
100107,Groceries,27.601043701171875,2023-06-28,100,0,28.5748348236084,2857.48348236084,2,6,0,26,55611,3
100107,Groceries,27.601043701171875,2023-06-29,114,0,28.5748348236084,3257.5311698913574,3,6,0,26,55725,3
100107,Groceries,27.601043701171875,2023-06-30,117,0,28.5748348236084,3343.2556743621826,4,6,0,26,55842,3
100107,Groceries,27.601043701171875,2023-07-01,96,0,28.5748348236084,2743.1841430664062,5,7,1,26,55938,3
100107,Groceries,27.601043701171875,2023-07-02,122,0,28.5748348236084,3486.1298484802246,6,7,1,26,56060,3
100107,Groceries,27.601043701171875,2023-07-03,94,0,28.5748348236084,2686.0344734191895,0,7,0,27,56154,3
100107,Groceries,27.601043701171875,2023-07-04,200,862,26.04251293182373,27185.46517272949,1,7,0,27,56354,3
100107,Groceries,27.601043701171875,2023-07-05,150,0,26.75502586364746,4013.253879547119,2,7,0,27,56504,3
100107,Groceries,27.601043701171875,2023-07-06,141,0,26.75502586364746,3772.458646774292,3,7,0,27,56645,3
100107,Groceries,27.601043701171875,2023-07-07,184,0,26.75502586364746,4922.924758911133,4,7,0,27,56829,3
100107,Groceries,27.601043701171875,2023-07-08,32,0,26.75502586364746,856.1608276367188,5,7,1,27,56861,3
100107,Groceries,27.601043701171875,2023-07-09,149,0,26.75502586364746,3986.4988536834717,6,7,1,27,57010,3
100107,Groceries,27.601043701171875,2023-07-10,193,920,30.01057559967041,34041.11218147278,0,7,0,28,57203,3
100107,Groceries,27.601043701171875,2023-07-11,111,0,29.13115119934082,3233.557783126831,1,7,0,28,57314,3
100107,Groceries,27.601043701171875,2023-07-12,109,0,29.13115119934082,3175.2954807281494,2,7,0,28,57423,3
100107,Groceries,27.601043701171875,2023-07-13,90,0,29.13115119934082,2621.803607940674,3,7,0,28,57513,3
100107,Groceries,27.601043701171875,2023-07-14,158,0,29.13115119934082,4602.72188949585,4,7,0,28,57671,3
100107,Groceries,27.601043701171875,2023-07-15,26,0,29.13115119934082,757.4099311828613,5,7,1,28,57697,3
100107,Groceries,27.601043701171875,2023-07-16,96,0,29.13115119934082,2796.5905151367188,6,7,1,28,57793,3
100107,Groceries,27.601043701171875,2023-07-17,87,0,29.13115119934082,2534.4101543426514,0,7,0,29,57880,3
100107,Groceries,27.601043701171875,2023-07-18,76,0,29.13115119934082,2213.9674911499023,1,7,0,29,57956,3
100107,Groceries,27.601043701171875,2023-07-19,169,723,31.04373867034912,28021.343670578004,2,7,0,29,58125,3
100107,Groceries,27.601043701171875,2023-07-20,125,0,30.447477340698242,3805.9346675872803,3,7,0,29,58250,3
100107,Groceries,27.601043701171875,2023-07-21,114,0,30.447477340698242,3471.0124168395996,4,7,0,29,58364,3
100107,Groceries,27.601043701171875,2023-07-22,123,0,30.447477340698242,3745.039712905884,5,7,1,29,58487,3
100107,Groceries,27.601043701171875,2023-07-23,212,0,30.447477340698242,6454.865196228027,6,7,1,29,58699,3
100107,Groceries,27.601043701171875,2023-07-24,241,699,31.6152498626709,29885.390433807373,0,7,0,30,58940,3
100107,Groceries,27.601043701171875,2023-07-25,152,0,31.250499725341797,4750.075958251953,1,7,0,30,59092,3
100107,Groceries,27.601043701171875,2023-07-26,213,849,34.72211120605469,37662.1793737793,2,7,0,30,59305,3
100107,Groceries,27.601043701171875,2023-07-27,29,0,33.484222412109375,971.0424499511719,3,7,0,30,59334,3
100107,Groceries,27.601043701171875,2023-07-28,164,0,33.484222412109375,5491.4124755859375,4,7,0,30,59498,3
100107,Groceries,27.601043701171875,2023-07-29,158,0,33.484222412109375,5290.507141113281,5,7,1,30,59656,3
100107,Groceries,27.601043701171875,2023-07-30,76,0,33.484222412109375,2544.8009033203125,6,7,1,30,59732,3
100107,Groceries,27.601043701171875,2023-07-31,107,0,33.484222412109375,3582.811798095703,0,7,0,31,59839,3
100107,Groceries,27.601043701171875,2023-08-01,109,0,33.484222412109375,3649.780242919922,1,8,0,31,59948,3
100107,Groceries,27.601043701171875,2023-08-02,208,767,31.50792015075684,30302.134782714846,2,8,0,31,60156,3
100107,Groceries,27.601043701171875,2023-08-03,122,0,32.25584030151367,3935.212516784668,3,8,0,31,60278,3
100107,Groceries,27.601043701171875,2023-08-04,105,0,32.25584030151367,3386.8632316589355,4,8,0,31,60383,3
100107,Groceries,27.601043701171875,2023-08-05,253,0,32.25584030151367,8160.727596282959,5,8,1,31,60636,3
100107,Groceries,27.601043701171875,2023-08-06,89,0,32.25584030151367,2870.769786834717,6,8,1,31,60725,3
100107,Groceries,27.601043701171875,2023-08-07,52,0,32.25584030151367,1677.303695678711,0,8,0,32,60777,3
100107,Groceries,27.601043701171875,2023-08-08,235,1086,35.18181015014649,47188.47077056885,1,8,0,32,61012,3
100107,Groceries,27.601043701171875,2023-08-09,118,0,34.34362030029297,4052.5471954345703,2,8,0,32,61130,3
100107,Groceries,27.601043701171875,2023-08-10,283,0,34.34362030029297,9719.24454498291,3,8,0,32,61413,3
100107,Groceries,27.601043701171875,2023-08-11,101,0,34.34362030029297,3468.70565032959,4,8,0,32,61514,3
100107,Groceries,27.601043701171875,2023-08-12,104,0,34.34362030029297,3571.7365112304688,5,8,1,32,61618,3
100107,Groceries,27.601043701171875,2023-08-13,78,0,34.34362030029297,2678.8023834228516,6,8,1,32,61696,3
100107,Groceries,27.601043701171875,2023-08-14,69,0,34.34362030029297,2369.709800720215,0,8,0,33,61765,3
100107,Groceries,27.601043701171875,2023-08-15,149,0,34.34362030029297,5117.199424743652,1,8,0,33,61914,3
100107,Groceries,27.601043701171875,2023-08-16,99,0,34.34362030029297,3400.018409729004,2,8,0,33,62013,3
100107,Groceries,27.601043701171875,2023-08-17,231,1176,30.235003242492674,41628.72149803161,3,8,0,33,62244,3
100107,Groceries,27.601043701171875,2023-08-18,67,0,31.20000648498535,2090.4004344940186,4,8,0,33,62311,3
100107,Groceries,27.601043701171875,2023-08-19,100,0,31.20000648498535,3120.000648498535,5,8,1,33,62411,3
100107,Groceries,27.601043701171875,2023-08-20,85,0,31.20000648498535,2652.000551223755,6,8,1,33,62496,3
100107,Groceries,27.601043701171875,2023-08-21,142,0,31.20000648498535,4430.40092086792,0,8,0,34,62638,3
100107,Groceries,27.601043701171875,2023-08-22,142,0,31.20000648498535,4430.40092086792,1,8,0,34,62780,3
100107,Groceries,27.601043701171875,2023-08-23,149,0,31.20000648498535,4648.800966262817,2,8,0,34,62929,3
100107,Groceries,27.601043701171875,2023-08-24,171,958,31.81993450164795,36090.027599563604,3,8,0,34,63100,3
100107,Groceries,27.601043701171875,2023-08-25,171,0,31.6098690032959,5405.287599563599,4,8,0,34,63271,3
100107,Groceries,27.601043701171875,2023-08-26,114,0,31.6098690032959,3603.5250663757324,5,8,1,34,63385,3
100107,Groceries,27.601043701171875,2023-08-27,249,0,31.6098690032959,7870.857381820679,6,8,1,34,63634,3
100107,Groceries,27.601043701171875,2023-08-28,175,0,31.6098690032959,5531.727075576782,0,8,0,35,63809,3
100107,Groceries,27.601043701171875,2023-08-29,124,0,31.6098690032959,3919.6237564086914,1,8,0,35,63933,3
100107,Groceries,27.601043701171875,2023-08-30,263,1014,35.197169342041015,45797.54107391357,2,8,0,35,64196,3
100107,Groceries,27.601043701171875,2023-08-31,97,0,34.06433868408203,3304.240852355957,3,8,0,35,64293,3
100107,Groceries,27.601043701171875,2023-09-01,101,0,34.06433868408203,3440.498207092285,4,9,0,35,64394,3
100107,Groceries,27.601043701171875,2023-09-02,149,0,34.06433868408203,5075.586463928223,5,9,1,35,64543,3
100107,Groceries,27.601043701171875,2023-09-03,68,0,34.06433868408203,2316.375030517578,6,9,1,35,64611,3
100107,Groceries,27.601043701171875,2023-09-04,121,0,34.06433868408203,4121.784980773926,0,9,0,36,64732,3
100107,Groceries,27.601043701171875,2023-09-05,66,0,34.06433868408203,2248.246353149414,1,9,0,36,64798,3
100107,Groceries,27.601043701171875,2023-09-06,117,0,34.06433868408203,3985.5276260375977,2,9,0,36,64915,3
100107,Groceries,27.601043701171875,2023-09-07,188,0,34.06433868408203,6404.095672607422,3,9,0,36,65103,3
100107,Groceries,27.601043701171875,2023-09-08,145,0,34.06433868408203,4939.3291091918945,4,9,0,36,65248,3
100107,Groceries,27.601043701171875,2023-09-09,109,0,34.06433868408203,3713.0129165649414,5,9,1,36,65357,3
100107,Groceries,27.601043701171875,2023-09-10,93,430,29.05941493988037,14557.971178817748,6,9,1,36,65450,3
100107,Groceries,27.601043701171875,2023-09-11,159,0,30.958829879760742,4922.453950881958,0,9,0,37,65609,3
100107,Groceries,27.601043701171875,2023-09-12,138,0,30.958829879760742,4272.318523406982,1,9,0,37,65747,3
100107,Groceries,27.601043701171875,2023-09-13,66,0,30.958829879760742,2043.282772064209,2,9,0,37,65813,3
100107,Groceries,27.601043701171875,2023-09-14,144,543,22.8396431350708,14669.537222900391,3,9,0,37,65957,3
100107,Groceries,27.601043701171875,2023-09-15,77,0,25.3992862701416,1955.7450428009033,4,9,0,37,66034,3
100107,Groceries,27.601043701171875,2023-09-16,129,0,25.3992862701416,3276.5079288482666,5,9,1,37,66163,3
100107,Groceries,27.601043701171875,2023-09-17,84,0,25.3992862701416,2133.5400466918945,6,9,1,37,66247,3
100107,Groceries,27.601043701171875,2023-09-18,108,0,25.3992862701416,2743.122917175293,0,9,0,38,66355,3
100107,Groceries,27.601043701171875,2023-09-19,140,513,27.26716083526611,18034.04503387451,1,9,0,38,66495,3
100107,Groceries,27.601043701171875,2023-09-20,117,0,26.654321670532227,3118.5556354522705,2,9,0,38,66612,3
100107,Groceries,27.601043701171875,2023-09-21,108,0,26.654321670532227,2878.6667404174805,3,9,0,38,66720,3
100107,Groceries,27.601043701171875,2023-09-22,136,0,26.654321670532227,3624.987747192383,4,9,0,38,66856,3
100107,Groceries,27.601043701171875,2023-09-23,117,812,27.77175380706787,25986.39039085388,5,9,1,38,66973,3
100107,Groceries,27.601043701171875,2023-09-24,119,0,27.503507614135742,3272.9174060821533,6,9,1,38,67092,3
100107,Groceries,27.601043701171875,2023-09-25,80,0,27.503507614135742,2200.2806091308594,0,9,0,39,67172,3
100107,Groceries,27.601043701171875,2023-09-26,114,0,27.503507614135742,3135.3998680114746,1,9,0,39,67286,3
100107,Groceries,27.601043701171875,2023-09-27,97,0,27.503507614135742,2667.840238571167,2,9,0,39,67383,3
100107,Groceries,27.601043701171875,2023-09-28,105,0,27.503507614135742,2887.868299484253,3,9,0,39,67488,3
100107,Groceries,27.601043701171875,2023-09-29,173,521,29.051639518737794,20377.027273483276,4,9,0,39,67661,3
100107,Groceries,27.601043701171875,2023-09-30,123,0,28.433279037475586,3497.293321609497,5,9,1,39,67784,3
100107,Groceries,27.601043701171875,2023-10-01,213,0,28.433279037475586,6056.2884349823,6,10,1,39,67997,3
100107,Groceries,27.601043701171875,2023-10-02,184,843,30.786221733093264,32074.64959777832,0,10,0,40,68181,3
100107,Groceries,27.601043701171875,2023-10-03,216,0,30.092443466186523,6499.967788696289,1,10,0,40,68397,3
100107,Groceries,27.601043701171875,2023-10-04,76,0,30.092443466186523,2287.025703430176,2,10,0,40,68473,3
100107,Groceries,27.601043701171875,2023-10-05,94,0,30.092443466186523,2828.689685821533,3,10,0,40,68567,3
100107,Groceries,27.601043701171875,2023-10-06,155,0,30.092443466186523,4664.328737258911,4,10,0,40,68722,3
100107,Groceries,27.601043701171875,2023-10-07,111,0,30.092443466186523,3340.261224746704,5,10,1,40,68833,3
100107,Groceries,27.601043701171875,2023-10-08,72,0,30.092443466186523,2166.6559295654297,6,10,1,40,68905,3
100107,Groceries,27.601043701171875,2023-10-09,55,0,30.092443466186523,1655.0843906402588,0,10,0,41,68960,3
100107,Groceries,27.601043701171875,2023-10-10,40,0,30.092443466186523,1203.697738647461,1,10,0,41,69000,3
100107,Groceries,27.601043701171875,2023-10-11,98,470,27.310852546691894,15132.80709915161,2,10,0,41,69098,3
100107,Groceries,27.601043701171875,2023-10-12,78,0,28.33170509338379,2209.8729972839355,3,10,0,41,69176,3
100107,Groceries,27.601043701171875,2023-10-13,98,0,28.33170509338379,2776.5070991516113,4,10,0,41,69274,3
100107,Groceries,27.601043701171875,2023-10-14,112,0,28.33170509338379,3173.1509704589844,5,10,1,41,69386,3
100107,Groceries,27.601043701171875,2023-10-15,60,0,28.33170509338379,1699.9023056030273,6,10,1,41,69446,3
100107,Groceries,27.601043701171875,2023-10-16,50,0,28.33170509338379,1416.5852546691895,0,10,0,42,69496,3
100107,Groceries,27.601043701171875,2023-10-17,83,0,28.33170509338379,2351.5315227508545,1,10,0,42,69579,3
100107,Groceries,27.601043701171875,2023-10-18,48,0,28.33170509338379,1359.9218444824219,2,10,0,42,69627,3
100107,Groceries,27.601043701171875,2023-10-19,88,384,25.31314888000488,11647.91420288086,3,10,0,42,69715,3
100107,Groceries,27.601043701171875,2023-10-20,87,0,26.326297760009766,2290.3879051208496,4,10,0,42,69802,3
100107,Groceries,27.601043701171875,2023-10-21,76,0,26.326297760009766,2000.7986297607422,5,10,1,42,69878,3
100107,Groceries,27.601043701171875,2023-10-22,108,0,26.326297760009766,2843.2401580810547,6,10,1,42,69986,3
100107,Groceries,27.601043701171875,2023-10-23,40,0,26.326297760009766,1053.0519104003906,0,10,0,43,70026,3
100107,Groceries,27.601043701171875,2023-10-24,59,410,22.748594703674314,10276.464175033569,1,10,0,43,70085,3
100107,Groceries,27.601043701171875,2023-10-25,143,0,23.867189407348633,3413.0080852508545,2,10,0,43,70228,3
100107,Groceries,27.601043701171875,2023-10-26,72,0,23.867189407348633,1718.4376373291016,3,10,0,43,70300,3
100107,Groceries,27.601043701171875,2023-10-27,99,0,23.867189407348633,2362.8517513275146,4,10,0,43,70399,3
100107,Groceries,27.601043701171875,2023-10-28,133,654,26.251084480285645,20956.00847175598,5,10,1,43,70532,3
100107,Groceries,27.601043701171875,2023-10-29,155,0,25.68216896057129,3980.73618888855,6,10,1,43,70687,3
100107,Groceries,27.601043701171875,2023-10-30,101,0,25.68216896057129,2593.8990650177,0,10,0,44,70788,3
100107,Groceries,27.601043701171875,2023-10-31,21,0,25.68216896057129,539.3255481719971,1,10,0,44,70809,3
100107,Groceries,27.601043701171875,2023-11-01,58,0,25.68216896057129,1489.5657997131348,2,11,0,44,70867,3
100107,Groceries,27.601043701171875,2023-11-02,150,716,27.5972004699707,24217.720140991212,3,11,0,44,71017,3
100107,Groceries,27.601043701171875,2023-11-03,88,0,27.034400939941406,2379.0272827148438,4,11,0,44,71105,3
100107,Groceries,27.601043701171875,2023-11-04,61,0,27.034400939941406,1649.0984573364258,5,11,1,44,71166,3
100107,Groceries,27.601043701171875,2023-11-05,162,0,27.034400939941406,4379.572952270508,6,11,1,44,71328,3
100107,Groceries,27.601043701171875,2023-11-06,122,0,27.034400939941406,3298.1969146728516,0,11,0,45,71450,3
100107,Groceries,27.601043701171875,2023-11-07,213,1063,32.782318115234375,43077.767517089844,1,11,0,45,71663,3
100107,Groceries,27.601043701171875,2023-11-08,206,0,31.31463623046875,6450.8150634765625,2,11,0,45,71869,3
100107,Groceries,27.601043701171875,2023-11-09,139,0,31.31463623046875,4352.734436035156,3,11,0,45,72008,3
100107,Groceries,27.601043701171875,2023-11-10,82,0,31.31463623046875,2567.8001708984375,4,11,0,45,72090,3
100107,Groceries,27.601043701171875,2023-11-11,118,0,31.31463623046875,3695.1270751953125,5,11,1,45,72208,3
100107,Groceries,27.601043701171875,2023-11-12,73,0,31.31463623046875,2285.9684448242188,6,11,1,45,72281,3
100107,Groceries,27.601043701171875,2023-11-13,91,0,31.31463623046875,2849.6318969726562,0,11,0,46,72372,3
100107,Groceries,27.601043701171875,2023-11-14,35,0,31.31463623046875,1096.0122680664062,1,11,0,46,72407,3
100107,Groceries,27.601043701171875,2023-11-15,73,0,31.31463623046875,2285.9684448242188,2,11,0,46,72480,3
100107,Groceries,27.601043701171875,2023-11-16,165,815,26.161570320129393,24571.3182056427,3,11,0,46,72645,3
100107,Groceries,27.601043701171875,2023-11-17,106,0,27.80314064025879,2947.1329078674316,4,11,0,46,72751,3
100107,Groceries,27.601043701171875,2023-11-18,116,0,27.80314064025879,3225.1643142700195,5,11,1,46,72867,3
100107,Groceries,27.601043701171875,2023-11-19,170,0,27.80314064025879,4726.533908843994,6,11,1,46,73037,3
100107,Groceries,27.601043701171875,2023-11-20,80,0,27.80314064025879,2224.251251220703,0,11,0,47,73117,3
100107,Groceries,27.601043701171875,2023-11-21,103,0,27.80314064025879,2863.7234859466553,1,11,0,47,73220,3
100107,Groceries,27.601043701171875,2023-11-22,82,0,27.80314064025879,2279.8575325012207,2,11,0,47,73302,3
100107,Groceries,27.601043701171875,2023-11-23,168,0,27.80314064025879,4670.927627563477,3,11,0,47,73470,3
100107,Groceries,27.601043701171875,2023-11-24,155,541,27.134992790222167,18795.247764968874,4,11,0,47,73625,3
100107,Groceries,27.601043701171875,2023-11-25,81,0,27.369985580444336,2216.968832015991,5,11,1,47,73706,3
100107,Groceries,27.601043701171875,2023-11-26,60,0,27.369985580444336,1642.1991348266602,6,11,1,47,73766,3
100107,Groceries,27.601043701171875,2023-11-27,48,0,27.369985580444336,1313.7593078613281,0,11,0,48,73814,3
100107,Groceries,27.601043701171875,2023-11-28,111,0,27.369985580444336,3038.0683994293213,1,11,0,48,73925,3
100107,Groceries,27.601043701171875,2023-11-29,100,0,27.369985580444336,2736.9985580444336,2,11,0,48,74025,3
100107,Groceries,27.601043701171875,2023-11-30,59,0,27.369985580444336,1614.8291492462158,3,11,0,48,74084,3
100107,Groceries,27.601043701171875,2023-12-01,99,568,25.974663276672363,17121.24332878113,4,12,0,48,74183,3
100107,Groceries,27.601043701171875,2023-12-02,206,0,26.409326553344727,5440.321269989014,5,12,1,48,74389,3
100107,Groceries,27.601043701171875,2023-12-03,143,0,26.409326553344727,3776.533697128296,6,12,1,48,74532,3
100107,Groceries,27.601043701171875,2023-12-04,66,0,26.409326553344727,1743.015552520752,0,12,0,49,74598,3
100107,Groceries,27.601043701171875,2023-12-05,79,0,26.409326553344727,2086.3367977142334,1,12,0,49,74677,3
100107,Groceries,27.601043701171875,2023-12-06,123,601,25.432481956481933,18278.090561294557,2,12,0,49,74800,3
100107,Groceries,27.601043701171875,2023-12-07,93,0,25.714963912963867,2391.4916439056396,3,12,0,49,74893,3
100107,Groceries,27.601043701171875,2023-12-08,158,0,25.714963912963867,4062.964298248291,4,12,0,49,75051,3
100107,Groceries,27.601043701171875,2023-12-09,115,0,25.714963912963867,2957.2208499908447,5,12,1,49,75166,3
100107,Groceries,27.601043701171875,2023-12-10,82,0,25.714963912963867,2108.627040863037,6,12,1,49,75248,3
100107,Groceries,27.601043701171875,2023-12-11,78,0,25.714963912963867,2005.7671852111816,0,12,0,50,75326,3
100107,Groceries,27.601043701171875,2023-12-12,51,0,25.714963912963867,1311.4631595611572,1,12,0,50,75377,3
100107,Groceries,27.601043701171875,2023-12-13,195,798,28.427355270385743,28549.54855545044,2,12,0,50,75572,3
100107,Groceries,27.601043701171875,2023-12-14,55,0,27.894710540771484,1534.2090797424316,3,12,0,50,75627,3
100107,Groceries,27.601043701171875,2023-12-15,83,0,27.894710540771484,2315.260974884033,4,12,0,50,75710,3
100107,Groceries,27.601043701171875,2023-12-16,57,750,26.607376403808594,21148.26091003418,5,12,1,50,75767,3
100107,Groceries,27.601043701171875,2023-12-17,139,0,27.074752807617188,3763.390640258789,6,12,1,50,75906,3
100107,Groceries,27.601043701171875,2023-12-18,75,0,27.074752807617188,2030.606460571289,0,12,0,51,75981,3
100107,Groceries,27.601043701171875,2023-12-19,292,0,27.074752807617188,7905.827819824219,1,12,0,51,76273,3
100107,Groceries,27.601043701171875,2023-12-20,59,0,27.074752807617188,1597.410415649414,2,12,0,51,76332,3
100107,Groceries,27.601043701171875,2023-12-21,134,0,27.074752807617188,3628.016876220703,3,12,0,51,76466,3
100107,Groceries,27.601043701171875,2023-12-22,84,0,27.074752807617188,2274.2792358398438,4,12,0,51,76550,3
100107,Groceries,27.601043701171875,2023-12-23,85,0,27.074752807617188,2301.353988647461,5,12,1,51,76635,3
100107,Groceries,27.601043701171875,2023-12-24,239,907,28.8546923828125,33391.66295898438,6,12,1,51,76874,3
100107,Groceries,27.601043701171875,2023-12-25,61,0,28.369384765625,1730.532470703125,0,12,0,52,76935,3
100107,Groceries,27.601043701171875,2023-12-26,111,0,28.369384765625,3149.001708984375,1,12,0,52,77046,3
100107,Groceries,27.601043701171875,2023-12-27,9,0,28.369384765625,255.324462890625,2,12,0,52,77055,3
100107,Groceries,27.601043701171875,2023-12-28,81,0,28.369384765625,2297.920166015625,3,12,0,52,77136,3
100107,Groceries,27.601043701171875,2023-12-29,93,0,28.369384765625,2638.352783203125,4,12,0,52,77229,3
100107,Groceries,27.601043701171875,2023-12-30,70,0,28.369384765625,1985.85693359375,5,12,1,52,77299,3
100107,Groceries,27.601043701171875,2023-12-31,72,0,28.369384765625,2042.595703125,6,12,1,52,77371,3
100107,Groceries,27.601043701171875,2024-01-01,117,0,28.369384765625,3319.218017578125,0,1,0,1,77488,3
100107,Groceries,27.601043701171875,2024-01-02,86,0,28.369384765625,2439.76708984375,1,1,0,1,77574,3
100107,Groceries,27.601043701171875,2024-01-03,46,0,28.369384765625,1304.99169921875,2,1,0,1,77620,3
100107,Groceries,27.601043701171875,2024-01-04,105,0,28.369384765625,2978.785400390625,3,1,0,1,77725,3
100107,Groceries,27.601043701171875,2024-01-05,91,0,28.369384765625,2581.614013671875,4,1,0,1,77816,3
100107,Groceries,27.601043701171875,2024-01-06,35,0,28.369384765625,992.928466796875,5,1,1,1,77851,3
100107,Groceries,27.601043701171875,2024-01-07,36,0,28.369384765625,1021.2978515625,6,1,1,1,77887,3
100107,Groceries,27.601043701171875,2024-01-08,57,298,24.39874683380127,8317.227139053344,0,1,0,2,77944,3
100107,Groceries,27.601043701171875,2024-01-09,67,0,25.82749366760254,1730.4420757293701,1,1,0,2,78011,3
100107,Groceries,27.601043701171875,2024-01-10,126,607,26.045574836730957,19122.3948588562,2,1,0,2,78137,3
100107,Groceries,27.601043701171875,2024-01-11,49,0,25.981149673461914,1273.0763339996338,3,1,0,2,78186,3
100107,Groceries,27.601043701171875,2024-01-12,182,0,25.981149673461914,4728.569240570068,4,1,0,2,78368,3
100107,Groceries,27.601043701171875,2024-01-13,62,0,25.981149673461914,1610.8312797546387,5,1,1,2,78430,3
100107,Groceries,27.601043701171875,2024-01-14,197,694,28.09376754760742,25382.544413757325,6,1,1,2,78627,3
100107,Groceries,27.601043701171875,2024-01-15,67,0,27.387535095214844,1834.9648513793945,0,1,0,3,78694,3
100107,Groceries,27.601043701171875,2024-01-16,117,0,27.387535095214844,3204.3416061401367,1,1,0,3,78811,3
100107,Groceries,27.601043701171875,2024-01-17,88,0,27.387535095214844,2410.1030883789062,2,1,0,3,78899,3
100107,Groceries,27.601043701171875,2024-01-18,46,0,27.387535095214844,1259.8266143798828,3,1,0,3,78945,3
100107,Groceries,27.601043701171875,2024-01-19,14,0,27.387535095214844,383.4254913330078,4,1,0,3,78959,3
100107,Groceries,27.601043701171875,2024-01-20,24,0,27.387535095214844,657.3008422851562,5,1,1,3,78983,3
100107,Groceries,27.601043701171875,2024-01-21,98,0,27.387535095214844,2683.9784393310547,6,1,1,3,79081,3
100107,Groceries,27.601043701171875,2024-01-22,91,0,27.387535095214844,2492.265693664551,0,1,0,4,79172,3
100107,Groceries,27.601043701171875,2024-01-23,9,0,27.387535095214844,246.4878158569336,1,1,0,4,79181,3
100107,Groceries,27.601043701171875,2024-01-24,88,0,27.387535095214844,2410.1030883789062,2,1,0,4,79269,3
100107,Groceries,27.601043701171875,2024-01-25,114,0,27.387535095214844,3122.179000854492,3,1,0,4,79383,3
100107,Groceries,27.601043701171875,2024-01-26,106,476,24.537931747436524,13948.841530456542,4,1,0,4,79489,3
100107,Groceries,27.601043701171875,2024-01-27,106,0,25.435863494873047,2696.201530456543,5,1,1,4,79595,3
100107,Groceries,27.601043701171875,2024-01-28,90,0,25.435863494873047,2289.227714538574,6,1,1,4,79685,3
100107,Groceries,27.601043701171875,2024-01-29,136,709,28.535521850585937,24647.971943359375,0,1,0,5,79821,3
100107,Groceries,27.601043701171875,2024-01-30,64,0,27.601043701171875,1766.466796875,1,1,0,5,79885,3
100108,Electronics,48.08847427368164,2022-01-01,42,244,37.79000045776367,10807.940038452149,5,1,1,52,42,1
100108,Electronics,48.08847427368164,2022-01-02,37,0,37.790000915527344,1398.2300338745117,6,1,1,52,79,1
100108,Electronics,48.08847427368164,2022-01-03,56,0,37.790000915527344,2116.2400512695312,0,1,0,1,135,1
100108,Electronics,48.08847427368164,2022-01-04,109,141,42.38815971374512,10638.058817596437,1,1,0,1,244,1
100108,Electronics,48.08847427368164,2022-01-05,57,0,41.106319427490234,2343.0602073669434,2,1,0,1,301,1
100108,Electronics,48.08847427368164,2022-01-06,84,108,46.24981948852539,8914.529674072266,3,1,0,1,385,1
100108,Electronics,48.08847427368164,2022-01-07,108,110,46.25431465148925,10084.391964721679,4,1,0,1,493,1
100108,Electronics,48.08847427368164,2022-01-08,69,97,42.98929809570312,7107.963137207031,5,1,1,1,562,1
100108,Electronics,48.08847427368164,2022-01-09,87,0,43.99859619140625,3827.8778686523438,6,1,1,1,649,1
100108,Electronics,48.08847427368164,2022-01-10,51,132,43.6469344329834,7982.777312164307,0,1,0,2,700,1
100108,Electronics,48.08847427368164,2022-01-11,86,96,46.20217262268066,8418.973691101073,1,1,0,2,786,1
100108,Electronics,48.08847427368164,2022-01-12,142,144,40.50520561218262,11581.398393859863,2,1,0,2,928,1
100108,Electronics,48.08847427368164,2022-01-13,102,0,42.050411224365234,4289.141944885254,3,1,0,2,1030,1
100108,Electronics,48.08847427368164,2022-01-14,42,50,38.26857299804688,3511.7601318359375,4,1,0,2,1072,1
100108,Electronics,48.08847427368164,2022-01-15,50,68,39.83075103759766,4702.175103759766,5,1,1,2,1122,1
100108,Electronics,48.08847427368164,2022-01-16,68,137,44.723468170166015,9237.071671142578,6,1,1,2,1190,1
100108,Electronics,48.08847427368164,2022-01-17,88,107,46.05235717773438,8997.454863281251,0,1,0,3,1278,1
100108,Electronics,48.08847427368164,2022-01-18,137,127,41.95402061462403,11088.001648406982,1,1,0,3,1415,1
100108,Electronics,48.08847427368164,2022-01-19,100,103,43.3532007598877,8800.93015197754,2,1,0,3,1515,1
100108,Electronics,48.08847427368164,2022-01-20,73,0,43.27640151977539,3159.1773109436035,3,1,0,3,1588,1
100108,Electronics,48.08847427368164,2022-01-21,76,96,40.36548377990722,6926.353534545899,4,1,0,3,1664,1
100108,Electronics,48.08847427368164,2022-01-22,74,134,44.86185363769531,9389.354338378906,5,1,1,3,1738,1
100108,Electronics,48.08847427368164,2022-01-23,88,0,43.893707275390625,3862.646240234375,6,1,1,3,1826,1
100108,Electronics,48.08847427368164,2022-01-24,51,62,39.95496871948242,4499.566809387207,0,1,0,4,1877,1
100108,Electronics,48.08847427368164,2022-01-25,76,65,41.023419570922854,5785.659774780273,1,1,0,4,1953,1
100108,Electronics,48.08847427368164,2022-01-26,68,130,44.11471008300781,8772.860571289062,2,1,0,4,2021,1
100108,Electronics,48.08847427368164,2022-01-27,130,110,42.209217300415034,10139.79649810791,3,1,0,4,2151,1
100108,Electronics,48.08847427368164,2022-01-28,110,123,52.96473915100098,12382.062613220216,4,1,0,4,2261,1
100108,Electronics,48.08847427368164,2022-01-29,85,97,46.756739654541015,8495.605741271973,5,1,1,4,2346,1
100108,Electronics,48.08847427368164,2022-01-30,85,160,49.997575454711914,12295.337827301026,6,1,1,4,2431,1
100108,Electronics,48.08847427368164,2022-01-31,64,0,49.38515090942383,3160.649658203125,0,1,0,5,2495,1
100108,Electronics,48.08847427368164,2022-02-01,77,135,42.77863357543946,8934.589570617676,1,2,0,5,2572,1
100108,Electronics,48.08847427368164,2022-02-02,82,0,45.097267150878906,3697.9759063720703,2,2,0,5,2654,1
100108,Electronics,48.08847427368164,2022-02-03,69,0,45.097267150878906,3111.7114334106445,3,2,0,5,2723,1
100108,Electronics,48.08847427368164,2022-02-04,53,71,41.55324546813965,5135.264019622803,4,2,0,5,2776,1
100108,Electronics,48.08847427368164,2022-02-05,71,78,41.26990264892578,6146.486176147461,5,2,1,5,2847,1
100108,Electronics,48.08847427368164,2022-02-06,78,131,42.53843223571778,8901.215428771973,6,2,1,5,2925,1
100108,Electronics,48.08847427368164,2022-02-07,131,191,50.76721855163574,16476.211260528566,0,2,0,6,3056,1
100108,Electronics,48.08847427368164,2022-02-08,135,0,48.614437103271484,6562.94900894165,1,2,0,6,3191,1
100108,Electronics,48.08847427368164,2022-02-09,56,185,59.56101417541504,14539.833587646484,2,2,0,6,3247,1
100108,Electronics,48.08847427368164,2022-02-10,123,0,58.12202835083008,7149.0094871521,3,2,0,6,3370,1
100108,Electronics,48.08847427368164,2022-02-11,62,89,49.09260261535644,7350.002724304199,4,2,0,6,3432,1
100108,Electronics,48.08847427368164,2022-02-12,89,89,42.60130126953125,7583.031625976562,5,2,1,6,3521,1
100108,Electronics,48.08847427368164,2022-02-13,83,79,42.092980194091794,6824.034712219238,6,2,1,6,3604,1
100108,Electronics,48.08847427368164,2022-02-14,85,170,44.722660064697266,11427.852210998535,0,2,0,7,3689,1
100108,Electronics,48.08847427368164,2022-02-15,88,0,44.44532012939453,3911.1881713867188,1,2,0,7,3777,1
100108,Electronics,48.08847427368164,2022-02-16,66,55,39.9709351348877,4857.503437805176,2,2,0,7,3843,1
100108,Electronics,48.08847427368164,2022-02-17,71,115,43.433905029296874,8094.814514160156,3,2,0,7,3914,1
100108,Electronics,48.08847427368164,2022-02-18,115,106,46.15447532653809,10190.36932510376,4,2,0,7,4029,1
100108,Electronics,48.08847427368164,2022-02-19,106,156,53.19845092773437,14041.071596679687,5,2,1,7,4135,1
100108,Electronics,48.08847427368164,2022-02-20,105,122,48.0456046295166,10885.856972198486,6,2,1,7,4240,1
100108,Electronics,48.08847427368164,2022-02-21,134,157,44.30652847290039,12852.799630737303,0,2,0,8,4374,1
100108,Electronics,48.08847427368164,2022-02-22,60,0,46.06305694580078,2763.783416748047,1,2,0,8,4434,1
100108,Electronics,48.08847427368164,2022-02-23,123,105,45.80243835449219,10444.799835205078,2,2,0,8,4557,1
100108,Electronics,48.08847427368164,2022-02-24,36,0,45.904876708984375,1652.5755615234375,3,2,0,8,4593,1
100108,Electronics,48.08847427368164,2022-02-25,82,81,41.39545959472656,6748.975373535157,4,2,0,8,4675,1
100108,Electronics,48.08847427368164,2022-02-26,81,153,42.90189094543457,10038.906333160401,5,2,1,8,4756,1
100108,Electronics,48.08847427368164,2022-02-27,92,0,42.90378189086914,3947.147933959961,6,2,1,8,4848,1
100108,Electronics,48.08847427368164,2022-02-28,39,50,37.63590461730957,3327.6405601501465,0,2,0,9,4887,1
100108,Electronics,48.08847427368164,2022-03-01,72,130,42.22715522766113,8562.530352783204,1,3,0,9,4959,1
100108,Electronics,48.08847427368164,2022-03-02,39,0,41.664310455322266,1624.9081077575684,2,3,0,9,4998,1
100108,Electronics,48.08847427368164,2022-03-03,88,100,45.88890693664551,8642.96762084961,3,3,0,9,5086,1
100108,Electronics,48.08847427368164,2022-03-04,103,104,46.868152084350584,9702.469329376221,4,3,0,9,5189,1
100108,Electronics,48.08847427368164,2022-03-05,88,132,43.68444061279297,9580.461547851562,5,3,1,9,5277,1
100108,Electronics,48.08847427368164,2022-03-06,136,122,42.58391578674316,10996.085093994141,6,3,1,9,5413,1
100108,Electronics,48.08847427368164,2022-03-07,112,137,43.72618049621582,10891.664431152345,0,3,0,10,5525,1
100108,Electronics,48.08847427368164,2022-03-08,113,0,43.57236099243164,4923.676792144775,1,3,0,10,5638,1
100108,Electronics,48.08847427368164,2022-03-09,46,141,46.43809692382813,8722.104916992188,2,3,0,10,5684,1
100108,Electronics,48.08847427368164,2022-03-10,105,108,46.50488540649414,9906.09593536377,3,3,0,10,5789,1
100108,Electronics,48.08847427368164,2022-03-11,124,120,41.94175567626953,10240.355407714844,4,3,0,10,5913,1
100108,Electronics,48.08847427368164,2022-03-12,102,137,48.2738835144043,11592.972236938476,5,3,1,10,6015,1
100108,Electronics,48.08847427368164,2022-03-13,111,0,46.687767028808594,5182.342140197754,6,3,1,10,6126,1
100108,Electronics,48.08847427368164,2022-03-14,64,109,52.50074211120605,9141.994990234376,0,3,0,11,6190,1
100108,Electronics,48.08847427368164,2022-03-15,90,135,48.640720443725584,10911.279679870604,1,3,0,11,6280,1
100108,Electronics,48.08847427368164,2022-03-16,76,0,49.37144088745117,3752.229507446289,2,3,0,11,6356,1
100108,Electronics,48.08847427368164,2022-03-17,78,120,39.0352840423584,7622.50431060791,3,3,0,11,6434,1
100108,Electronics,48.08847427368164,2022-03-18,78,91,44.697508544921874,7570.0313330078125,4,3,0,11,6512,1
100108,Electronics,48.08847427368164,2022-03-19,119,80,46.553514938354496,9209.296555328368,5,3,1,11,6631,1
100108,Electronics,48.08847427368164,2022-03-20,94,144,41.63437057495118,9865.761668090821,6,3,1,11,6725,1
100108,Electronics,48.08847427368164,2022-03-21,90,114,47.43802146911621,9723.24386444092,0,3,0,12,6815,1
100108,Electronics,48.08847427368164,2022-03-22,122,0,45.52604293823242,5554.1772384643555,1,3,0,12,6937,1
100108,Electronics,48.08847427368164,2022-03-23,21,50,37.36978187561035,2578.7308387756348,2,3,0,12,6958,1
100108,Electronics,48.08847427368164,2022-03-24,75,113,44.719089584350584,8452.443437652588,3,3,0,12,7033,1
100108,Electronics,48.08847427368164,2022-03-25,113,115,47.10998680114746,10743.437017059325,4,3,0,12,7146,1
100108,Electronics,48.08847427368164,2022-03-26,102,102,45.665384445190426,9315.738426818847,5,3,1,12,7248,1
100108,Electronics,48.08847427368164,2022-03-27,115,115,44.93519218444824,10335.094202423095,6,3,1,12,7363,1
100108,Electronics,48.08847427368164,2022-03-28,85,73,41.39229820251465,6560.17069442749,0,3,0,13,7448,1
100108,Electronics,48.08847427368164,2022-03-29,103,144,51.4450065612793,12797.321351623534,1,3,0,13,7551,1
100108,Electronics,48.08847427368164,2022-03-30,57,0,49.240013122558594,2806.68074798584,2,3,0,13,7608,1
100108,Electronics,48.08847427368164,2022-03-31,87,90,47.588222885131835,8421.50078201294,3,3,0,13,7695,1
100108,Electronics,48.08847427368164,2022-04-01,73,98,44.447659988403316,7571.608358306885,4,4,0,13,7768,1
100108,Electronics,48.08847427368164,2022-04-02,63,0,45.60531997680664,2873.1351585388184,5,4,1,13,7831,1
100108,Electronics,48.08847427368164,2022-04-03,52,113,50.849141159057616,8449.940680541993,6,4,1,13,7883,1
100108,Electronics,48.08847427368164,2022-04-04,22,0,49.868282318115234,1097.1022109985352,0,4,0,14,7905,1
100108,Electronics,48.08847427368164,2022-04-05,57,79,42.33362869262695,5696.793670959472,1,4,0,14,7962,1
100108,Electronics,48.08847427368164,2022-04-06,94,98,41.46473915100098,7955.930960388184,2,4,0,14,8056,1
100108,Electronics,48.08847427368164,2022-04-07,61,0,42.78947830200195,2610.158176422119,3,4,0,14,8117,1
100108,Electronics,48.08847427368164,2022-04-08,56,107,39.319664764404294,6372.402453613281,4,4,0,14,8173,1
100108,Electronics,48.08847427368164,2022-04-09,70,0,40.039329528808594,2802.7530670166016,5,4,1,14,8243,1
100108,Electronics,48.08847427368164,2022-04-10,37,71,38.20844940185547,4113.645255737305,6,4,1,14,8280,1
100108,Electronics,48.08847427368164,2022-04-11,71,174,40.83846794128418,10044.722447662352,0,4,0,15,8351,1
100108,Electronics,48.08847427368164,2022-04-12,28,0,40.45693588256836,1132.794204711914,1,4,0,15,8379,1
100108,Electronics,48.08847427368164,2022-04-13,115,130,46.247632064819335,11361.905374908447,2,4,0,15,8494,1
100108,Electronics,48.08847427368164,2022-04-14,81,0,44.16526412963867,3577.3863945007324,3,4,0,15,8575,1
100108,Electronics,48.08847427368164,2022-04-15,80,127,47.315462265014645,9829.763962402343,4,4,0,15,8655,1
100108,Electronics,48.08847427368164,2022-04-16,121,123,40.71905540466308,9931.471407928468,5,4,1,15,8776,1
100108,Electronics,48.08847427368164,2022-04-17,102,84,40.785203552246095,7601.081524658203,6,4,1,15,8878,1
100108,Electronics,48.08847427368164,2022-04-18,60,0,41.62040710449219,2497.2244262695312,0,4,0,16,8938,1
100108,Electronics,48.08847427368164,2022-04-19,51,101,39.38135131835938,5963.3978344726565,1,4,0,16,8989,1
100108,Electronics,48.08847427368164,2022-04-20,101,157,45.19496726989746,11733.383388519287,2,4,0,16,9090,1
100108,Electronics,48.08847427368164,2022-04-21,74,0,43.88993453979492,3247.855155944824,3,4,0,16,9164,1
100108,Electronics,48.08847427368164,2022-04-22,83,195,54.175188293457026,15262.841256713866,4,4,0,16,9247,1
100108,Electronics,48.08847427368164,2022-04-23,87,0,52.37037658691406,4556.222763061523,5,4,1,16,9334,1
100108,Electronics,48.08847427368164,2022-04-24,108,117,41.26648986816406,9253.401811523438,6,4,1,16,9442,1
100108,Electronics,48.08847427368164,2022-04-25,44,0,44.772979736328125,1970.0111083984375,0,4,0,17,9486,1
100108,Electronics,48.08847427368164,2022-04-26,48,79,41.84522148132324,5285.6612622070315,1,4,0,17,9534,1
100108,Electronics,48.08847427368164,2022-04-27,73,77,35.42924247741699,5302.549401702881,2,4,0,17,9607,1
100108,Electronics,48.08847427368164,2022-04-28,30,0,38.388484954833984,1151.6545486450195,3,4,0,17,9637,1
100108,Electronics,48.08847427368164,2022-04-29,39,50,39.34906936645508,3506.697410583496,4,4,0,17,9676,1
100108,Electronics,48.08847427368164,2022-04-30,35,0,38.928138732910156,1362.4848556518555,5,4,1,17,9711,1
100108,Electronics,48.08847427368164,2022-05-01,54,54,37.40703506469727,4039.9597869873046,6,5,1,17,9765,1
100108,Electronics,48.08847427368164,2022-05-02,29,50,33.83894165039062,2643.2686157226562,0,5,0,18,9794,1
100108,Electronics,48.08847427368164,2022-05-03,38,0,35.26788330078125,1340.1795654296875,1,5,0,18,9832,1
100108,Electronics,48.08847427368164,2022-05-04,37,50,38.95437774658203,3401.9739532470703,2,5,0,18,9869,1
100108,Electronics,48.08847427368164,2022-05-05,24,50,34.704689559936526,2539.945098876953,3,5,0,18,9893,1
100108,Electronics,48.08847427368164,2022-05-06,28,50,35.64314559936523,2778.776153564453,4,5,0,18,9921,1
100108,Electronics,48.08847427368164,2022-05-07,66,0,35.70629119873047,2356.615219116211,5,5,1,18,9987,1
100108,Electronics,48.08847427368164,2022-05-08,27,50,33.94659400939942,2604.0760765075684,6,5,1,18,10014,1
100108,Electronics,48.08847427368164,2022-05-09,39,50,37.714406204223636,3369.6236839294434,0,5,0,19,10053,1
100108,Electronics,48.08847427368164,2022-05-10,66,90,37.972633056640625,5933.027563476562,1,5,0,19,10119,1
100108,Electronics,48.08847427368164,2022-05-11,63,50,35.61383613586426,4036.5033531188965,2,5,0,19,10182,1
100108,Electronics,48.08847427368164,2022-05-12,28,0,36.547672271728516,1023.3348236083984,3,5,0,19,10210,1
100108,Electronics,48.08847427368164,2022-05-13,49,62,35.54421699523925,3941.713265533447,4,5,0,19,10259,1
100108,Electronics,48.08847427368164,2022-05-14,62,70,38.438799972534184,5080.3311965942385,5,5,1,19,10321,1
100108,Electronics,48.08847427368164,2022-05-15,55,58,38.336844253540036,4332.8528678894045,6,5,1,19,10376,1
100108,Electronics,48.08847427368164,2022-05-16,22,0,38.07368850708008,837.6211471557617,0,5,0,20,10398,1
100108,Electronics,48.08847427368164,2022-05-17,51,87,42.529920120239254,5905.491852264404,1,5,0,20,10449,1
100108,Electronics,48.08847427368164,2022-05-18,46,62,39.68609413146973,4274.000660095215,2,5,0,20,10495,1
100108,Electronics,48.08847427368164,2022-05-19,47,0,40.44218826293945,1900.7828483581543,3,5,0,20,10542,1
100108,Electronics,48.08847427368164,2022-05-20,48,50,34.56850288391114,3383.4962768554688,4,5,0,20,10590,1
100108,Electronics,48.08847427368164,2022-05-21,6,0,36.677005767822266,220.0620346069336,5,5,1,20,10596,1
100108,Electronics,48.08847427368164,2022-05-22,39,50,35.57649192810059,3162.1663703918457,6,5,1,20,10635,1
100108,Electronics,48.08847427368164,2022-05-23,50,53,38.71891403198242,3991.141403198242,0,5,0,21,10685,1
100108,Electronics,48.08847427368164,2022-05-24,66,50,32.93119194030761,3850.2773361206055,1,5,0,21,10751,1
100108,Electronics,48.08847427368164,2022-05-25,50,77,32.2744857788086,4081.998577880859,2,5,0,21,10801,1
100108,Electronics,48.08847427368164,2022-05-26,53,76,42.089675750732425,5500.645629577637,3,5,0,21,10854,1
100108,Electronics,48.08847427368164,2022-05-27,100,134,42.6955867767334,10024.917355346679,4,5,0,21,10954,1
100108,Electronics,48.08847427368164,2022-05-28,126,89,43.45322273254395,9314.442128601075,5,5,1,21,11080,1
100108,Electronics,48.08847427368164,2022-05-29,97,174,52.9704899597168,14527.44505218506,6,5,1,21,11177,1
100108,Electronics,48.08847427368164,2022-05-30,122,0,50.730979919433594,6189.179550170898,0,5,0,22,11299,1
100108,Electronics,48.08847427368164,2022-05-31,52,140,48.57732116699219,9297.161401367188,1,5,0,22,11351,1
100108,Electronics,48.08847427368164,2022-06-01,70,0,48.914642333984375,3424.0249633789062,2,6,0,22,11421,1
100108,Electronics,48.08847427368164,2022-06-02,70,83,37.64321937561035,5715.950712585449,3,6,0,22,11491,1
100108,Electronics,48.08847427368164,2022-06-03,67,94,41.61690452575684,6705.535206451416,4,6,0,22,11558,1
100108,Electronics,48.08847427368164,2022-06-04,110,156,49.07548728942871,13145.827203674316,5,6,1,22,11668,1
100108,Electronics,48.08847427368164,2022-06-05,76,0,47.08097457885742,3578.154067993164,6,6,1,22,11744,1
100108,Electronics,48.08847427368164,2022-06-06,56,87,37.11035285949707,5209.429520263671,0,6,0,23,11800,1
100108,Electronics,48.08847427368164,2022-06-07,48,0,40.25070571899414,1932.0338745117188,1,6,0,23,11848,1
100108,Electronics,48.08847427368164,2022-06-08,52,84,43.33015151977539,5919.775758056641,2,6,0,23,11900,1
100108,Electronics,48.08847427368164,2022-06-09,95,106,46.56049362182617,9372.513788146973,3,6,0,23,11995,1
100108,Electronics,48.08847427368164,2022-06-10,106,161,50.662217254638676,13599.840057983398,4,6,0,23,12101,1
100108,Electronics,48.08847427368164,2022-06-11,63,0,49.334434509277344,3108.0693740844727,5,6,1,23,12164,1
100108,Electronics,48.08847427368164,2022-06-12,55,76,42.27665031433105,5480.141534576416,6,6,1,23,12219,1
100108,Electronics,48.08847427368164,2022-06-13,64,113,38.966169891357424,6794.2997460937495,0,6,0,24,12283,1
100108,Electronics,48.08847427368164,2022-06-14,64,0,41.062339782714844,2627.98974609375,1,6,0,24,12347,1
100108,Electronics,48.08847427368164,2022-06-15,22,0,41.062339782714844,903.3714752197266,2,6,0,24,12369,1
100108,Electronics,48.08847427368164,2022-06-16,46,60,40.01511184692383,4235.650289916992,3,6,0,24,12415,1
100108,Electronics,48.08847427368164,2022-06-17,83,122,46.75656272888183,9654.649412994386,4,6,0,24,12498,1
100108,Electronics,48.08847427368164,2022-06-18,54,0,44.97312545776367,2428.5487747192383,5,6,1,24,12552,1
100108,Electronics,48.08847427368164,2022-06-19,81,81,42.53328071594238,6890.391475982666,6,6,1,24,12633,1
100108,Electronics,48.08847427368164,2022-06-20,81,128,41.26928688049317,8601.814474639894,0,6,0,25,12714,1
100108,Electronics,48.08847427368164,2022-06-21,117,115,47.63316368103027,11046.700301361085,1,6,0,25,12831,1
100108,Electronics,48.08847427368164,2022-06-22,126,166,43.021775283813476,12534.687371520995,2,6,0,25,12957,1
100108,Electronics,48.08847427368164,2022-06-23,117,0,43.71355056762695,5114.4854164123535,3,6,0,25,13074,1
100108,Electronics,48.08847427368164,2022-06-24,49,122,44.395890121459956,7600.0272319030755,4,6,0,25,13123,1
100108,Electronics,48.08847427368164,2022-06-25,121,95,44.258934020996094,9560.162033081055,5,6,1,25,13244,1
100108,Electronics,48.08847427368164,2022-06-26,96,197,49.336886444091796,14556.012197265625,6,6,1,25,13340,1
100108,Electronics,48.08847427368164,2022-06-27,127,0,48.343772888183594,6139.659156799316,0,6,0,26,13467,1
100108,Electronics,48.08847427368164,2022-06-28,70,159,49.84005325317383,11437.397455444336,1,6,0,26,13537,1
100108,Electronics,48.08847427368164,2022-06-29,40,0,49.570106506347656,1982.8042602539062,2,6,0,26,13577,1
100108,Electronics,48.08847427368164,2022-06-30,12,0,49.570106506347656,594.8412780761719,3,6,0,26,13589,1
100108,Electronics,48.08847427368164,2022-07-01,72,0,49.570106506347656,3569.0476684570312,4,7,0,26,13661,1
100108,Electronics,48.08847427368164,2022-07-02,34,62,34.00604919433594,3168.651345214844,5,7,1,26,13695,1
100108,Electronics,48.08847427368164,2022-07-03,30,50,38.37540733337403,3077.3244400024414,6,7,1,26,13725,1
100108,Electronics,48.08847427368164,2022-07-04,70,73,40.14608093261719,5743.211330566406,0,7,0,27,13795,1
100108,Electronics,48.08847427368164,2022-07-05,24,0,39.372161865234375,944.931884765625,1,7,0,27,13819,1
100108,Electronics,48.08847427368164,2022-07-06,44,50,39.14640167236328,3679.2433471679688,2,7,0,27,13863,1
100108,Electronics,48.08847427368164,2022-07-07,62,53,38.63401145935059,4445.0174209594725,3,7,0,27,13925,1
100108,Electronics,48.08847427368164,2022-07-08,59,103,43.49896110534668,7092.197410430908,4,7,0,27,13984,1
100108,Electronics,48.08847427368164,2022-07-09,80,77,37.37937728881836,5874.680366210938,5,7,1,27,14064,1
100108,Electronics,48.08847427368164,2022-07-10,31,0,39.41875457763672,1221.9813919067383,6,7,1,27,14095,1
100108,Electronics,48.08847427368164,2022-07-11,69,56,33.75797538757324,4247.800603485108,0,7,0,28,14164,1
100108,Electronics,48.08847427368164,2022-07-12,56,78,38.300199356079105,5146.082327880859,1,7,0,28,14220,1
100108,Electronics,48.08847427368164,2022-07-13,52,94,43.19886985778808,6375.122465209961,2,7,0,28,14272,1
100108,Electronics,48.08847427368164,2022-07-14,34,0,41.57773971557617,1413.6431503295898,3,7,0,28,14306,1
100108,Electronics,48.08847427368164,2022-07-15,35,0,41.57773971557617,1455.220890045166,4,7,0,28,14341,1
100108,Electronics,48.08847427368164,2022-07-16,47,54,39.997021789550786,4036.1500482177735,5,7,1,28,14388,1
100108,Electronics,48.08847427368164,2022-07-17,35,50,35.673308563232425,3005.6315994262695,6,7,1,28,14423,1
100108,Electronics,48.08847427368164,2022-07-18,45,50,38.124118881225584,3623.2206993103027,0,7,0,29,14468,1
100108,Electronics,48.08847427368164,2022-07-19,72,74,39.66836395263672,5792.844409179687,1,7,0,29,14540,1
100108,Electronics,48.08847427368164,2022-07-20,26,0,39.03672790527344,1014.9549255371094,2,7,0,29,14566,1
100108,Electronics,48.08847427368164,2022-07-21,54,93,37.121031494140624,5439.981401367188,3,7,0,29,14620,1
100108,Electronics,48.08847427368164,2022-07-22,65,81,35.96779281616211,5242.053066101074,4,7,0,29,14685,1
100108,Electronics,48.08847427368164,2022-07-23,50,69,38.59541893005371,4610.041893005371,5,7,1,29,14735,1
100108,Electronics,48.08847427368164,2022-07-24,37,0,37.69083786010742,1394.5610008239746,6,7,1,29,14772,1
100108,Electronics,48.08847427368164,2022-07-25,91,127,44.566436233520506,9780.771394500733,0,7,0,30,14863,1
100108,Electronics,48.08847427368164,2022-07-26,127,110,39.50039031982422,9381.829141235352,1,7,0,30,14990,1
100108,Electronics,48.08847427368164,2022-07-27,104,147,45.60261795043945,11503.764533691407,2,7,0,30,15094,1
100108,Electronics,48.08847427368164,2022-07-28,72,0,44.265235900878906,3187.0969848632812,3,7,0,30,15166,1
100108,Electronics,48.08847427368164,2022-07-29,81,95,42.90620422363281,7545.805084228516,4,7,0,30,15247,1
100108,Electronics,48.08847427368164,2022-07-30,95,96,44.159579010009764,8434.760011901855,5,7,1,30,15342,1
100108,Electronics,48.08847427368164,2022-07-31,96,121,44.55737113952637,9673.765258789062,6,7,1,30,15438,1
100108,Electronics,48.08847427368164,2022-08-01,78,0,44.364742279052734,3460.4498977661133,0,8,0,31,15516,1
100108,Electronics,48.08847427368164,2022-08-02,43,63,43.133320007324215,4565.865520629883,1,8,0,31,15559,1
100108,Electronics,48.08847427368164,2022-08-03,63,148,51.19096794128418,10916.811960601806,2,8,0,31,15622,1
100108,Electronics,48.08847427368164,2022-08-04,75,0,49.83193588256836,3737.395191192627,3,8,0,31,15697,1
100108,Electronics,48.08847427368164,2022-08-05,72,87,41.80294212341309,6611.073665771484,4,8,0,31,15769,1
100108,Electronics,48.08847427368164,2022-08-06,70,73,40.399994125366206,5772.9391775512695,5,8,1,31,15839,1
100108,Electronics,48.08847427368164,2022-08-07,91,136,44.74638389587402,10190.441869049071,6,8,1,31,15930,1
100108,Electronics,48.08847427368164,2022-08-08,58,0,44.01276779174805,2552.7405319213867,0,8,0,32,15988,1
100108,Electronics,48.08847427368164,2022-08-09,78,126,48.30538192749023,9902.999580688476,1,8,0,32,16066,1
100108,Electronics,48.08847427368164,2022-08-10,43,0,47.29076385498047,2033.5028457641602,2,8,0,32,16109,1
100108,Electronics,48.08847427368164,2022-08-11,83,161,50.767486801147456,12442.842808990477,3,8,0,32,16192,1
100108,Electronics,48.08847427368164,2022-08-12,106,125,46.63119079589843,10746.322448730469,4,8,0,32,16298,1
100108,Electronics,48.08847427368164,2022-08-13,123,184,49.4459741973877,15209.439652557374,5,8,1,32,16421,1
100108,Electronics,48.08847427368164,2022-08-14,88,0,48.96194839477539,4308.651458740234,6,8,1,32,16509,1
100108,Electronics,48.08847427368164,2022-08-15,107,117,49.15405296325683,11011.267334136963,0,8,0,33,16616,1
100108,Electronics,48.08847427368164,2022-08-16,56,0,49.07810592651367,2748.3739318847656,1,8,0,33,16672,1
100108,Electronics,48.08847427368164,2022-08-17,87,97,45.87768852233887,8430.117802886962,2,8,0,33,16759,1
100108,Electronics,48.08847427368164,2022-08-18,46,0,47.015377044677734,2162.707344055176,3,8,0,33,16805,1
100108,Electronics,48.08847427368164,2022-08-19,71,158,40.96078948974609,9283.382107543945,4,8,0,33,16876,1
100108,Electronics,48.08847427368164,2022-08-20,60,0,42.07157897949219,2524.2947387695312,5,8,1,33,16936,1
100108,Electronics,48.08847427368164,2022-08-21,88,90,44.022325973510746,7837.34937133789,6,8,1,33,17024,1
100108,Electronics,48.08847427368164,2022-08-22,100,113,41.157759780883794,8757.921956176757,0,8,0,34,17124,1
100108,Electronics,48.08847427368164,2022-08-23,113,99,47.82142448425293,10107.641933441162,1,8,0,34,17237,1
100108,Electronics,48.08847427368164,2022-08-24,82,117,42.87336196899414,8502.981362915038,2,8,0,34,17319,1
100108,Electronics,48.08847427368164,2022-08-25,130,158,44.01517265319824,12679.024889831544,3,8,0,34,17449,1
100108,Electronics,48.08847427368164,2022-08-26,100,0,43.920345306396484,4392.034530639648,4,8,0,34,17549,1
100108,Electronics,48.08847427368164,2022-08-27,62,155,54.01719245910645,11878.2318649292,5,8,1,34,17611,1
100108,Electronics,48.08847427368164,2022-08-28,119,0,52.33438491821289,6227.791805267334,6,8,1,34,17730,1
100108,Electronics,48.08847427368164,2022-08-29,36,52,39.48430618286133,3421.7500451660153,0,8,0,35,17766,1
100108,Electronics,48.08847427368164,2022-08-30,52,116,46.05240364074707,7775.049978637695,1,8,0,35,17818,1
100108,Electronics,48.08847427368164,2022-08-31,77,96,46.352070541381835,8025.3288633728025,2,8,0,35,17895,1
100108,Electronics,48.08847427368164,2022-09-01,71,84,46.032029647827144,7135.068209991456,3,9,0,35,17966,1
100108,Electronics,48.08847427368164,2022-09-02,122,147,49.7218327331543,13406.127186889647,4,9,0,35,18088,1
100108,Electronics,48.08847427368164,2022-09-03,104,0,48.483665466308594,5042.301208496094,5,9,1,35,18192,1
100108,Electronics,48.08847427368164,2022-09-04,59,75,38.04035758972168,5044.762195587158,6,9,1,35,18251,1
100108,Electronics,48.08847427368164,2022-09-05,85,91,41.944576568603516,7383.418016662597,0,9,0,36,18336,1
100108,Electronics,48.08847427368164,2022-09-06,68,99,44.19108627319336,7403.747733154297,1,9,0,36,18404,1
100108,Electronics,48.08847427368164,2022-09-07,122,166,46.89639762878418,13547.241021423339,2,9,0,36,18526,1
100108,Electronics,48.08847427368164,2022-09-08,19,0,45.96279525756836,873.2931098937988,3,9,0,36,18545,1
100108,Electronics,48.08847427368164,2022-09-09,66,0,45.96279525756836,3033.5444869995117,4,9,0,36,18611,1
100108,Electronics,48.08847427368164,2022-09-10,81,162,53.310467376708985,13073.475715026856,5,9,1,36,18692,1
100108,Electronics,48.08847427368164,2022-09-11,23,0,51.84093475341797,1192.3414993286133,6,9,1,36,18715,1
100108,Electronics,48.08847427368164,2022-09-12,72,128,51.27067390441894,10242.897042236327,0,9,0,37,18787,1
100108,Electronics,48.08847427368164,2022-09-13,86,0,51.47134780883789,4426.535911560059,1,9,0,37,18873,1
100108,Electronics,48.08847427368164,2022-09-14,109,112,42.715899276733396,9431.616042327882,2,9,0,37,18982,1
100108,Electronics,48.08847427368164,2022-09-15,54,94,39.31107078552246,5724.395644836426,3,9,0,37,19036,1
100108,Electronics,48.08847427368164,2022-09-16,122,144,38.12757690429687,10115.148764648437,4,9,0,37,19158,1
100108,Electronics,48.08847427368164,2022-09-17,111,0,39.34515380859375,4367.312072753906,5,9,1,37,19269,1
100108,Electronics,48.08847427368164,2022-09-18,63,76,39.735592651367185,5524.734674072266,6,9,1,37,19332,1
100108,Electronics,48.08847427368164,2022-09-19,76,103,45.00030860900879,8094.196908569336,0,9,0,38,19408,1
100108,Electronics,48.08847427368164,2022-09-20,41,0,43.55061721801758,1785.5753059387207,1,9,0,38,19449,1
100108,Electronics,48.08847427368164,2022-09-21,46,60,37.35171424865723,3929.717710876465,2,9,0,38,19495,1
100108,Electronics,48.08847427368164,2022-09-22,76,140,39.63365837097168,8563.196072387695,3,9,0,38,19571,1
100108,Electronics,48.08847427368164,2022-09-23,116,0,39.59731674194336,4593.28874206543,4,9,0,38,19687,1
100108,Electronics,48.08847427368164,2022-09-24,24,124,45.83924133300781,6839.283583984375,5,9,1,38,19711,1
100108,Electronics,48.08847427368164,2022-09-25,60,0,45.288482666015625,2717.3089599609375,6,9,1,38,19771,1
100108,Electronics,48.08847427368164,2022-09-26,64,71,41.58927032470703,5606.5066015625,0,9,0,39,19835,1
100108,Electronics,48.08847427368164,2022-09-27,71,115,47.64310874938965,8912.52144241333,1,9,0,39,19906,1
100108,Electronics,48.08847427368164,2022-09-28,92,156,49.38050659179687,12296.253212890624,2,9,0,39,19998,1
100108,Electronics,48.08847427368164,2022-09-29,43,0,48.60101318359375,2089.8435668945312,3,9,0,39,20041,1
100108,Electronics,48.08847427368164,2022-09-30,68,0,48.60101318359375,3304.868896484375,4,9,0,39,20109,1
100108,Electronics,48.08847427368164,2022-10-01,68,148,45.381455078125,9754.277890625,5,10,1,39,20177,1
100108,Electronics,48.08847427368164,2022-10-02,99,145,45.479951171875,11089.29033203125,6,10,1,39,20276,1
100108,Electronics,48.08847427368164,2022-10-03,134,0,45.64990234375,6117.0869140625,0,10,0,40,20410,1
100108,Electronics,48.08847427368164,2022-10-04,59,99,44.25450881958008,6979.232040710449,1,10,0,40,20469,1
100108,Electronics,48.08847427368164,2022-10-05,100,88,45.36516494750977,8525.232989501954,2,10,0,40,20569,1
100108,Electronics,48.08847427368164,2022-10-06,88,128,43.423770904541016,9362.583679199219,3,10,0,40,20657,1
100108,Electronics,48.08847427368164,2022-10-07,128,172,47.9558755493164,14435.784140625,4,10,0,40,20785,1
100108,Electronics,48.08847427368164,2022-10-08,121,0,46.84175109863281,5667.85188293457,5,10,1,40,20906,1
100108,Electronics,48.08847427368164,2022-10-09,49,50,42.9234130859375,4248.094482421875,6,10,1,40,20955,1
100108,Electronics,48.08847427368164,2022-10-10,52,121,41.666401367187504,7176.7957421875,0,10,0,41,21007,1
100108,Electronics,48.08847427368164,2022-10-11,6,0,42.122802734375,252.73681640625,1,10,0,41,21013,1
100108,Electronics,48.08847427368164,2022-10-12,58,90,45.8118839263916,6826.178535461426,2,10,0,41,21071,1
100108,Electronics,48.08847427368164,2022-10-13,65,0,44.3737678527832,2884.294910430908,3,10,0,41,21136,1
100108,Electronics,48.08847427368164,2022-10-14,82,109,40.84463066101074,7775.279428405762,4,10,0,41,21218,1
100108,Electronics,48.08847427368164,2022-10-15,62,0,41.809261322021484,2592.174201965332,5,10,1,41,21280,1
100108,Electronics,48.08847427368164,2022-10-16,47,50,37.14976890563965,3599.058277130127,6,10,1,41,21327,1
100108,Electronics,48.08847427368164,2022-10-17,50,97,42.25842475891113,6246.842475891113,0,10,0,42,21377,1
100108,Electronics,48.08847427368164,2022-10-18,58,89,45.68853385925293,6761.82992767334,1,10,0,42,21435,1
100108,Electronics,48.08847427368164,2022-10-19,94,0,44.21706771850586,4156.404365539551,2,10,0,42,21529,1
100108,Electronics,48.08847427368164,2022-10-20,34,83,42.89478775024414,5007.675567016602,3,10,0,42,21563,1
100108,Electronics,48.08847427368164,2022-10-21,73,84,40.69255859375,6379.9035546875,4,10,0,42,21636,1
100108,Electronics,48.08847427368164,2022-10-22,94,98,44.80661720275879,8607.164034118654,5,10,1,42,21730,1
100108,Electronics,48.08847427368164,2022-10-23,98,136,49.58110565185547,11660.836707763672,6,10,1,42,21828,1
100108,Electronics,48.08847427368164,2022-10-24,125,158,50.40581756591797,14288.414391479491,0,10,0,43,21953,1
100108,Electronics,48.08847427368164,2022-10-25,87,0,49.69163513183594,4323.172256469727,1,10,0,43,22040,1
100108,Electronics,48.08847427368164,2022-10-26,44,50,38.722250595092774,3610.238052368164,2,10,0,43,22084,1
100108,Electronics,48.08847427368164,2022-10-27,49,86,42.21171318054199,5680.387891693115,3,10,0,43,22133,1
100108,Electronics,48.08847427368164,2022-10-28,123,131,44.802126159667964,11385.16303527832,4,10,0,43,22256,1
100108,Electronics,48.08847427368164,2022-10-29,46,0,44.12425231933594,2029.7156066894531,5,10,1,43,22302,1
100108,Electronics,48.08847427368164,2022-10-30,68,84,43.03248413085937,6534.977841796875,6,10,1,43,22370,1
100108,Electronics,48.08847427368164,2022-10-31,103,85,44.28715950012207,8319.994857025147,0,10,0,44,22473,1
100108,Electronics,48.08847427368164,2022-11-01,27,0,43.95431900024414,1186.7666130065918,1,11,0,44,22500,1
100108,Electronics,48.08847427368164,2022-11-02,58,169,45.55548431396484,10367.126180419922,2,11,0,44,22558,1
100108,Electronics,48.08847427368164,2022-11-03,121,0,45.32096862792969,5483.837203979492,3,11,0,44,22679,1
100108,Electronics,48.08847427368164,2022-11-04,48,59,35.414516830444335,3757.843615722656,4,11,0,44,22727,1
100108,Electronics,48.08847427368164,2022-11-05,59,107,41.72521911621094,6962.135855712891,5,11,1,44,22786,1
100108,Electronics,48.08847427368164,2022-11-06,107,151,41.1941032409668,10630.538093566895,6,11,1,44,22893,1
100108,Electronics,48.08847427368164,2022-11-07,114,139,39.85253257751465,10071.377427673338,0,11,0,45,23007,1
100108,Electronics,48.08847427368164,2022-11-08,81,0,40.3050651550293,3264.710277557373,1,11,0,45,23088,1
100108,Electronics,48.08847427368164,2022-11-09,76,96,37.06311904907227,6353.394095458984,2,11,0,45,23164,1
100108,Electronics,48.08847427368164,2022-11-10,67,100,44.97376190185547,7592.994094848633,3,11,0,45,23231,1
100108,Electronics,48.08847427368164,2022-11-11,90,99,42.44423660278321,8021.832588500976,4,11,0,45,23321,1
100108,Electronics,48.08847427368164,2022-11-12,91,144,43.34664543151855,10203.069468536376,5,11,1,45,23412,1
100108,Electronics,48.08847427368164,2022-11-13,75,0,43.03329086303711,3227.496814727783,6,11,1,45,23487,1
100108,Electronics,48.08847427368164,2022-11-14,89,0,43.03329086303711,3829.9628868103027,0,11,0,46,23576,1
100108,Electronics,48.08847427368164,2022-11-15,12,50,28.91745506286621,1623.878921508789,1,11,0,46,23588,1
100108,Electronics,48.08847427368164,2022-11-16,84,112,48.203195571899414,9561.136856079102,2,11,0,46,23672,1
100108,Electronics,48.08847427368164,2022-11-17,81,0,44.15639114379883,3576.667682647705,3,11,0,46,23753,1
100108,Electronics,48.08847427368164,2022-11-18,31,109,44.417493438720705,6220.984593200684,4,11,0,46,23784,1
100108,Electronics,48.08847427368164,2022-11-19,71,70,43.699898910522464,6161.985645294189,5,11,1,46,23855,1
100108,Electronics,48.08847427368164,2022-11-20,51,0,43.99979782104492,2243.989688873291,6,11,1,46,23906,1
100108,Electronics,48.08847427368164,2022-11-21,17,50,36.64882492065429,2367.400047302246,0,11,0,47,23923,1
100108,Electronics,48.08847427368164,2022-11-22,62,71,41.94195220947266,5587.442073974609,1,11,0,47,23985,1
100108,Electronics,48.08847427368164,2022-11-23,79,83,40.26584220886231,6522.083069000244,2,11,0,47,24064,1
100108,Electronics,48.08847427368164,2022-11-24,50,0,40.51168441772461,2025.5842208862305,3,11,0,47,24114,1
100108,Electronics,48.08847427368164,2022-11-25,45,50,34.92519104003907,3308.2171936035156,4,11,0,47,24159,1
100108,Electronics,48.08847427368164,2022-11-26,58,129,43.04487213134766,8129.985167236328,5,11,1,47,24217,1
100108,Electronics,48.08847427368164,2022-11-27,124,104,44.10838279724121,10039.87893371582,6,11,1,47,24341,1
100108,Electronics,48.08847427368164,2022-11-28,109,96,41.029994354248046,8421.678769226073,0,11,0,48,24450,1
100108,Electronics,48.08847427368164,2022-11-29,59,96,41.22499633789063,6382.289567871094,1,11,0,48,24509,1
100108,Electronics,48.08847427368164,2022-11-30,93,118,50.618245925903324,10763.243742218017,2,11,0,48,24602,1
100108,Electronics,48.08847427368164,2022-12-01,45,0,47.30649185180664,2128.792133331299,3,12,0,48,24647,1
100108,Electronics,48.08847427368164,2022-12-02,83,96,43.471014404296874,7762.8383911132805,4,12,0,48,24730,1
100108,Electronics,48.08847427368164,2022-12-03,108,88,46.06896141052246,9019.695664672852,5,12,1,48,24838,1
100108,Electronics,48.08847427368164,2022-12-04,106,167,42.396445693969724,11527.476487121581,6,12,1,48,24944,1
100108,Electronics,48.08847427368164,2022-12-05,96,120,48.40788009643555,10507.752978515626,0,12,0,49,25040,1
100108,Electronics,48.08847427368164,2022-12-06,154,0,46.255760192871094,7123.387069702148,1,12,0,49,25194,1
100108,Electronics,48.08847427368164,2022-12-07,37,94,39.64680603027344,5131.783646240235,2,12,0,49,25231,1
100108,Electronics,48.08847427368164,2022-12-08,94,186,45.28242835998535,12763.496531677247,3,12,0,49,25325,1
100108,Electronics,48.08847427368164,2022-12-09,126,140,49.28583335876465,13137.530006408691,4,12,0,49,25451,1
100108,Electronics,48.08847427368164,2022-12-10,85,0,47.3216667175293,4022.3416709899902,5,12,1,49,25536,1
100108,Electronics,48.08847427368164,2022-12-11,115,113,46.33331489562988,10564.662425994873,6,12,1,49,25651,1
100108,Electronics,48.08847427368164,2022-12-12,64,0,46.666629791259766,2986.664306640625,0,12,0,50,25715,1
100108,Electronics,48.08847427368164,2022-12-13,49,73,43.688381881713866,5312.021424407959,1,12,0,50,25764,1
100108,Electronics,48.08847427368164,2022-12-14,73,135,44.29101837158203,9210.608682250975,2,12,0,50,25837,1
100108,Electronics,48.08847427368164,2022-12-15,118,108,46.91334350585937,10592.449067382811,3,12,0,50,25955,1
100108,Electronics,48.08847427368164,2022-12-16,80,95,44.250989837646486,7734.008374023438,4,12,0,50,26035,1
100108,Electronics,48.08847427368164,2022-12-17,34,0,44.91197967529297,1527.007308959961,5,12,1,50,26069,1
100108,Electronics,48.08847427368164,2022-12-18,106,182,48.01105735778809,13880.304159851074,6,12,1,50,26175,1
100108,Electronics,48.08847427368164,2022-12-19,73,0,47.31211471557617,3453.7843742370605,0,12,0,51,26248,1
100108,Electronics,48.08847427368164,2022-12-20,76,76,42.75370483398437,6498.563134765625,1,12,0,51,26324,1
100108,Electronics,48.08847427368164,2022-12-21,45,0,44.65740966796875,2009.5834350585938,2,12,0,51,26369,1
100108,Electronics,48.08847427368164,2022-12-22,64,74,43.95273315429688,6063.34984375,3,12,0,51,26433,1
100108,Electronics,48.08847427368164,2022-12-23,74,74,41.9338671875,6206.2123437499995,4,12,0,51,26507,1
100108,Electronics,48.08847427368164,2022-12-24,74,88,45.29522338867187,7348.673061523437,5,12,1,51,26581,1
100108,Electronics,48.08847427368164,2022-12-25,67,121,46.209568099975584,8711.72212539673,6,12,1,51,26648,1
100108,Electronics,48.08847427368164,2022-12-26,136,125,45.921268692016596,11984.805084228516,0,12,0,52,26784,1
100108,Electronics,48.08847427368164,2022-12-27,56,0,45.8625373840332,2568.3020935058594,1,12,0,52,26840,1
100108,Electronics,48.08847427368164,2022-12-28,75,114,47.9205835723877,9076.857535858155,2,12,0,52,26915,1
100108,Electronics,48.08847427368164,2022-12-29,104,118,49.024509811401366,10890.798040771484,3,12,0,52,27019,1
100108,Electronics,48.08847427368164,2022-12-30,125,101,43.86675659179687,9957.009147949218,4,12,0,52,27144,1
100108,Electronics,48.08847427368164,2022-12-31,46,72,41.56058303833008,4859.413639526368,5,12,1,52,27190,1
100108,Electronics,48.08847427368164,2023-01-01,54,0,43.281166076660156,2337.1829681396484,6,1,1,52,27244,1
100108,Electronics,48.08847427368164,2023-01-02,76,108,39.43187126159668,7223.404431762695,0,1,0,1,27320,1
100108,Electronics,48.08847427368164,2023-01-03,71,62,38.54789443969727,5134.771010437012,1,1,0,1,27391,1
100108,Electronics,48.08847427368164,2023-01-04,99,121,38.08055374145508,8369.129640808105,2,1,0,1,27490,1
100108,Electronics,48.08847427368164,2023-01-05,88,118,38.58231025695801,7949.086605224609,3,1,0,1,27578,1
100108,Electronics,48.08847427368164,2023-01-06,92,0,38.544620513916016,3546.1050872802734,4,1,0,1,27670,1
100108,Electronics,48.08847427368164,2023-01-07,56,81,42.7478662109375,5884.511015624999,5,1,1,1,27726,1
100108,Electronics,48.08847427368164,2023-01-08,84,128,42.070192184448246,8923.712286987306,6,1,1,1,27810,1
100108,Electronics,48.08847427368164,2023-01-09,47,0,41.960384368896484,1972.1380653381348,0,1,0,2,27857,1
100108,Electronics,48.08847427368164,2023-01-10,81,141,43.08013633728027,9578.782086639403,1,1,0,2,27938,1
100108,Electronics,48.08847427368164,2023-01-11,51,0,42.83027267456055,2184.343906402588,2,1,0,2,27989,1
100108,Electronics,48.08847427368164,2023-01-12,78,58,40.0810961151123,5475.0509939575195,3,1,0,2,28067,1
100108,Electronics,48.08847427368164,2023-01-13,70,211,45.73628860473633,12941.250404663086,4,1,0,2,28137,1
100108,Electronics,48.08847427368164,2023-01-14,178,0,45.102577209472656,8028.258743286133,5,1,1,2,28315,1
100108,Electronics,48.08847427368164,2023-01-15,33,87,42.09022872924805,5024.895096130371,6,1,1,2,28348,1
100108,Electronics,48.08847427368164,2023-01-16,71,85,40.538021850585935,6314.299102783203,0,1,0,3,28419,1
100108,Electronics,48.08847427368164,2023-01-17,52,73,40.36293304443359,5037.955036621093,1,1,0,3,28471,1
100108,Electronics,48.08847427368164,2023-01-18,112,125,44.25825019836426,10504.308044433594,2,1,0,3,28583,1
100108,Electronics,48.08847427368164,2023-01-19,127,133,43.555481414794926,11325.35227935791,3,1,0,3,28710,1
100108,Electronics,48.08847427368164,2023-01-20,133,178,44.98157676696778,14009.449420013429,4,1,0,3,28843,1
100108,Electronics,48.08847427368164,2023-01-21,78,0,44.53315353393555,3473.5859756469727,5,1,1,3,28921,1
100108,Electronics,48.08847427368164,2023-01-22,79,81,44.22375755310058,7075.553693389893,6,1,1,3,29000,1
100108,Electronics,48.08847427368164,2023-01-23,103,139,45.58045562744141,11043.05385925293,0,1,0,4,29103,1
100108,Electronics,48.08847427368164,2023-01-24,30,0,45.23091125488281,1356.9273376464844,1,1,0,4,29133,1
100108,Electronics,48.08847427368164,2023-01-25,58,0,45.23091125488281,2623.392852783203,2,1,0,4,29191,1
100108,Electronics,48.08847427368164,2023-01-26,58,58,40.88022789001465,4742.1064352417,3,1,0,4,29249,1
100108,Electronics,48.08847427368164,2023-01-27,58,85,43.26281929016113,6192.987037658691,4,1,0,4,29307,1
100108,Electronics,48.08847427368164,2023-01-28,85,107,47.630831451416014,9173.921346740723,5,1,1,4,29392,1
100108,Electronics,48.08847427368164,2023-01-29,59,0,46.32166290283203,2732.97811126709,6,1,1,4,29451,1
100108,Electronics,48.08847427368164,2023-01-30,37,50,37.84061042785645,3256.375171661377,0,1,0,5,29488,1
100108,Electronics,48.08847427368164,2023-01-31,28,50,35.15114585876465,2696.4441680908203,1,1,0,5,29516,1
100108,Electronics,48.08847427368164,2023-02-01,23,0,37.2122917175293,855.8827095031738,2,2,0,5,29539,1
100108,Electronics,48.08847427368164,2023-02-02,60,98,33.98613189697265,5341.075827636718,3,2,0,5,29599,1
100108,Electronics,48.08847427368164,2023-02-03,47,60,35.28570236206055,3778.7460220336916,4,2,0,5,29646,1
100108,Electronics,48.08847427368164,2023-02-04,42,0,35.041404724121094,1471.738998413086,5,2,1,5,29688,1
100108,Electronics,48.08847427368164,2023-02-05,69,65,34.76562210083008,4658.975849914551,6,2,1,5,29757,1
100108,Electronics,48.08847427368164,2023-02-06,39,52,34.434234390258794,3131.3802824401855,0,2,0,6,29796,1
100108,Electronics,48.08847427368164,2023-02-07,41,0,34.59846878051758,1418.5372200012207,1,2,0,6,29837,1
100108,Electronics,48.08847427368164,2023-02-08,37,72,42.246575622558595,4659.596596069336,2,2,0,6,29874,1
100108,Electronics,48.08847427368164,2023-02-09,52,86,38.263882064819335,5256.14373474121,3,2,0,6,29926,1
100108,Electronics,48.08847427368164,2023-02-10,74,84,42.65674499511719,6753.998259277343,4,2,0,6,30000,1
100108,Electronics,48.08847427368164,2023-02-11,27,0,41.233489990234375,1113.3042297363281,5,2,1,6,30027,1
100108,Electronics,48.08847427368164,2023-02-12,39,0,41.233489990234375,1608.1061096191406,6,2,1,6,30066,1
100108,Electronics,48.08847427368164,2023-02-13,39,50,37.360872421264645,3310.9180488586426,0,2,0,7,30105,1
100108,Electronics,48.08847427368164,2023-02-14,17,50,35.80034385681152,2362.971691131592,1,2,0,7,30122,1
100108,Electronics,48.08847427368164,2023-02-15,27,0,36.88068771362305,995.7785682678223,2,2,0,7,30149,1
100108,Electronics,48.08847427368164,2023-02-16,67,116,43.91397773742676,8113.483016815186,3,2,0,7,30216,1
100108,Electronics,48.08847427368164,2023-02-17,29,0,42.337955474853516,1227.800708770752,4,2,0,7,30245,1
100108,Electronics,48.08847427368164,2023-02-18,32,0,42.337955474853516,1354.8145751953125,5,2,1,7,30277,1
100108,Electronics,48.08847427368164,2023-02-19,39,50,37.62303504943848,3330.046733856201,6,2,1,7,30316,1
100108,Electronics,48.08847427368164,2023-02-20,42,75,35.36205871582031,4097.692932128906,0,2,0,8,30358,1
100108,Electronics,48.08847427368164,2023-02-21,59,0,36.564117431640625,2157.282928466797,1,2,0,8,30417,1
100108,Electronics,48.08847427368164,2023-02-22,40,129,38.20918640136719,6477.004912109375,2,2,0,8,30457,1
100108,Electronics,48.08847427368164,2023-02-23,39,0,37.988372802734375,1481.5465393066406,3,2,0,8,30496,1
100108,Electronics,48.08847427368164,2023-02-24,39,67,39.501889877319336,4204.227410430908,4,2,0,8,30535,1
100108,Electronics,48.08847427368164,2023-02-25,72,0,38.89377975463867,2800.3521423339844,5,2,1,8,30607,1
100108,Electronics,48.08847427368164,2023-02-26,25,50,35.87965568542481,2667.2327842712402,6,2,1,8,30632,1
100108,Electronics,48.08847427368164,2023-02-27,49,88,33.86273849487304,4605.938372497558,0,2,0,9,30681,1
100108,Electronics,48.08847427368164,2023-02-28,44,0,34.715476989746094,1527.4809875488281,1,2,0,9,30725,1
100108,Electronics,48.08847427368164,2023-03-01,66,123,44.227782363891606,8473.747272033692,2,3,0,9,30791,1
100108,Electronics,48.08847427368164,2023-03-02,123,217,45.72502136230469,15619.355255126953,3,3,0,9,30914,1
100108,Electronics,48.08847427368164,2023-03-03,104,0,44.950042724609375,4674.804443359375,4,3,0,9,31018,1
100108,Electronics,48.08847427368164,2023-03-04,113,206,45.188645477294926,14419.953877868653,5,3,1,9,31131,1
100108,Electronics,48.08847427368164,2023-03-05,89,0,45.137290954589844,4017.218894958496,6,3,1,9,31220,1
100108,Electronics,48.08847427368164,2023-03-06,79,78,44.92218688964844,7052.875528564453,0,3,0,10,31299,1
100108,Electronics,48.08847427368164,2023-03-07,116,140,43.10833396911621,11022.333480834961,1,3,0,10,31415,1
100108,Electronics,48.08847427368164,2023-03-08,41,0,43.66666793823242,1790.3333854675293,2,3,0,10,31456,1
100108,Electronics,48.08847427368164,2023-03-09,99,149,47.83943504333496,11916.208138580323,3,3,0,10,31555,1
100108,Electronics,48.08847427368164,2023-03-10,97,0,46.79887008666992,4539.490398406982,4,3,0,10,31652,1
100108,Electronics,48.08847427368164,2023-03-11,52,80,43.38689842224121,5703.637435913086,5,3,1,10,31704,1
100108,Electronics,48.08847427368164,2023-03-12,43,59,40.3608039855957,4091.8291427612303,6,3,1,10,31747,1
100108,Electronics,48.08847427368164,2023-03-13,86,103,40.38003570556641,7623.496141357422,0,3,0,11,31833,1
100108,Electronics,48.08847427368164,2023-03-14,77,0,40.87007141113281,3146.9954986572266,1,3,0,11,31910,1
100108,Electronics,48.08847427368164,2023-03-15,36,116,44.83711296081543,6857.872133178711,2,3,0,11,31946,1
100108,Electronics,48.08847427368164,2023-03-16,94,102,46.22405906677246,9065.483104553223,3,3,0,11,32040,1
100108,Electronics,48.08847427368164,2023-03-17,51,0,45.52811813354492,2321.934024810791,4,3,0,11,32091,1
100108,Electronics,48.08847427368164,2023-03-18,73,117,41.93450645446777,7929.957942352295,5,3,1,11,32164,1
100108,Electronics,48.08847427368164,2023-03-19,71,88,44.99793762207031,7169.667142333985,6,3,1,11,32235,1
100108,Electronics,48.08847427368164,2023-03-20,91,81,46.37657470703125,7966.536596679687,0,3,0,12,32326,1
100108,Electronics,48.08847427368164,2023-03-21,68,103,44.136983718872074,7531.4297857666015,1,3,0,12,32394,1
100108,Electronics,48.08847427368164,2023-03-22,159,147,43.98406959533692,13461.69413131714,2,3,0,12,32553,1
100108,Electronics,48.08847427368164,2023-03-23,66,0,44.19813919067383,2917.0771865844727,3,3,0,12,32619,1
100108,Electronics,48.08847427368164,2023-03-24,71,69,41.82699737548828,5857.533627319336,4,3,0,12,32690,1
100108,Electronics,48.08847427368164,2023-03-25,79,151,51.0412728881836,11863.961116333008,5,3,1,12,32769,1
100108,Electronics,48.08847427368164,2023-03-26,88,0,49.31254577636719,4339.5040283203125,6,3,1,12,32857,1
100108,Electronics,48.08847427368164,2023-03-27,63,94,43.81089195251465,6835.502386016846,0,3,0,13,32920,1
100108,Electronics,48.08847427368164,2023-03-28,72,75,45.34209365844727,6665.461486816406,1,3,0,13,32992,1
100108,Electronics,48.08847427368164,2023-03-29,79,96,44.045690002441404,7700.929020385743,2,3,0,13,33071,1
100108,Electronics,48.08847427368164,2023-03-30,101,77,42.496013717651365,7584.354770965576,3,3,0,13,33172,1
100108,Electronics,48.08847427368164,2023-03-31,43,60,39.55760833740234,4046.934317016601,4,3,0,13,33215,1
100108,Electronics,48.08847427368164,2023-04-01,80,96,37.503838272094725,6579.654123535156,5,4,1,13,33295,1
100108,Electronics,48.08847427368164,2023-04-02,59,0,38.81767654418945,2290.2429161071777,6,4,1,13,33354,1
100108,Electronics,48.08847427368164,2023-04-03,48,60,38.00327049255371,4100.953967285156,0,4,0,14,33402,1
100108,Electronics,48.08847427368164,2023-04-04,56,95,38.77145393371582,5859.892840576172,1,4,0,14,33458,1
100108,Electronics,48.08847427368164,2023-04-05,111,108,45.50308258056641,9958.014332885741,2,4,0,14,33569,1
100108,Electronics,48.08847427368164,2023-04-06,54,74,44.3209952545166,5683.467487487793,3,4,0,14,33623,1
100108,Electronics,48.08847427368164,2023-04-07,46,0,43.8019905090332,2014.8915634155273,4,4,0,14,33669,1
100108,Electronics,48.08847427368164,2023-04-08,77,146,38.29330017089843,8452.92822631836,5,4,1,14,33746,1
100108,Electronics,48.08847427368164,2023-04-09,155,174,45.98576484680176,15167.017102508546,6,4,1,14,33901,1
100108,Electronics,48.08847427368164,2023-04-10,132,123,51.46711471557617,13096.27828491211,0,4,0,15,34033,1
100108,Electronics,48.08847427368164,2023-04-11,47,0,48.374229431152344,2273.58878326416,1,4,0,15,34080,1
100108,Electronics,48.08847427368164,2023-04-12,88,0,48.374229431152344,4256.932189941406,2,4,0,15,34168,1
100108,Electronics,48.08847427368164,2023-04-13,30,51,41.94189476013183,3366.59368560791,3,4,0,15,34198,1
100108,Electronics,48.08847427368164,2023-04-14,51,113,42.9023258972168,7030.257241516114,4,4,0,15,34249,1
100108,Electronics,48.08847427368164,2023-04-15,35,0,42.994651794433594,1504.8128128051758,5,4,1,15,34284,1
100108,Electronics,48.08847427368164,2023-04-16,18,0,42.994651794433594,773.9037322998047,6,4,1,15,34302,1
100108,Electronics,48.08847427368164,2023-04-17,48,73,34.735560455322265,4142.863803710938,0,4,0,16,34350,1
100108,Electronics,48.08847427368164,2023-04-18,32,52,39.416624755859374,3331.463984375,1,4,0,16,34382,1
100108,Electronics,48.08847427368164,2023-04-19,84,81,42.69736892700195,7039.987979736328,2,4,0,16,34466,1
100108,Electronics,48.08847427368164,2023-04-20,46,0,41.004737854003906,1886.2179412841797,3,4,0,16,34512,1
100108,Electronics,48.08847427368164,2023-04-21,37,59,38.0809806060791,3635.0725648498537,4,4,0,16,34549,1
100108,Electronics,48.08847427368164,2023-04-22,50,51,38.35780158996582,3873.8501589965817,5,4,1,16,34599,1
100108,Electronics,48.08847427368164,2023-04-23,79,93,44.97355430603027,7761.861580352783,6,4,1,16,34678,1
100108,Electronics,48.08847427368164,2023-04-24,39,0,43.08710861206055,1680.3972358703613,0,4,0,17,34717,1
100108,Electronics,48.08847427368164,2023-04-25,54,61,40.88549468994141,4697.103426513671,1,4,0,17,34771,1
100108,Electronics,48.08847427368164,2023-04-26,58,50,38.27500213623047,4143.660247802734,2,4,0,17,34829,1
100108,Electronics,48.08847427368164,2023-04-27,53,96,42.249530715942385,6320.570255889893,3,4,0,17,34882,1
100108,Electronics,48.08847427368164,2023-04-28,40,0,41.659061431884766,1666.3624572753906,4,4,0,17,34922,1
100108,Electronics,48.08847427368164,2023-04-29,35,50,37.36975196838379,3153.3326377868652,5,4,1,17,34957,1
100108,Electronics,48.08847427368164,2023-04-30,51,50,38.59894500732422,3898.6223907470703,6,4,1,17,35008,1
100108,Electronics,48.08847427368164,2023-05-01,46,50,37.99271842956543,3646.0900955200195,0,5,0,18,35054,1
100108,Electronics,48.08847427368164,2023-05-02,67,58,41.890008468627926,5223.651134796142,1,5,0,18,35121,1
100108,Electronics,48.08847427368164,2023-05-03,27,50,32.66326622009277,2444.1563758850098,2,5,0,18,35148,1
100108,Electronics,48.08847427368164,2023-05-04,69,103,40.01297142028808,6925.650055999756,3,5,0,18,35217,1
100108,Electronics,48.08847427368164,2023-05-05,60,0,38.73594284057617,2324.1565704345703,4,5,0,18,35277,1
100108,Electronics,48.08847427368164,2023-05-06,42,50,35.961734008789065,3299.9856567382812,5,5,1,18,35319,1
100108,Electronics,48.08847427368164,2023-05-07,36,51,38.406953201293945,3349.8506304931643,6,5,1,18,35355,1
100108,Electronics,48.08847427368164,2023-05-08,48,56,34.30635513305664,3555.650092773438,0,5,0,19,35403,1
100108,Electronics,48.08847427368164,2023-05-09,35,0,35.83271026611328,1254.1448593139648,1,5,0,19,35438,1
100108,Electronics,48.08847427368164,2023-05-10,50,50,35.3552645111084,3535.52645111084,2,5,0,19,35488,1
100108,Electronics,48.08847427368164,2023-05-11,48,50,37.29301330566406,3656.00927734375,3,5,0,19,35536,1
100108,Electronics,48.08847427368164,2023-05-12,33,50,34.50346145629883,2850.1284561157227,4,5,0,19,35569,1
100108,Electronics,48.08847427368164,2023-05-13,77,164,49.24083549499512,12097.518666229249,5,5,1,19,35646,1
100108,Electronics,48.08847427368164,2023-05-14,51,0,46.591670989990234,2376.175220489502,6,5,1,19,35697,1
100108,Electronics,48.08847427368164,2023-05-15,113,117,46.831802444458006,10771.62735244751,0,5,0,20,35810,1
100108,Electronics,48.08847427368164,2023-05-16,94,101,47.06557830810547,9178.588721923828,1,5,0,20,35904,1
100108,Electronics,48.08847427368164,2023-05-17,124,182,48.61677124023437,14901.279267578126,2,5,0,20,36028,1
100108,Electronics,48.08847427368164,2023-05-18,103,0,48.19354248046875,4963.934875488281,3,5,0,20,36131,1
100108,Electronics,48.08847427368164,2023-05-19,55,75,37.74464256286621,4834.710681915283,4,5,0,20,36186,1
100108,Electronics,48.08847427368164,2023-05-20,99,168,48.86868766784668,13166.020158233643,5,5,1,20,36285,1
100108,Electronics,48.08847427368164,2023-05-21,166,133,49.221128234863286,14690.75457397461,6,5,1,20,36451,1
100108,Electronics,48.08847427368164,2023-05-22,95,140,46.873735961914065,10992.659832763671,0,5,0,21,36546,1
100108,Electronics,48.08847427368164,2023-05-23,137,0,47.377471923828125,6490.713653564453,1,5,0,21,36683,1
100108,Electronics,48.08847427368164,2023-05-24,43,67,41.031642074584965,4476.481218414307,2,5,0,21,36726,1
100108,Electronics,48.08847427368164,2023-05-25,67,71,41.11688346862793,5672.262384796142,3,5,0,21,36793,1
100108,Electronics,48.08847427368164,2023-05-26,71,89,43.689555664062496,7001.1369042968745,4,5,0,21,36864,1
100108,Electronics,48.08847427368164,2023-05-27,89,91,39.89800338745117,7179.544602966309,5,5,1,21,36953,1
100108,Electronics,48.08847427368164,2023-05-28,56,100,41.070933990478515,6408.784606933594,6,5,1,21,37009,1
100108,Electronics,48.08847427368164,2023-05-29,116,102,42.940087890625,9350.300390625001,0,5,0,22,37125,1
100108,Electronics,48.08847427368164,2023-05-30,78,99,43.013798751831054,7620.082605285645,1,5,0,22,37203,1
100108,Electronics,48.08847427368164,2023-05-31,62,0,42.69759750366211,2647.251045227051,2,5,0,22,37265,1
100108,Electronics,48.08847427368164,2023-06-01,43,50,38.88464614868164,3604.409568786621,3,6,0,22,37308,1
100108,Electronics,48.08847427368164,2023-06-02,34,0,40.57929229736328,1379.6959381103516,4,6,0,22,37342,1
100108,Electronics,48.08847427368164,2023-06-03,49,72,38.90929077148438,4697.690495605469,5,6,1,22,37391,1
100108,Electronics,48.08847427368164,2023-06-04,57,75,39.202490997314456,5173.783973693848,6,6,1,22,37448,1
100108,Electronics,48.08847427368164,2023-06-05,94,108,41.131110763549806,8316.448823547364,0,6,0,23,37542,1
100108,Electronics,48.08847427368164,2023-06-06,108,189,43.841314468383786,13079.893925170898,1,6,0,23,37650,1
100108,Electronics,48.08847427368164,2023-06-07,181,249,48.325806503295894,20877.621954193113,2,6,0,23,37831,1
100108,Electronics,48.08847427368164,2023-06-08,90,0,46.8916130065918,4220.245170593262,3,6,0,23,37921,1
100108,Electronics,48.08847427368164,2023-06-09,78,0,46.8916130065918,3657.54581451416,4,6,0,23,37999,1
100108,Electronics,48.08847427368164,2023-06-10,73,78,43.22276527404785,6519.973730010986,5,6,1,23,38072,1
100108,Electronics,48.08847427368164,2023-06-11,58,83,41.19497131347656,5778.116672363281,6,6,1,23,38130,1
100108,Electronics,48.08847427368164,2023-06-12,70,0,42.409942626953125,2968.6959838867188,0,6,0,24,38200,1
100108,Electronics,48.08847427368164,2023-06-13,49,106,49.62537788391113,7769.147032623291,1,6,0,24,38249,1
100108,Electronics,48.08847427368164,2023-06-14,80,155,45.79168518066406,10713.66962890625,2,6,0,24,38329,1
100108,Electronics,48.08847427368164,2023-06-15,61,0,46.423370361328125,2831.8255920410156,3,6,0,24,38390,1
100108,Electronics,48.08847427368164,2023-06-16,61,0,46.423370361328125,2831.8255920410156,4,6,0,24,38451,1
100108,Electronics,48.08847427368164,2023-06-17,59,120,49.018013610839844,8805.455606079102,5,6,1,24,38510,1
100108,Electronics,48.08847427368164,2023-06-18,120,108,45.98895446777344,10496.269072265626,6,6,1,24,38630,1
100108,Electronics,48.08847427368164,2023-06-19,108,101,46.563144302368165,9732.489169311524,0,6,0,25,38738,1
100108,Electronics,48.08847427368164,2023-06-20,101,147,46.24123901367187,11462.71028076172,1,6,0,25,38839,1
100108,Electronics,48.08847427368164,2023-06-21,43,0,46.35247802734375,1993.1565551757812,2,6,0,25,38882,1
100108,Electronics,48.08847427368164,2023-06-22,101,100,46.328279647827145,9311.992488861084,3,6,0,25,38983,1
100108,Electronics,48.08847427368164,2023-06-23,61,92,42.97603965759278,6537.9468382263185,4,6,0,25,39044,1
100108,Electronics,48.08847427368164,2023-06-24,73,89,39.14385246276855,6306.682459564208,5,6,1,25,39117,1
100108,Electronics,48.08847427368164,2023-06-25,88,0,41.30770492553711,3635.0780334472656,6,6,1,25,39205,1
100108,Electronics,48.08847427368164,2023-06-26,62,217,61.67418991088867,17601.699548950193,0,6,0,26,39267,1
100108,Electronics,48.08847427368164,2023-06-27,121,0,59.128379821777344,7154.533958435059,1,6,0,26,39388,1
100108,Electronics,48.08847427368164,2023-06-28,96,188,50.39606338500977,14149.084169921874,2,6,0,26,39484,1
100108,Electronics,48.08847427368164,2023-06-29,107,0,52.17212677001953,5582.41756439209,3,6,0,26,39591,1
100108,Electronics,48.08847427368164,2023-06-30,81,208,55.6355396270752,16150.357419586182,4,6,0,26,39672,1
100108,Electronics,48.08847427368164,2023-07-01,127,0,55.07107925415039,6994.0270652771,5,7,1,26,39799,1
100108,Electronics,48.08847427368164,2023-07-02,81,104,48.07175033569336,8848.153554382323,6,7,1,26,39880,1
100108,Electronics,48.08847427368164,2023-07-03,104,123,49.8920352935791,11324.693341064452,0,7,0,27,39984,1
100108,Electronics,48.08847427368164,2023-07-04,98,118,45.43236572265625,9782.543681640625,1,7,0,27,40082,1
100108,Electronics,48.08847427368164,2023-07-05,115,0,46.9747314453125,5402.0941162109375,2,7,0,27,40197,1
100108,Electronics,48.08847427368164,2023-07-06,28,97,43.06332984924316,5348.876471557617,3,7,0,27,40225,1
100108,Electronics,48.08847427368164,2023-07-07,64,82,41.56149688720703,6054.6316015625,4,7,0,27,40289,1
100108,Electronics,48.08847427368164,2023-07-08,115,137,46.22155708312988,11673.318129119874,5,7,1,27,40404,1
100108,Electronics,48.08847427368164,2023-07-09,81,101,37.696904525756835,6801.298533172607,6,7,1,27,40485,1
100108,Electronics,48.08847427368164,2023-07-10,85,0,40.67380905151367,3457.273769378662,0,7,0,28,40570,1
100108,Electronics,48.08847427368164,2023-07-11,72,97,45.37696380615235,7700.532788085938,1,7,0,28,40642,1
100108,Electronics,48.08847427368164,2023-07-12,72,87,43.578182525634766,6926.1082836914065,2,7,0,28,40714,1
100108,Electronics,48.08847427368164,2023-07-13,65,89,46.784410095214845,7232.77331237793,3,7,0,28,40779,1
100108,Electronics,48.08847427368164,2023-07-14,51,0,45.61882019042969,2326.559829711914,4,7,0,28,40830,1
100108,Electronics,48.08847427368164,2023-07-15,85,119,43.767254486083985,8911.953262634277,5,7,1,28,40915,1
100108,Electronics,48.08847427368164,2023-07-16,119,149,48.07090766906738,12915.676025238037,6,7,1,28,41034,1
100108,Electronics,48.08847427368164,2023-07-17,132,114,45.48971672058106,11201.085214233397,0,7,0,29,41166,1
100108,Electronics,48.08847427368164,2023-07-18,105,83,42.499173126220704,8024.586356506348,1,7,0,29,41271,1
100108,Electronics,48.08847427368164,2023-07-19,109,184,48.45897529602051,14273.55661453247,2,7,0,29,41380,1
100108,Electronics,48.08847427368164,2023-07-20,82,0,47.457950592041016,3891.5519485473633,3,7,0,29,41462,1
100108,Electronics,48.08847427368164,2023-07-21,97,106,43.10425827026367,8737.436104431152,4,7,0,29,41559,1
100108,Electronics,48.08847427368164,2023-07-22,111,130,44.942999038696286,10833.675786590577,5,7,1,29,41670,1
100108,Electronics,48.08847427368164,2023-07-23,107,125,50.07937187194824,11650.825580596924,6,7,1,29,41777,1
100108,Electronics,48.08847427368164,2023-07-24,135,142,43.90009231567383,12149.824925231933,0,7,0,30,41912,1
100108,Electronics,48.08847427368164,2023-07-25,39,0,45.400184631347656,1770.6072006225586,1,7,0,30,41951,1
100108,Electronics,48.08847427368164,2023-07-26,69,109,47.90875877380371,8562.608710784913,2,7,0,30,42020,1
100108,Electronics,48.08847427368164,2023-07-27,18,0,47.03751754760742,846.6753158569336,3,7,0,30,42038,1
100108,Electronics,48.08847427368164,2023-07-28,138,140,48.32495880126953,13435.18862915039,4,7,0,30,42176,1
100108,Electronics,48.08847427368164,2023-07-29,42,0,47.89991760253906,2011.7965393066406,5,7,1,30,42218,1
100108,Electronics,48.08847427368164,2023-07-30,98,127,47.64184967041015,10717.33253540039,6,7,1,30,42316,1
100108,Electronics,48.08847427368164,2023-07-31,72,0,47.71369934082031,3435.3863525390625,0,7,0,31,42388,1
100108,Electronics,48.08847427368164,2023-08-01,55,105,47.602978744506835,7615.327661895752,1,8,0,31,42443,1
100108,Electronics,48.08847427368164,2023-08-02,103,92,45.88318634033203,8954.186386108398,2,8,0,31,42546,1
100108,Electronics,48.08847427368164,2023-08-03,68,114,46.62754638671875,8487.70630859375,3,8,0,31,42614,1
100108,Electronics,48.08847427368164,2023-08-04,25,0,46.5950927734375,1164.8773193359375,4,8,0,31,42639,1
100108,Electronics,48.08847427368164,2023-08-05,79,71,45.223670654296875,6788.459963378906,5,8,1,31,42718,1
100108,Electronics,48.08847427368164,2023-08-06,48,62,38.765637512207036,4218.361201171875,6,8,1,31,42766,1
100108,Electronics,48.08847427368164,2023-08-07,19,0,42.04127502441406,798.7842254638672,0,8,0,32,42785,1
100108,Electronics,48.08847427368164,2023-08-08,18,0,42.04127502441406,756.7429504394531,1,8,0,32,42803,1
100108,Electronics,48.08847427368164,2023-08-09,81,115,38.87660087585449,7591.029341888428,2,8,0,32,42884,1
100108,Electronics,48.08847427368164,2023-08-10,118,90,40.816917419433594,8477.792510986328,3,8,0,32,43002,1
100108,Electronics,48.08847427368164,2023-08-11,90,143,51.83018127441406,12221.642629394531,4,8,0,32,43092,1
100108,Electronics,48.08847427368164,2023-08-12,91,0,49.090362548828125,4467.222991943359,5,8,1,32,43183,1
100108,Electronics,48.08847427368164,2023-08-13,52,112,41.56737442016602,6732.006939697266,6,8,1,32,43235,1
100108,Electronics,48.08847427368164,2023-08-14,53,60,43.55480293273926,4923.619110870361,0,8,0,33,43288,1
100108,Electronics,48.08847427368164,2023-08-15,69,112,43.34671646118164,7846.756871643066,1,8,0,33,43357,1
100108,Electronics,48.08847427368164,2023-08-16,59,0,43.32343292236328,2556.0825424194336,2,8,0,33,43416,1
100108,Electronics,48.08847427368164,2023-08-17,97,82,40.53549621582032,7271.986265869141,3,8,0,33,43513,1
100108,Electronics,48.08847427368164,2023-08-18,88,97,41.46542449951172,7670.694711914062,4,8,0,33,43601,1
100108,Electronics,48.08847427368164,2023-08-19,97,95,43.176905746459965,8288.839714813232,5,8,1,33,43698,1
100108,Electronics,48.08847427368164,2023-08-20,81,104,45.67897445678711,8472.713861999513,6,8,1,33,43779,1
100108,Electronics,48.08847427368164,2023-08-21,118,94,42.79971244812012,9091.292137756347,0,8,0,34,43897,1
100108,Electronics,48.08847427368164,2023-08-22,94,128,41.42726486206055,9177.565794067383,1,8,0,34,43991,1
100108,Electronics,48.08847427368164,2023-08-23,31,0,41.994529724121094,1301.830421447754,2,8,0,34,44022,1
100108,Electronics,48.08847427368164,2023-08-24,97,250,49.84453826904297,17491.200424194336,3,8,0,34,44119,1
100108,Electronics,48.08847427368164,2023-08-25,81,0,48.56907653808594,3934.095199584961,4,8,0,34,44200,1
100108,Electronics,48.08847427368164,2023-08-26,119,168,53.13274963378906,15323.934412841796,5,8,1,34,44319,1
100108,Electronics,48.08847427368164,2023-08-27,57,0,51.605499267578125,2941.513458251953,6,8,1,34,44376,1
100108,Electronics,48.08847427368164,2023-08-28,94,142,44.56664253234864,10395.488796081543,0,8,0,35,44470,1
100108,Electronics,48.08847427368164,2023-08-29,113,0,47.113285064697266,5323.801212310791,1,8,0,35,44583,1
100108,Electronics,48.08847427368164,2023-08-30,96,146,49.47552803039551,12002.301381835938,2,8,0,35,44679,1
100108,Electronics,48.08847427368164,2023-08-31,70,0,48.891056060791016,3422.373924255371,3,8,0,35,44749,1
100108,Electronics,48.08847427368164,2023-09-01,74,74,47.32226707458496,7003.695527038574,4,9,0,35,44823,1
100108,Electronics,48.08847427368164,2023-09-02,66,109,45.42741813659668,7922.8191940307615,5,9,1,35,44889,1
100108,Electronics,48.08847427368164,2023-09-03,119,128,44.267259216308595,10928.907693481446,6,9,1,35,45008,1
100108,Electronics,48.08847427368164,2023-09-04,62,0,44.83451843261719,2779.7401428222656,0,9,0,36,45070,1
100108,Electronics,48.08847427368164,2023-09-05,39,59,40.34895240783692,3922.0182878112796,1,9,0,36,45109,1
100108,Electronics,48.08847427368164,2023-09-06,86,107,47.22896301269532,9146.921638183594,2,9,0,36,45195,1
100108,Electronics,48.08847427368164,2023-09-07,67,100,38.87499534606934,6413.419376373291,3,9,0,36,45262,1
100108,Electronics,48.08847427368164,2023-09-08,66,119,38.698646545410156,7108.971343994141,4,9,0,36,45328,1
100108,Electronics,48.08847427368164,2023-09-09,66,0,39.64729309082031,2616.7213439941406,5,9,1,36,45394,1
100108,Electronics,48.08847427368164,2023-09-10,127,134,44.84790588378907,11717.008094482422,6,9,1,36,45521,1
100108,Electronics,48.08847427368164,2023-09-11,108,97,43.9526383972168,9006.799893798829,0,9,0,37,45629,1
100108,Electronics,48.08847427368164,2023-09-12,123,102,46.0439754486084,10340.867960357667,1,9,0,37,45752,1
100108,Electronics,48.08847427368164,2023-09-13,70,69,43.55342430114746,6054.599402160645,2,9,0,37,45822,1
100108,Electronics,48.08847427368164,2023-09-14,101,132,50.7538883972168,11881.645456237793,3,9,0,37,45923,1
100108,Electronics,48.08847427368164,2023-09-15,83,106,44.56265968322754,8383.641507415772,4,9,0,37,46006,1
100108,Electronics,48.08847427368164,2023-09-16,64,0,46.24531936645508,2959.700439453125,5,9,1,37,46070,1
100108,Electronics,48.08847427368164,2023-09-17,62,80,39.45267211914063,5557.951342773438,6,9,1,37,46132,1
100108,Electronics,48.08847427368164,2023-09-18,48,0,41.91534423828125,2011.9365234375,0,9,0,38,46180,1
100108,Electronics,48.08847427368164,2023-09-19,61,121,42.27715950012207,7698.813459014893,1,9,0,38,46241,1
100108,Electronics,48.08847427368164,2023-09-20,97,105,46.97575889587402,9503.05722579956,2,9,0,38,46338,1
100108,Electronics,48.08847427368164,2023-09-21,117,148,41.969974746704096,11091.35409072876,3,9,0,38,46455,1
100108,Electronics,48.08847427368164,2023-09-22,95,0,42.9599494934082,4081.1952018737793,4,9,0,38,46550,1
100108,Electronics,48.08847427368164,2023-09-23,65,103,45.33930595397949,7638.689774017334,5,9,1,38,46615,1
100108,Electronics,48.08847427368164,2023-09-24,103,101,44.306168746948245,9038.770761871338,6,9,1,38,46718,1
100108,Electronics,48.08847427368164,2023-09-25,101,115,43.35721183776856,9360.436791229247,0,9,0,39,46819,1
100108,Electronics,48.08847427368164,2023-09-26,35,0,43.69442367553711,1529.3048286437988,1,9,0,39,46854,1
100108,Electronics,48.08847427368164,2023-09-27,64,110,40.69882698059082,7044.849853515625,2,9,0,39,46918,1
100108,Electronics,48.08847427368164,2023-09-28,110,89,45.59977760314941,9038.651072692872,3,9,0,39,47028,1
100108,Electronics,48.08847427368164,2023-09-29,44,0,43.89955520629883,1931.5804290771484,4,9,0,39,47072,1
100108,Electronics,48.08847427368164,2023-09-30,61,111,45.635764007568355,7868.0632089233395,5,9,1,39,47133,1
100108,Electronics,48.08847427368164,2023-10-01,111,98,39.86954399108887,8358.078766021728,6,10,1,39,47244,1
100108,Electronics,48.08847427368164,2023-10-02,82,130,46.64809356689453,9952.847344970702,0,10,0,40,47326,1
100108,Electronics,48.08847427368164,2023-10-03,40,0,45.32618713378906,1813.0474853515625,1,10,0,40,47366,1
100108,Electronics,48.08847427368164,2023-10-04,106,158,45.96862930297851,12144.109412231446,2,10,0,40,47472,1
100108,Electronics,48.08847427368164,2023-10-05,127,133,46.15894653320312,12002.112419433593,3,10,0,40,47599,1
100108,Electronics,48.08847427368164,2023-10-06,91,0,46.02789306640625,4188.538269042969,4,10,0,40,47690,1
100108,Electronics,48.08847427368164,2023-10-07,34,50,39.91811553955078,3311.871856689453,5,10,1,40,47724,1
100108,Electronics,48.08847427368164,2023-10-08,41,0,42.49623107910156,1742.345474243164,6,10,1,40,47765,1
100108,Electronics,48.08847427368164,2023-10-09,28,50,35.0537703704834,2681.0911407470703,0,10,0,41,47793,1
100108,Electronics,48.08847427368164,2023-10-10,70,84,40.058077011108395,6179.610781555176,1,10,0,41,47863,1
100108,Electronics,48.08847427368164,2023-10-11,52,73,38.368715896606446,4788.976453247071,2,10,0,41,47915,1
100108,Electronics,48.08847427368164,2023-10-12,69,100,34.7740983581543,5834.845573425293,3,10,0,41,47984,1
100108,Electronics,48.08847427368164,2023-10-13,28,0,36.128196716308594,1011.5895080566406,4,10,0,41,48012,1
100108,Electronics,48.08847427368164,2023-10-14,24,0,36.128196716308594,867.0767211914062,5,10,1,41,48036,1
100108,Electronics,48.08847427368164,2023-10-15,62,53,40.60207466125488,4651.437257995605,6,10,1,41,48098,1
100108,Electronics,48.08847427368164,2023-10-16,46,50,37.48724555969238,3596.826591491699,0,10,0,42,48144,1
100108,Electronics,48.08847427368164,2023-10-17,38,50,36.41032920837402,3195.825019836426,1,10,0,42,48182,1
100108,Electronics,48.08847427368164,2023-10-18,53,59,37.37886619567871,4187.159816741943,2,10,0,42,48235,1
100108,Electronics,48.08847427368164,2023-10-19,73,118,36.81807014465332,7026.488241119385,3,10,0,42,48308,1
100108,Electronics,48.08847427368164,2023-10-20,70,0,36.94614028930664,2586.229820251465,4,10,0,42,48378,1
100108,Electronics,48.08847427368164,2023-10-21,72,106,41.91921981811524,7504.487653808594,5,10,1,42,48450,1
100108,Electronics,48.08847427368164,2023-10-22,72,0,40.65843963623047,2927.4076538085938,6,10,1,42,48522,1
100108,Electronics,48.08847427368164,2023-10-23,34,51,34.55568756103516,2911.2967541503904,0,10,0,43,48556,1
100108,Electronics,48.08847427368164,2023-10-24,38,50,38.330396575927736,3382.190139770508,1,10,0,43,48594,1
100108,Electronics,48.08847427368164,2023-10-25,63,68,38.527213134765624,5048.578854980469,2,10,0,43,48657,1
100108,Electronics,48.08847427368164,2023-10-26,68,141,50.152537689208984,10651.055125732422,3,10,0,43,48725,1
100108,Electronics,48.08847427368164,2023-10-27,34,0,47.83507537841797,1626.392562866211,4,10,0,43,48759,1
100108,Electronics,48.08847427368164,2023-10-28,66,0,47.83507537841797,3157.114974975586,5,10,1,43,48825,1
100108,Electronics,48.08847427368164,2023-10-29,41,139,48.50402252197266,8739.149846801758,6,10,1,43,48866,1
100108,Electronics,48.08847427368164,2023-10-30,96,112,46.99493751525879,9766.228002929689,0,10,0,44,48962,1
100108,Electronics,48.08847427368164,2023-10-31,49,0,47.53987503051758,2329.4538764953613,1,10,0,44,49011,1
100108,Electronics,48.08847427368164,2023-11-01,84,61,41.8058283996582,6123.159171142578,2,11,0,44,49095,1
100108,Electronics,48.08847427368164,2023-11-02,83,121,48.731979522705075,9982.668600769044,3,11,0,44,49178,1
100108,Electronics,48.08847427368164,2023-11-03,97,132,46.72029479980469,10688.78719116211,4,11,0,44,49275,1
100108,Electronics,48.08847427368164,2023-11-04,67,0,47.010589599609375,3149.709503173828,5,11,1,44,49342,1
100108,Electronics,48.08847427368164,2023-11-05,80,70,41.23475563049317,6207.660900878906,6,11,1,44,49422,1
100108,Electronics,48.08847427368164,2023-11-06,79,103,44.79527862548828,8161.494022827148,0,11,0,45,49501,1
100108,Electronics,48.08847427368164,2023-11-07,40,0,44.43055725097656,1777.2222900390625,1,11,0,45,49541,1
100108,Electronics,48.08847427368164,2023-11-08,63,119,47.47317283630371,8675.779777374268,2,11,0,45,49604,1
100108,Electronics,48.08847427368164,2023-11-09,119,91,40.28863105773926,8533.094191741944,3,11,0,45,49723,1
100108,Electronics,48.08847427368164,2023-11-10,73,65,37.42503532409668,5182.615157318115,4,11,0,45,49796,1
100108,Electronics,48.08847427368164,2023-11-11,83,152,43.79526695251465,10352.934314117432,5,11,1,45,49879,1
100108,Electronics,48.08847427368164,2023-11-12,90,107,44.20316802978516,8717.150245361328,6,11,1,45,49969,1
100108,Electronics,48.08847427368164,2023-11-13,124,137,45.58720603942871,11907.78709777832,0,11,0,46,50093,1
100108,Electronics,48.08847427368164,2023-11-14,101,0,44.85441207885742,4530.2956199646,1,11,0,46,50194,1
100108,Electronics,48.08847427368164,2023-11-15,61,101,43.29603652954101,6996.116456604004,2,11,0,46,50255,1
100108,Electronics,48.08847427368164,2023-11-16,117,117,43.121515350341795,10090.43459197998,3,11,0,46,50372,1
100108,Electronics,48.08847427368164,2023-11-17,83,0,43.333030700683594,3596.6415481567383,4,11,0,46,50455,1
100108,Electronics,48.08847427368164,2023-11-18,25,50,33.7569051361084,2465.84525680542,5,11,1,46,50480,1
100108,Electronics,48.08847427368164,2023-11-19,63,80,40.71828720092773,5843.484187316894,6,11,1,46,50543,1
100108,Electronics,48.08847427368164,2023-11-20,63,72,35.682256851196286,4804.844363250732,0,11,0,47,50606,1
100108,Electronics,48.08847427368164,2023-11-21,43,61,38.55350563049316,4021.021484222412,1,11,0,47,50649,1
100108,Electronics,48.08847427368164,2023-11-22,61,78,41.33813499450683,5769.662469329834,2,11,0,47,50710,1
100108,Electronics,48.08847427368164,2023-11-23,92,75,44.33421531677246,7370.055618286133,3,11,0,47,50802,1
100108,Electronics,48.08847427368164,2023-11-24,107,183,50.39070938110352,14751.571807556153,4,11,0,47,50909,1
100108,Electronics,48.08847427368164,2023-11-25,32,0,48.57141876220703,1554.285400390625,5,11,1,47,50941,1
100108,Electronics,48.08847427368164,2023-11-26,60,0,48.57141876220703,2914.285125732422,6,11,1,47,51001,1
100108,Electronics,48.08847427368164,2023-11-27,91,117,49.40624839782715,10282.577208404542,0,11,0,48,51092,1
100108,Electronics,48.08847427368164,2023-11-28,117,144,50.0395255279541,13067.07897354126,1,11,0,48,51209,1
100108,Electronics,48.08847427368164,2023-11-29,81,0,49.7890510559082,4032.9131355285645,2,11,0,48,51290,1
100108,Electronics,48.08847427368164,2023-11-30,63,114,45.9180517578125,8084.754521484375,3,11,0,48,51353,1
100108,Electronics,48.08847427368164,2023-12-01,42,0,46.756103515625,1963.75634765625,4,12,0,48,51395,1
100108,Electronics,48.08847427368164,2023-12-02,72,104,44.52397499084473,7817.852398681641,5,12,1,48,51467,1
100108,Electronics,48.08847427368164,2023-12-03,85,96,46.73486640930176,8465.337289581299,6,12,1,48,51552,1
100108,Electronics,48.08847427368164,2023-12-04,24,0,46.159732818603516,1107.8335876464844,0,12,0,49,51576,1
100108,Electronics,48.08847427368164,2023-12-05,80,120,44.38728828430176,8857.966125488281,1,12,0,49,51656,1
100108,Electronics,48.08847427368164,2023-12-06,51,0,44.874576568603516,2288.6034049987793,2,12,0,49,51707,1
100108,Electronics,48.08847427368164,2023-12-07,80,124,46.4224666595459,9486.794665527344,3,12,0,49,51787,1
100108,Electronics,48.08847427368164,2023-12-08,88,114,44.310865020751955,8934.912243652343,4,12,0,49,51875,1
100108,Electronics,48.08847427368164,2023-12-09,84,105,44.15109733581543,8337.814352416992,5,12,1,49,51959,1
100108,Electronics,48.08847427368164,2023-12-10,71,0,44.47219467163086,3157.525821685791,6,12,1,49,52030,1
100108,Electronics,48.08847427368164,2023-12-11,71,105,45.90712028503418,8095.391080474853,0,12,0,50,52101,1
100108,Electronics,48.08847427368164,2023-12-12,134,193,46.402949523925784,15188.340472412108,1,12,0,50,52235,1
100108,Electronics,48.08847427368164,2023-12-13,103,0,46.15589904785156,4754.057601928711,2,12,0,50,52338,1
100108,Electronics,48.08847427368164,2023-12-14,68,86,39.33355438232422,6015.183395996094,3,12,0,50,52406,1
100108,Electronics,48.08847427368164,2023-12-15,108,149,46.48188293457031,11998.246713867187,4,12,0,50,52514,1
100108,Electronics,48.08847427368164,2023-12-16,95,0,45.203765869140625,4294.357757568359,5,12,1,50,52609,1
100108,Electronics,48.08847427368164,2023-12-17,54,85,42.533680267333985,5892.22746887207,6,12,1,50,52663,1
100108,Electronics,48.08847427368164,2023-12-18,49,50,40.794725036621095,4037.583053588867,0,12,0,51,52712,1
100108,Electronics,48.08847427368164,2023-12-19,72,85,43.49921752929687,6836.40732421875,1,12,0,51,52784,1
100108,Electronics,48.08847427368164,2023-12-20,99,125,45.58494476318359,10230.399063110352,2,12,0,51,52883,1
100108,Electronics,48.08847427368164,2023-12-21,40,0,44.83988952636719,1793.5955810546875,3,12,0,51,52923,1
100108,Electronics,48.08847427368164,2023-12-22,85,120,42.882050094604494,8772.898516082763,4,12,0,51,53008,1
100108,Electronics,48.08847427368164,2023-12-23,120,202,51.812193984985356,16841.606556396484,5,12,1,51,53128,1
100108,Electronics,48.08847427368164,2023-12-24,194,173,54.3309415435791,19905.03531890869,6,12,1,51,53322,1
100108,Electronics,48.08847427368164,2023-12-25,43,0,52.6918830871582,2265.7509727478027,0,12,0,52,53365,1
100108,Electronics,48.08847427368164,2023-12-26,113,114,46.20563400268554,10486.233284606933,1,12,0,52,53478,1
100108,Electronics,48.08847427368164,2023-12-27,40,0,48.651268005371094,1946.0507202148438,2,12,0,52,53518,1
100108,Electronics,48.08847427368164,2023-12-28,24,0,48.651268005371094,1167.6304321289062,3,12,0,52,53542,1
100108,Electronics,48.08847427368164,2023-12-29,74,65,41.050697097778325,5731.073170471192,4,12,0,52,53616,1
100108,Electronics,48.08847427368164,2023-12-30,30,0,43.83139419555664,1314.9418258666992,5,12,1,52,53646,1
100108,Electronics,48.08847427368164,2023-12-31,36,60,41.05963607788086,3926.373797607422,6,12,1,52,53682,1
100108,Electronics,48.08847427368164,2024-01-01,32,50,35.27798324584961,2849.450927734375,0,1,0,1,53714,1
100108,Electronics,48.08847427368164,2024-01-02,41,50,38.36322410583496,3493.724376678467,1,1,0,1,53755,1
100108,Electronics,48.08847427368164,2024-01-03,68,55,38.61690490722656,4746.719067382813,2,1,0,1,53823,1
100108,Electronics,48.08847427368164,2024-01-04,74,91,39.301763687133786,6489.351025695801,3,1,0,1,53897,1
100108,Electronics,48.08847427368164,2024-01-05,82,60,37.368214797973636,5322.087226867676,4,1,0,1,53979,1
100108,Electronics,48.08847427368164,2024-01-06,32,50,33.8568643951416,2745.1793212890625,5,1,1,1,54011,1
100108,Electronics,48.08847427368164,2024-01-07,44,50,39.35530822753906,3709.9271240234375,6,1,1,1,54055,1
100108,Electronics,48.08847427368164,2024-01-08,30,0,37.600616455078125,1128.0184936523438,0,1,0,2,54085,1
100108,Electronics,48.08847427368164,2024-01-09,63,110,41.8042155456543,7276.111158752442,1,1,0,2,54148,1
100108,Electronics,48.08847427368164,2024-01-10,76,83,42.921677703857426,6830.275010986328,2,1,0,2,54224,1
100108,Electronics,48.08847427368164,2024-01-11,117,157,46.017468490600585,12651.287626800537,3,1,0,2,54341,1
100108,Electronics,48.08847427368164,2024-01-12,143,140,50.15999282836914,14189.667948913575,4,1,0,2,54484,1
100108,Electronics,48.08847427368164,2024-01-13,53,0,48.28998565673828,2559.369239807129,5,1,1,2,54537,1
100108,Electronics,48.08847427368164,2024-01-14,101,88,44.62597419738769,8451.676787872315,6,1,1,2,54638,1
100108,Electronics,48.08847427368164,2024-01-15,62,92,41.857809677124024,6406.268399963379,0,1,0,3,54700,1
100108,Electronics,48.08847427368164,2024-01-16,115,145,41.91692581176758,10887.392936706543,1,1,0,3,54815,1
100108,Electronics,48.08847427368164,2024-01-17,95,0,42.283851623535156,4016.96590423584,2,1,0,3,54910,1
100108,Electronics,48.08847427368164,2024-01-18,53,168,55.95706764221191,12580.749170074463,3,1,0,3,54963,1
100108,Electronics,48.08847427368164,2024-01-19,74,0,54.09413528442383,4002.9660110473633,4,1,0,3,55037,1
100108,Electronics,48.08847427368164,2024-01-20,94,150,50.44952682495117,12260.99104309082,5,1,1,3,55131,1
100108,Electronics,48.08847427368164,2024-01-21,115,112,49.76377517700195,11298.24829071045,6,1,1,3,55246,1
100108,Electronics,48.08847427368164,2024-01-22,74,0,50.387550354003906,3728.678726196289,0,1,0,4,55320,1
100108,Electronics,48.08847427368164,2024-01-23,73,89,41.35654663085937,6657.735808105468,1,1,0,4,55393,1
100108,Electronics,48.08847427368164,2024-01-24,89,122,42.13415939331055,8874.000372009277,2,1,0,4,55482,1
100108,Electronics,48.08847427368164,2024-01-25,103,128,47.898909378051755,11107.175331878661,3,1,0,4,55585,1
100108,Electronics,48.08847427368164,2024-01-26,115,113,43.645767517089844,9953.246528930664,4,1,0,4,55700,1
100108,Electronics,48.08847427368164,2024-01-27,104,0,44.65153503417969,4643.7596435546875,5,1,1,4,55804,1
100108,Electronics,48.08847427368164,2024-01-28,41,118,50.02469459533691,8015.164956817627,6,1,1,4,55845,1
100108,Electronics,48.08847427368164,2024-01-29,82,126,47.554237136840825,9867.774890441895,0,1,0,5,55927,1
100108,Electronics,48.08847427368164,2024-01-30,34,0,48.08847427368164,1635.0081253051758,1,1,0,5,55961,1
100109,Clothing,94.78804016113281,2022-01-01,88,254,94.20000228881835,32216.40040283203,5,1,1,52,88,0
100109,Clothing,94.78804016113281,2022-01-02,133,107,93.51099060058593,22450.46349975586,6,1,1,52,221,0
100109,Clothing,94.78804016113281,2022-01-03,88,109,96.89453201293945,19113.537634277345,0,1,0,1,309,0
100109,Clothing,94.78804016113281,2022-01-04,88,115,85.61014602661132,17266.805700683595,1,1,0,1,397,0
100109,Clothing,94.78804016113281,2022-01-05,130,167,91.56869827270508,27220.00155090332,2,1,0,1,527,0
100109,Clothing,94.78804016113281,2022-01-06,152,151,97.49971130371094,29539.602236328123,3,1,0,1,679,0
100109,Clothing,94.78804016113281,2022-01-07,94,0,94.68942260742188,8900.805725097656,4,1,0,1,773,0
100109,Clothing,94.78804016113281,2022-01-08,83,105,89.9877116394043,16878.14013214111,5,1,1,1,856,0
100109,Clothing,94.78804016113281,2022-01-09,117,145,94.51226196289062,24788.469299316406,6,1,1,1,973,0
100109,Clothing,94.78804016113281,2022-01-10,180,174,103.75826858520509,36709.59669067383,0,1,0,2,1153,0
100109,Clothing,94.78804016113281,2022-01-11,174,188,104.07231689453124,37690.94627929687,1,1,0,2,1327,0
100109,Clothing,94.78804016113281,2022-01-12,150,172,93.1030990600586,29903.22971801758,2,1,0,2,1477,0
100109,Clothing,94.78804016113281,2022-01-13,101,158,97.80244674682618,25359.194242858888,3,1,0,2,1578,0
100109,Clothing,94.78804016113281,2022-01-14,86,0,97.30489349365234,8368.220840454102,4,1,0,2,1664,0
100109,Clothing,94.78804016113281,2022-01-15,151,166,110.85807830810546,35213.73964904786,5,1,1,2,1815,0
100109,Clothing,94.78804016113281,2022-01-16,138,113,85.51140258789061,21702.147114257812,6,1,1,2,1953,0
100109,Clothing,94.78804016113281,2022-01-17,114,128,88.02029953002929,21261.42829284668,0,1,0,3,2067,0
100109,Clothing,94.78804016113281,2022-01-18,173,201,113.68904144287109,42721.3283392334,1,1,0,3,2240,0
100109,Clothing,94.78804016113281,2022-01-19,134,119,103.87440139770507,26298.73957458496,2,1,0,3,2374,0
100109,Clothing,94.78804016113281,2022-01-20,31,0,105.10880279541016,3258.372886657715,3,1,0,3,2405,0
100109,Clothing,94.78804016113281,2022-01-21,167,226,99.64427658081055,39073.21837799072,4,1,0,3,2572,0
100109,Clothing,94.78804016113281,2022-01-22,123,0,101.1185531616211,12437.582038879395,5,1,1,3,2695,0
100109,Clothing,94.78804016113281,2022-01-23,63,54,85.5901936340332,10082.274397888184,6,1,1,3,2758,0
100109,Clothing,94.78804016113281,2022-01-24,94,131,92.99603805541992,20922.405154418946,0,1,0,4,2852,0
100109,Clothing,94.78804016113281,2022-01-25,109,115,94.4199838256836,21153.076473999026,1,1,0,4,2961,0
100109,Clothing,94.78804016113281,2022-01-26,71,119,87.76764846801757,16567.966082458493,2,1,0,4,3032,0
100109,Clothing,94.78804016113281,2022-01-27,102,130,96.03671600341798,22350.610064697266,3,1,0,4,3134,0
100109,Clothing,94.78804016113281,2022-01-28,133,0,93.53343200683594,12439.94645690918,4,1,0,4,3267,0
100109,Clothing,94.78804016113281,2022-01-29,80,119,86.39566497802734,17122.706396484376,5,1,1,4,3347,0
100109,Clothing,94.78804016113281,2022-01-30,119,149,97.61947372436524,26242.734746398928,6,1,1,4,3466,0
100109,Clothing,94.78804016113281,2022-01-31,101,99,89.87159881591796,17978.662960815433,0,1,0,5,3567,0
100109,Clothing,94.78804016113281,2022-02-01,123,151,108.82555404663086,29972.04629547119,1,2,0,5,3690,0
100109,Clothing,94.78804016113281,2022-02-02,175,216,89.94053939819335,35008.468789367675,2,2,0,5,3865,0
100109,Clothing,94.78804016113281,2022-02-03,216,248,108.43154388427735,50454.266958007815,3,2,0,5,4081,0
100109,Clothing,94.78804016113281,2022-02-04,131,0,103.99308776855469,13623.094497680664,4,2,0,5,4212,0
100109,Clothing,94.78804016113281,2022-02-05,117,216,110.75824508666992,37025.22935028076,5,2,1,5,4329,0
100109,Clothing,94.78804016113281,2022-02-06,184,166,103.01413787841797,36099.66273925781,6,2,1,5,4513,0
100109,Clothing,94.78804016113281,2022-02-07,142,128,95.7440463256836,25910.44915649414,0,2,0,6,4655,0
100109,Clothing,94.78804016113281,2022-02-08,86,132,99.99944305419922,21799.904205322266,1,2,0,6,4741,0
100109,Clothing,94.78804016113281,2022-02-09,192,166,102.68904449462892,36734.0530859375,2,2,0,6,4933,0
100109,Clothing,94.78804016113281,2022-02-10,79,0,101.58808898925781,8025.459030151367,3,2,0,6,5012,0
100109,Clothing,94.78804016113281,2022-02-11,92,104,97.10342880249024,19012.070899658203,4,2,0,6,5104,0
100109,Clothing,94.78804016113281,2022-02-12,137,178,96.08172897338866,30234.923738708494,5,2,1,6,5241,0
100109,Clothing,94.78804016113281,2022-02-13,66,0,96.83345794677734,6391.008224487305,6,2,1,6,5307,0
100109,Clothing,94.78804016113281,2022-02-14,112,161,90.74994262695313,24697.807148437503,0,2,0,7,5419,0
100109,Clothing,94.78804016113281,2022-02-15,161,154,109.71763870239258,34519.249662170405,1,2,0,7,5580,0
100109,Clothing,94.78804016113281,2022-02-16,104,87,86.198448638916,16603.95731689453,2,2,0,7,5684,0
100109,Clothing,94.78804016113281,2022-02-17,137,167,111.84615905761719,34153.14758178711,3,2,0,7,5821,0
100109,Clothing,94.78804016113281,2022-02-18,43,0,106.78231811523438,4591.639678955078,4,2,0,7,5864,0
100109,Clothing,94.78804016113281,2022-02-19,104,107,81.84031936645508,17240.856428222658,5,2,1,7,5968,0
100109,Clothing,94.78804016113281,2022-02-20,109,144,93.24891540527344,23616.16355834961,6,2,1,7,6077,0
100109,Clothing,94.78804016113281,2022-02-21,47,0,92.55783081054688,4350.218048095703,0,2,0,8,6124,0
100109,Clothing,94.78804016113281,2022-02-22,56,98,92.32579910278321,14214.569499511717,1,2,0,8,6180,0
100109,Clothing,94.78804016113281,2022-02-23,139,165,103.26958251953124,31484.963940429687,2,2,0,8,6319,0
100109,Clothing,94.78804016113281,2022-02-24,126,105,96.05124298095703,22224.19323120117,3,2,0,8,6445,0
100109,Clothing,94.78804016113281,2022-02-25,102,125,100.1780534362793,22762.082901000977,4,2,0,8,6547,0
100109,Clothing,94.78804016113281,2022-02-26,185,181,109.87263809204102,40198.996094055175,5,2,1,8,6732,0
100109,Clothing,94.78804016113281,2022-02-27,100,110,88.15773986816407,18431.347973632815,6,2,1,8,6832,0
100109,Clothing,94.78804016113281,2022-02-28,82,145,94.37749557495117,21374.709274291992,0,2,0,9,6914,0
100109,Clothing,94.78804016113281,2022-03-01,116,0,95.15499114990234,11037.978973388672,1,3,0,9,7030,0
100109,Clothing,94.78804016113281,2022-03-02,138,197,100.01048828124999,33577.824765625,2,3,0,9,7168,0
100109,Clothing,94.78804016113281,2022-03-03,70,0,98.7509765625,6912.568359375,3,3,0,9,7238,0
100109,Clothing,94.78804016113281,2022-03-04,127,139,96.8089729309082,25743.879124450687,4,3,0,9,7365,0
100109,Clothing,94.78804016113281,2022-03-05,91,85,90.47375946044922,15942.124221801758,5,3,1,9,7456,0
100109,Clothing,94.78804016113281,2022-03-06,133,183,100.91867309570313,31987.86704345703,6,3,1,9,7589,0
100109,Clothing,94.78804016113281,2022-03-07,141,116,105.82570724487304,27121.599443054198,0,3,0,10,7730,0
100109,Clothing,94.78804016113281,2022-03-08,158,148,99.18023391723634,30361.75391784668,1,3,0,10,7888,0
100109,Clothing,94.78804016113281,2022-03-09,5,0,100.44046783447266,502.2023391723633,2,3,0,10,7893,0
100109,Clothing,94.78804016113281,2022-03-10,81,105,83.53741333007812,15373.620959472657,3,3,0,10,7974,0
100109,Clothing,94.78804016113281,2022-03-11,101,86,79.82971710205078,15006.152854614258,4,3,0,10,8075,0
100109,Clothing,94.78804016113281,2022-03-12,152,140,97.34629043579102,28373.11229248047,5,3,1,10,8227,0
100109,Clothing,94.78804016113281,2022-03-13,56,102,88.25587097167968,13855.377548828124,6,3,1,10,8283,0
100109,Clothing,94.78804016113281,2022-03-14,69,0,90.19174194335938,6223.230194091797,0,3,0,11,8352,0
100109,Clothing,94.78804016113281,2022-03-15,75,75,83.65459396362306,12548.189094543457,1,3,0,11,8427,0
100109,Clothing,94.78804016113281,2022-03-16,105,107,84.43626174926757,17899.014967346193,2,3,0,11,8532,0
100109,Clothing,94.78804016113281,2022-03-17,89,88,76.47036407470702,13538.764805297851,3,3,0,11,8621,0
100109,Clothing,94.78804016113281,2022-03-18,61,96,89.64234939575195,14202.566626281738,4,3,0,11,8682,0
100109,Clothing,94.78804016113281,2022-03-19,99,122,93.59092391967773,20751.19293609619,5,3,1,11,8781,0
100109,Clothing,94.78804016113281,2022-03-20,150,119,101.56190643310546,27176.371929931644,6,3,1,11,8931,0
100109,Clothing,94.78804016113281,2022-03-21,40,67,85.95212936401367,9042.920349121094,0,3,0,12,8971,0
100109,Clothing,94.78804016113281,2022-03-22,60,0,91.65425872802734,5499.255523681641,1,3,0,12,9031,0
100109,Clothing,94.78804016113281,2022-03-23,112,148,80.43091659545898,20801.12531738281,2,3,0,12,9143,0
100109,Clothing,94.78804016113281,2022-03-24,106,83,87.25547958374023,16450.70167175293,3,3,0,12,9249,0
100109,Clothing,94.78804016113281,2022-03-25,125,170,98.89638900756836,29336.59725189209,4,3,0,12,9374,0
100109,Clothing,94.78804016113281,2022-03-26,163,208,102.17379852294923,37996.308318481446,5,3,1,12,9537,0
100109,Clothing,94.78804016113281,2022-03-27,122,0,100.17759704589844,12221.66683959961,6,3,1,12,9659,0
100109,Clothing,94.78804016113281,2022-03-28,78,83,84.1758154296875,13523.57720703125,0,3,0,13,9737,0
100109,Clothing,94.78804016113281,2022-03-29,98,173,97.44863479614258,26533.182420043944,1,3,0,13,9835,0
100109,Clothing,94.78804016113281,2022-03-30,114,119,103.73472122192382,24186.916438598633,2,3,0,13,9949,0
100109,Clothing,94.78804016113281,2022-03-31,66,0,100.38944244384766,6625.703201293945,3,3,0,13,10015,0
100109,Clothing,94.78804016113281,2022-04-01,68,109,87.93646286010741,15391.468948974609,4,4,0,13,10083,0
100109,Clothing,94.78804016113281,2022-04-02,90,127,91.60844345092774,19871.319821166995,5,4,1,13,10173,0
100109,Clothing,94.78804016113281,2022-04-03,43,0,91.81688690185547,3948.126136779785,6,4,1,13,10216,0
100109,Clothing,94.78804016113281,2022-04-04,108,74,85.99905471801758,15750.395819091797,0,4,0,14,10324,0
100109,Clothing,94.78804016113281,2022-04-05,100,135,93.10793762207031,21923.837524414062,1,4,0,14,10424,0
100109,Clothing,94.78804016113281,2022-04-06,66,80,83.85120391845703,12188.358917236328,2,4,0,14,10490,0
100109,Clothing,94.78804016113281,2022-04-07,152,165,92.47013809204103,29333.441979980467,3,4,0,14,10642,0
100109,Clothing,94.78804016113281,2022-04-08,78,127,97.64759750366211,20152.625210571292,4,4,0,14,10720,0
100109,Clothing,94.78804016113281,2022-04-09,64,0,94.89519500732422,6073.29248046875,5,4,1,14,10784,0
100109,Clothing,94.78804016113281,2022-04-10,151,145,105.95693618774413,31339.65472869873,6,4,1,14,10935,0
100109,Clothing,94.78804016113281,2022-04-11,107,90,99.27667510986328,19579.038473510744,0,4,0,15,11042,0
100109,Clothing,94.78804016113281,2022-04-12,112,89,91.13283111572267,18411.834169921876,1,4,0,15,11154,0
100109,Clothing,94.78804016113281,2022-04-13,114,132,97.75667739868163,24061.882446899413,2,4,0,15,11268,0
100109,Clothing,94.78804016113281,2022-04-14,132,172,93.42855712890625,28362.73908203125,3,4,0,15,11400,0
100109,Clothing,94.78804016113281,2022-04-15,76,117,93.83613006591797,18100.28177001953,4,4,0,15,11476,0
100109,Clothing,94.78804016113281,2022-04-16,124,176,86.42625000000001,25777.79,5,4,1,15,11600,0
100109,Clothing,94.78804016113281,2022-04-17,151,0,89.3125,13486.1875,6,4,1,15,11751,0
100109,Clothing,94.78804016113281,2022-04-18,89,77,79.53085189819336,13252.05163787842,0,4,0,16,11840,0
100109,Clothing,94.78804016113281,2022-04-19,97,131,95.32900039672852,21845.886076965333,1,4,0,16,11937,0
100109,Clothing,94.78804016113281,2022-04-20,121,106,85.2532405090332,19392.434203186036,2,4,0,16,12058,0
100109,Clothing,94.78804016113281,2022-04-21,35,50,74.61998168945313,6233.498718261719,3,4,0,16,12093,0
100109,Clothing,94.78804016113281,2022-04-22,100,105,83.37874267578124,17095.54853515625,4,4,0,16,12193,0
100109,Clothing,94.78804016113281,2022-04-23,141,151,92.31175415039063,26985.314670410156,5,4,1,16,12334,0
100109,Clothing,94.78804016113281,2022-04-24,70,86,76.49058807373046,11836.842330322266,6,4,1,16,12404,0
100109,Clothing,94.78804016113281,2022-04-25,147,141,81.61022140502931,23505.665093078613,0,4,0,17,12551,0
100109,Clothing,94.78804016113281,2022-04-26,80,78,75.00655090332032,11858.06814453125,1,4,0,17,12631,0
100109,Clothing,94.78804016113281,2022-04-27,74,140,77.27283111572265,16506.499005126952,2,4,0,17,12705,0
100109,Clothing,94.78804016113281,2022-04-28,114,0,77.72566223144531,8860.725494384766,3,4,0,17,12819,0
100109,Clothing,94.78804016113281,2022-04-29,55,55,78.73370086669922,8660.707095336915,4,4,0,17,12874,0
100109,Clothing,94.78804016113281,2022-04-30,94,128,84.79393447875977,18891.779682006836,5,4,1,17,12968,0
100109,Clothing,94.78804016113281,2022-05-01,73,88,82.96776916503907,13358.894298095704,6,5,1,17,13041,0
100109,Clothing,94.78804016113281,2022-05-02,152,106,94.79985900878907,24222.837138671875,0,5,0,18,13193,0
100109,Clothing,94.78804016113281,2022-05-03,87,118,97.69825103759766,20109.105680541994,1,5,0,18,13280,0
100109,Clothing,94.78804016113281,2022-05-04,45,86,81.01602462768554,10349.2222164917,2,5,0,18,13325,0
100109,Clothing,94.78804016113281,2022-05-05,103,123,97.8661506652832,22207.42703704834,3,5,0,18,13428,0
100109,Clothing,94.78804016113281,2022-05-06,79,0,93.3823013305664,7377.201805114746,4,5,0,18,13507,0
100109,Clothing,94.78804016113281,2022-05-07,104,125,88.68304138183593,20275.172607421875,5,5,1,18,13611,0
100109,Clothing,94.78804016113281,2022-05-08,132,148,99.97402236938476,28044.50190551758,6,5,1,18,13743,0
100109,Clothing,94.78804016113281,2022-05-09,55,97,93.26911911010743,14110.163102111817,0,5,0,19,13798,0
100109,Clothing,94.78804016113281,2022-05-10,70,0,94.85823822021484,6640.076675415039,1,5,0,19,13868,0
100109,Clothing,94.78804016113281,2022-05-11,136,143,98.98881927490234,27627.198842773436,2,5,0,19,14004,0
100109,Clothing,94.78804016113281,2022-05-12,83,114,88.8246354675293,17392.909487609864,3,5,0,19,14087,0
100109,Clothing,94.78804016113281,2022-05-13,101,107,88.34286956787109,18364.859652709958,4,5,0,19,14188,0
100109,Clothing,94.78804016113281,2022-05-14,113,128,88.4183676147461,21298.50108093262,5,5,1,19,14301,0
100109,Clothing,94.78804016113281,2022-05-15,74,0,89.10673522949219,6593.898406982422,6,5,1,19,14375,0
100109,Clothing,94.78804016113281,2022-05-16,121,134,81.5656770324707,20768.75384185791,0,5,0,20,14496,0
100109,Clothing,94.78804016113281,2022-05-17,134,181,100.60108154296876,31901.259853515625,1,5,0,20,14630,0
100109,Clothing,94.78804016113281,2022-05-18,125,121,95.43934066772461,23479.195166931153,2,5,0,20,14755,0
100109,Clothing,94.78804016113281,2022-05-19,177,235,93.21494735717773,38364.83136444092,3,5,0,20,14932,0
100109,Clothing,94.78804016113281,2022-05-20,124,0,93.89989471435547,11643.586944580078,4,5,0,20,15056,0
100109,Clothing,94.78804016113281,2022-05-21,58,75,87.92222732543945,11650.438369750977,5,5,1,20,15114,0
100109,Clothing,94.78804016113281,2022-05-22,61,82,81.91688247680665,11635.42966217041,6,5,1,20,15175,0
100109,Clothing,94.78804016113281,2022-05-23,81,133,80.87083358764649,17216.87504119873,0,5,0,21,15256,0
100109,Clothing,94.78804016113281,2022-05-24,109,200,92.81191467285157,28989.92739868164,1,5,0,21,15365,0
100109,Clothing,94.78804016113281,2022-05-25,125,0,89.39382934570312,11174.22866821289,2,5,0,21,15490,0
100109,Clothing,94.78804016113281,2022-05-26,121,133,83.48783157348632,21178.57524078369,3,5,0,21,15611,0
100109,Clothing,94.78804016113281,2022-05-27,140,114,85.89369354248046,21815.534191894534,4,5,0,21,15751,0
100109,Clothing,94.78804016113281,2022-05-28,87,167,99.61995468139648,25649.87211456299,5,5,1,21,15838,0
100109,Clothing,94.78804016113281,2022-05-29,124,0,95.28990936279297,11815.948760986328,6,5,1,21,15962,0
100109,Clothing,94.78804016113281,2022-05-30,72,100,92.80614837646485,15938.125366210938,0,5,0,22,16034,0
100109,Clothing,94.78804016113281,2022-05-31,85,100,96.80893234252929,17928.71849822998,1,5,0,22,16119,0
100109,Clothing,94.78804016113281,2022-06-01,101,93,94.86333587646484,18405.9138470459,2,6,0,22,16220,0
100109,Clothing,94.78804016113281,2022-06-02,125,156,95.11600189208984,26727.10047302246,3,6,0,22,16345,0
100109,Clothing,94.78804016113281,2022-06-03,139,121,86.82581130981445,22637.455544128417,4,6,0,22,16484,0
100109,Clothing,94.78804016113281,2022-06-04,79,88,95.17639862060547,15915.100982055665,5,6,1,22,16563,0
100109,Clothing,94.78804016113281,2022-06-05,105,74,89.73442474365234,16114.059196166992,6,6,1,22,16668,0
100109,Clothing,94.78804016113281,2022-06-06,26,0,91.39884948730469,2376.370086669922,0,6,0,23,16694,0
100109,Clothing,94.78804016113281,2022-06-07,78,78,83.03870086669922,12954.037335205077,1,6,0,23,16772,0
100109,Clothing,94.78804016113281,2022-06-08,109,147,85.03903503417969,21755.209637451175,2,6,0,23,16881,0
100109,Clothing,94.78804016113281,2022-06-09,65,77,83.02405624389648,11775.327311706544,3,6,0,23,16946,0
100109,Clothing,94.78804016113281,2022-06-10,62,59,83.43692779541016,10097.17904663086,4,6,0,23,17008,0
100109,Clothing,94.78804016113281,2022-06-11,71,125,87.3025651550293,17182.44425201416,5,6,1,23,17079,0
100109,Clothing,94.78804016113281,2022-06-12,81,0,85.9851303100586,6964.795555114746,6,6,1,23,17160,0
100109,Clothing,94.78804016113281,2022-06-13,108,113,93.60212951660156,20699.90997558594,0,6,0,24,17268,0
100109,Clothing,94.78804016113281,2022-06-14,90,94,79.2646728515625,14565.44111328125,1,6,0,24,17358,0
100109,Clothing,94.78804016113281,2022-06-15,51,76,78.44918228149413,9896.066592712403,2,6,0,24,17409,0
100109,Clothing,94.78804016113281,2022-06-16,19,0,81.12836456298828,1541.4389266967773,3,6,0,24,17428,0
100109,Clothing,94.78804016113281,2022-06-17,135,173,80.84366882324218,24896.670582275394,4,6,0,24,17563,0
100109,Clothing,94.78804016113281,2022-06-18,94,107,74.00258651733398,14833.146265258787,5,6,1,24,17657,0
100109,Clothing,94.78804016113281,2022-06-19,111,119,85.72439208984375,19747.375043945314,6,6,1,24,17768,0
100109,Clothing,94.78804016113281,2022-06-20,91,0,81.8787841796875,7450.9693603515625,0,6,0,25,17859,0
100109,Clothing,94.78804016113281,2022-06-21,91,117,92.85651596069336,19406.545904846193,1,6,0,25,17950,0
100109,Clothing,94.78804016113281,2022-06-22,125,122,76.87111419677734,19000.638549194337,2,6,0,25,18075,0
100109,Clothing,94.78804016113281,2022-06-23,84,99,86.82525970458985,15922.243630371095,3,6,0,25,18159,0
100109,Clothing,94.78804016113281,2022-06-24,95,122,77.07778976440429,16648.450055236815,4,6,0,25,18254,0
100109,Clothing,94.78804016113281,2022-06-25,109,137,88.34396011352538,21824.903304748535,5,6,1,25,18363,0
100109,Clothing,94.78804016113281,2022-06-26,113,125,84.47026489257811,20100.799865722656,6,6,1,25,18476,0
100109,Clothing,94.78804016113281,2022-06-27,72,0,84.73052978515625,6100.59814453125,0,6,0,26,18548,0
100109,Clothing,94.78804016113281,2022-06-28,79,64,78.68891738891602,11300.648947448732,1,6,0,26,18627,0
100109,Clothing,94.78804016113281,2022-06-29,130,146,97.63274978637696,27024.19494445801,2,6,0,26,18757,0
100109,Clothing,94.78804016113281,2022-06-30,138,116,87.64534957885742,22305.596483764646,3,6,0,26,18895,0
100109,Clothing,94.78804016113281,2022-07-01,124,122,81.44741317749023,20041.57846801758,4,7,0,26,19019,0
100109,Clothing,94.78804016113281,2022-07-02,122,219,111.3304835510254,38536.91798645019,5,7,1,26,19141,0
100109,Clothing,94.78804016113281,2022-07-03,165,172,106.39940322875977,35859.263065490726,6,7,1,26,19306,0
100109,Clothing,94.78804016113281,2022-07-04,132,0,106.01880645751953,13994.482452392578,0,7,0,27,19438,0
100109,Clothing,94.78804016113281,2022-07-05,94,162,97.74142211914062,24895.227358398435,1,7,0,27,19532,0
100109,Clothing,94.78804016113281,2022-07-06,88,86,89.1836294555664,15528.058784179688,2,7,0,27,19620,0
100109,Clothing,94.78804016113281,2022-07-07,147,198,89.06765655517577,30652.47102722168,3,7,0,27,19767,0
100109,Clothing,94.78804016113281,2022-07-08,192,191,108.89456649780274,41700.09353515625,4,7,0,27,19959,0
100109,Clothing,94.78804016113281,2022-07-09,68,0,102.36913299560547,6961.101043701172,5,7,1,27,20027,0
100109,Clothing,94.78804016113281,2022-07-10,138,129,83.07826065063477,22243.529939575194,6,7,1,27,20165,0
100109,Clothing,94.78804016113281,2022-07-11,86,72,87.55748077392579,13850.006693115234,0,7,0,28,20251,0
100109,Clothing,94.78804016113281,2022-07-12,66,85,91.0006118774414,13759.130767822266,1,7,0,28,20317,0
100109,Clothing,94.78804016113281,2022-07-13,138,133,97.1240382385254,26308.534553833008,2,7,0,28,20455,0
100109,Clothing,94.78804016113281,2022-07-14,102,148,99.17511489868164,24857.483439331056,3,7,0,28,20557,0
100109,Clothing,94.78804016113281,2022-07-15,86,0,97.79022979736328,8409.959762573242,4,7,0,28,20643,0
100109,Clothing,94.78804016113281,2022-07-16,93,146,100.79433227539062,24128.305803222655,5,7,1,28,20736,0
100109,Clothing,94.78804016113281,2022-07-17,28,0,100.06866455078125,2801.922607421875,6,7,1,28,20764,0
100109,Clothing,94.78804016113281,2022-07-18,56,78,87.51592605590821,11608.203718261719,0,7,0,29,20820,0
100109,Clothing,94.78804016113281,2022-07-19,31,50,79.56278778076171,6296.522842407227,1,7,0,29,20851,0
100109,Clothing,94.78804016113281,2022-07-20,81,109,86.30364959716798,16385.27123474121,2,7,0,29,20932,0
100109,Clothing,94.78804016113281,2022-07-21,77,92,86.63606552124023,14640.654090270997,3,7,0,29,21009,0
100109,Clothing,94.78804016113281,2022-07-22,202,200,105.11742630004883,42244.84022521973,4,7,0,29,21211,0
100109,Clothing,94.78804016113281,2022-07-23,125,168,96.46251251220704,28223.84812805176,5,7,1,29,21336,0
100109,Clothing,94.78804016113281,2022-07-24,121,0,97.38502502441406,11783.588027954102,6,7,1,29,21457,0
100109,Clothing,94.78804016113281,2022-07-25,122,237,98.78369537353515,35496.271671142575,0,7,0,30,21579,0
100109,Clothing,94.78804016113281,2022-07-26,123,0,98.49739074707031,12115.179061889648,1,7,0,30,21702,0
100109,Clothing,94.78804016113281,2022-07-27,54,90,72.91838836669922,10143.185943603516,2,7,0,30,21756,0
100109,Clothing,94.78804016113281,2022-07-28,125,152,101.20966400146484,28198.97600036621,3,7,0,30,21881,0
100109,Clothing,94.78804016113281,2022-07-29,85,0,95.13932800292969,8086.842880249023,4,7,0,30,21966,0
100109,Clothing,94.78804016113281,2022-07-30,92,137,101.86051788330079,23402.085290527342,5,7,1,30,22058,0
100109,Clothing,94.78804016113281,2022-07-31,137,139,97.05024124145507,26783.80610015869,6,7,1,30,22195,0
100109,Clothing,94.78804016113281,2022-08-01,57,81,84.32992385864259,11485.131319885255,0,8,0,31,22252,0
100109,Clothing,94.78804016113281,2022-08-02,99,113,84.19662307739259,17811.65136932373,1,8,0,31,22351,0
100109,Clothing,94.78804016113281,2022-08-03,50,0,86.91324615478516,4345.662307739258,2,8,0,31,22401,0
100109,Clothing,94.78804016113281,2022-08-04,117,160,89.67526290893554,24873.791520690917,3,8,0,31,22518,0
100109,Clothing,94.78804016113281,2022-08-05,98,142,94.17953308105469,22690.22848388672,4,8,0,31,22616,0
100109,Clothing,94.78804016113281,2022-08-06,143,142,98.75345626831054,28141.918492736815,5,8,1,31,22759,0
100109,Clothing,94.78804016113281,2022-08-07,125,136,98.97551849365234,25847.289623413086,6,8,1,31,22884,0
100109,Clothing,94.78804016113281,2022-08-08,91,0,97.64103698730469,8885.334365844727,0,8,0,32,22975,0
100109,Clothing,94.78804016113281,2022-08-09,79,113,76.14406188964844,14348.881778564453,1,8,0,32,23054,0
100109,Clothing,94.78804016113281,2022-08-10,95,118,87.70109817504883,18714.578653259276,2,8,0,32,23149,0
100109,Clothing,94.78804016113281,2022-08-11,114,127,79.30554656982422,19074.21461791992,3,8,0,32,23263,0
100109,Clothing,94.78804016113281,2022-08-12,122,151,101.1550178527832,27835.5743560791,4,8,0,32,23385,0
100109,Clothing,94.78804016113281,2022-08-13,208,248,102.39459274291991,46804.55058105469,5,8,1,32,23593,0
100109,Clothing,94.78804016113281,2022-08-14,85,0,99.57918548583984,8464.230766296387,6,8,1,32,23678,0
100109,Clothing,94.78804016113281,2022-08-15,72,0,99.57918548583984,7169.701354980469,0,8,0,33,23750,0
100109,Clothing,94.78804016113281,2022-08-16,79,114,89.72416015625001,17201.1173046875,1,8,0,33,23829,0
100109,Clothing,94.78804016113281,2022-08-17,79,80,82.96793060302734,13187.03303527832,2,8,0,33,23908,0
100109,Clothing,94.78804016113281,2022-08-18,53,0,87.83586120605469,4655.300643920898,3,8,0,33,23961,0
100109,Clothing,94.78804016113281,2022-08-19,83,121,92.37240966796875,18893.66000488281,4,8,0,33,24044,0
100109,Clothing,94.78804016113281,2022-08-20,117,157,86.9527554321289,23775.344771118165,5,8,1,33,24161,0
100109,Clothing,94.78804016113281,2022-08-21,106,119,94.24025466918945,21237.463989868163,6,8,1,33,24267,0
100109,Clothing,94.78804016113281,2022-08-22,109,93,84.36963912963867,17101.54133026123,0,8,0,34,24376,0
100109,Clothing,94.78804016113281,2022-08-23,118,126,97.01885314941407,23701.809343261717,1,8,0,34,24494,0
100109,Clothing,94.78804016113281,2022-08-24,141,138,97.5955255126953,27224.12819458008,2,8,0,34,24635,0
100109,Clothing,94.78804016113281,2022-08-25,170,172,96.79275314331055,33103.71606872558,3,8,0,34,24805,0
100109,Clothing,94.78804016113281,2022-08-26,118,159,84.68783279418946,23283.54853942871,4,8,0,34,24923,0
100109,Clothing,94.78804016113281,2022-08-27,182,170,84.41768783569336,29736.47837219238,5,8,1,34,25105,0
100109,Clothing,94.78804016113281,2022-08-28,56,0,86.20537567138672,4827.501037597656,6,8,1,34,25161,0
100109,Clothing,94.78804016113281,2022-08-29,96,88,85.49183090209961,15733.151533203125,0,8,0,35,25257,0
100109,Clothing,94.78804016113281,2022-08-30,21,0,85.82366180419922,1802.2968978881836,1,8,0,35,25278,0
100109,Clothing,94.78804016113281,2022-08-31,101,98,89.84985168457031,17875.440040283203,2,8,0,35,25379,0
100109,Clothing,94.78804016113281,2022-09-01,73,56,77.38365493774414,10078.773620910644,3,9,0,35,25452,0
100109,Clothing,94.78804016113281,2022-09-02,104,150,95.59889892578124,24430.7509765625,4,9,0,35,25556,0
100109,Clothing,94.78804016113281,2022-09-03,128,206,90.86981903076172,30319.333671875,5,9,1,35,25684,0
100109,Clothing,94.78804016113281,2022-09-04,151,0,91.26963806152344,13781.715347290039,6,9,1,35,25835,0
100109,Clothing,94.78804016113281,2022-09-05,77,127,100.83485916137695,20681.568310852053,0,9,0,36,25912,0
100109,Clothing,94.78804016113281,2022-09-06,78,86,83.1615837097168,13586.007058715819,1,9,0,36,25990,0
100109,Clothing,94.78804016113281,2022-09-07,44,59,70.10708267211913,7064.023275146485,2,9,0,36,26034,0
100109,Clothing,94.78804016113281,2022-09-08,87,72,86.26600357055665,13672.734621276855,3,9,0,36,26121,0
100109,Clothing,94.78804016113281,2022-09-09,120,170,91.11618438720703,26533.88425292969,4,9,0,36,26241,0
100109,Clothing,94.78804016113281,2022-09-10,109,107,92.00573226928711,19870.36963470459,5,9,1,36,26350,0
100109,Clothing,94.78804016113281,2022-09-11,93,106,89.95541091918946,17897.41643096924,6,9,1,36,26443,0
100109,Clothing,94.78804016113281,2022-09-12,107,127,83.08622680664062,19379.852536621096,0,9,0,37,26550,0
100109,Clothing,94.78804016113281,2022-09-13,69,0,86.20245361328125,5947.969299316406,1,9,0,37,26619,0
100109,Clothing,94.78804016113281,2022-09-14,109,152,95.40160675048828,25028.75027160645,2,9,0,37,26728,0
100109,Clothing,94.78804016113281,2022-09-15,177,178,115.27941619873047,40932.15333435059,3,9,0,37,26905,0
100109,Clothing,94.78804016113281,2022-09-16,85,135,93.53915313720702,20293.156033325195,4,9,0,37,26990,0
100109,Clothing,94.78804016113281,2022-09-17,101,0,99.24830627441406,10024.07893371582,5,9,1,37,27091,0
100109,Clothing,94.78804016113281,2022-09-18,123,132,83.87676849365235,21340.635049438475,6,9,1,37,27214,0
100109,Clothing,94.78804016113281,2022-09-19,118,147,99.5575099182129,26483.732340698243,0,9,0,38,27332,0
100109,Clothing,94.78804016113281,2022-09-20,137,116,89.94244064331055,22811.34873626709,1,9,0,38,27469,0
100109,Clothing,94.78804016113281,2022-09-21,57,76,87.73456085205078,11621.67993713379,2,9,0,38,27526,0
100109,Clothing,94.78804016113281,2022-09-22,64,0,90.20912170410156,5773.3837890625,3,9,0,38,27590,0
100109,Clothing,94.78804016113281,2022-09-23,112,137,96.46486343383789,24065.129409179688,4,9,0,38,27702,0
100109,Clothing,94.78804016113281,2022-09-24,137,141,103.94932281494141,28910.074451293945,5,9,1,38,27839,0
100109,Clothing,94.78804016113281,2022-09-25,136,105,96.32949172973633,23272.43175048828,6,9,1,38,27975,0
100109,Clothing,94.78804016113281,2022-09-26,73,75,82.26051010131836,12161.09447479248,0,9,0,39,28048,0
100109,Clothing,94.78804016113281,2022-09-27,51,78,83.1295622253418,10657.575346984864,1,9,0,39,28099,0
100109,Clothing,94.78804016113281,2022-09-28,47,58,78.37626419067382,8186.31883392334,2,9,0,39,28146,0
100109,Clothing,94.78804016113281,2022-09-29,79,110,83.48188064575194,15792.897142028807,3,9,0,39,28225,0
100109,Clothing,94.78804016113281,2022-09-30,72,85,83.89857452392579,13178.074731445313,4,9,0,39,28297,0
100109,Clothing,94.78804016113281,2022-10-01,63,0,83.43714904785156,5256.540390014648,5,10,1,39,28360,0
100109,Clothing,94.78804016113281,2022-10-02,105,140,94.7835189819336,23348.538986206055,6,10,1,39,28465,0
100109,Clothing,94.78804016113281,2022-10-03,77,102,86.09538665771484,15354.189545288085,0,10,0,40,28542,0
100109,Clothing,94.78804016113281,2022-10-04,66,0,88.37077331542969,5832.471038818359,1,10,0,40,28608,0
100109,Clothing,94.78804016113281,2022-10-05,125,122,93.44207580566406,23075.038951416016,2,10,0,40,28733,0
100109,Clothing,94.78804016113281,2022-10-06,90,96,76.92859252929688,14274.226655273438,3,10,0,40,28823,0
100109,Clothing,94.78804016113281,2022-10-07,67,75,84.26768493652344,11971.86978149414,4,10,0,40,28890,0
100109,Clothing,94.78804016113281,2022-10-08,136,100,92.9281561279297,21794.178466796875,5,10,1,40,29026,0
100109,Clothing,94.78804016113281,2022-10-09,85,94,70.65399658203125,12589.339418945312,6,10,1,40,29111,0
100109,Clothing,94.78804016113281,2022-10-10,96,121,83.33411087036133,18132.149287109376,0,10,0,41,29207,0
100109,Clothing,94.78804016113281,2022-10-11,73,88,80.12572387695312,12892.055686035157,1,10,0,41,29280,0
100109,Clothing,94.78804016113281,2022-10-12,76,86,79.73477783203126,12912.68623046875,2,10,0,41,29356,0
100109,Clothing,94.78804016113281,2022-10-13,52,0,80.1695556640625,4168.81689453125,3,10,0,41,29408,0
100109,Clothing,94.78804016113281,2022-10-14,69,89,79.05750686645507,12482.7359475708,4,10,0,41,29477,0
100109,Clothing,94.78804016113281,2022-10-15,127,182,106.70643615722656,33359.68478393555,5,10,1,41,29604,0
100109,Clothing,94.78804016113281,2022-10-16,50,0,99.66287231445312,4983.143615722656,6,10,1,41,29654,0
100109,Clothing,94.78804016113281,2022-10-17,107,113,94.81681503295898,20848.978417053222,0,10,0,42,29761,0
100109,Clothing,94.78804016113281,2022-10-18,76,126,78.55606170654298,15549.021379394531,1,10,0,42,29837,0
100109,Clothing,94.78804016113281,2022-10-19,35,0,84.94212341308594,2972.974319458008,2,10,0,42,29872,0
100109,Clothing,94.78804016113281,2022-10-20,69,68,79.91265869140625,10950.696899414062,3,10,0,42,29941,0
100109,Clothing,94.78804016113281,2022-10-21,83,94,84.81066635131836,15022.480614318847,4,10,0,42,30024,0
100109,Clothing,94.78804016113281,2022-10-22,49,0,83.81133270263672,4106.755302429199,5,10,1,42,30073,0
100109,Clothing,94.78804016113281,2022-10-23,114,119,98.70612014770508,23022.645393676758,6,10,1,42,30187,0
100109,Clothing,94.78804016113281,2022-10-24,63,71,81.73046371459961,10907.55842803955,0,10,0,43,30250,0
100109,Clothing,94.78804016113281,2022-10-25,52,88,84.3036930847168,11757.744080810548,1,10,0,43,30302,0
100109,Clothing,94.78804016113281,2022-10-26,86,110,95.44689376831055,18808.705728149413,2,10,0,43,30388,0
100109,Clothing,94.78804016113281,2022-10-27,163,175,83.19822998046875,28087.422973632812,3,10,0,43,30551,0
100109,Clothing,94.78804016113281,2022-10-28,159,199,111.42411346435547,40228.868081665045,4,10,0,43,30710,0
100109,Clothing,94.78804016113281,2022-10-29,108,0,102.94822692871094,11118.408508300781,5,10,1,43,30818,0
100109,Clothing,94.78804016113281,2022-10-30,121,89,91.20747207641602,19312.848242492677,6,10,1,43,30939,0
100109,Clothing,94.78804016113281,2022-10-31,77,101,93.57757125854492,16636.22597381592,0,10,0,44,31016,0
100109,Clothing,94.78804016113281,2022-11-01,82,77,83.64935653686524,13324.1944720459,1,11,0,44,31098,0
100109,Clothing,94.78804016113281,2022-11-02,102,130,83.7985237121582,19400.698837280273,2,11,0,44,31200,0
100109,Clothing,94.78804016113281,2022-11-03,51,70,82.44196594238281,9948.270526123048,3,11,0,44,31251,0
100109,Clothing,94.78804016113281,2022-11-04,72,81,85.40662368774414,13074.173811035158,4,11,0,44,31323,0
100109,Clothing,94.78804016113281,2022-11-05,133,234,99.12289657592774,36774.740489196774,5,11,1,44,31456,0
100109,Clothing,94.78804016113281,2022-11-06,93,0,95.19579315185547,8853.208763122559,6,11,1,44,31549,0
100109,Clothing,94.78804016113281,2022-11-07,64,96,85.51229324340821,13531.17353515625,0,11,0,45,31613,0
100109,Clothing,94.78804016113281,2022-11-08,132,0,90.2245864868164,11909.645416259766,1,11,0,45,31745,0
100109,Clothing,94.78804016113281,2022-11-09,82,122,90.40469894409179,18444.370626831056,2,11,0,45,31827,0
100109,Clothing,94.78804016113281,2022-11-10,117,119,88.29096786499024,20835.266480407714,3,11,0,45,31944,0
100109,Clothing,94.78804016113281,2022-11-11,63,84,80.62365356445312,11777.050349121093,4,11,0,45,32007,0
100109,Clothing,94.78804016113281,2022-11-12,144,119,83.60621292114257,21993.839321289062,5,11,1,45,32151,0
100109,Clothing,94.78804016113281,2022-11-13,74,84,83.99012496948242,13271.1384954834,6,11,1,45,32225,0
100109,Clothing,94.78804016113281,2022-11-14,71,95,81.59473724365235,13522.052688598633,0,11,0,46,32296,0
100109,Clothing,94.78804016113281,2022-11-15,80,86,82.5873715209961,13709.639443359374,1,11,0,46,32376,0
100109,Clothing,94.78804016113281,2022-11-16,79,69,85.22934158325195,12599.63597015381,2,11,0,46,32455,0
100109,Clothing,94.78804016113281,2022-11-17,113,136,99.24839508056641,24839.157288208007,3,11,0,46,32568,0
100109,Clothing,94.78804016113281,2022-11-18,90,97,91.40745391845704,17085.441705322264,4,11,0,46,32658,0
100109,Clothing,94.78804016113281,2022-11-19,98,122,92.3219271850586,20308.857728271483,5,11,1,46,32756,0
100109,Clothing,94.78804016113281,2022-11-20,54,0,92.40385437011719,4989.808135986328,6,11,1,46,32810,0
100109,Clothing,94.78804016113281,2022-11-21,150,154,94.8416064453125,28835.041933593748,0,11,0,47,32960,0
100109,Clothing,94.78804016113281,2022-11-22,122,113,96.83755813598633,22746.634185180665,1,11,0,47,33082,0
100109,Clothing,94.78804016113281,2022-11-23,39,0,95.70511627197266,3732.4995346069336,2,11,0,47,33121,0
100109,Clothing,94.78804016113281,2022-11-24,54,78,89.28674575805664,11723.528541870117,3,11,0,47,33175,0
100109,Clothing,94.78804016113281,2022-11-25,105,123,89.636787109375,20423.20529296875,4,11,0,47,33280,0
100109,Clothing,94.78804016113281,2022-11-26,141,164,102.13539947509766,31235.12265197754,5,11,1,47,33421,0
100109,Clothing,94.78804016113281,2022-11-27,122,138,96.19735733032226,24997.275188598633,6,11,1,47,33543,0
100109,Clothing,94.78804016113281,2022-11-28,125,98,92.30084548950195,20646.021372375486,0,11,0,48,33668,0
100109,Clothing,94.78804016113281,2022-11-29,48,0,94.6316909790039,4542.3211669921875,1,11,0,48,33716,0
100109,Clothing,94.78804016113281,2022-11-30,90,122,94.30331192016601,19988.996145629884,2,11,0,48,33806,0
100109,Clothing,94.78804016113281,2022-12-01,120,114,96.05998764038085,22474.19703369141,3,12,0,48,33926,0
100109,Clothing,94.78804016113281,2022-12-02,128,105,86.78443878173829,20299.536328125,4,12,0,48,34054,0
100109,Clothing,94.78804016113281,2022-12-03,115,154,96.54689956665038,26038.31690032959,5,12,1,48,34169,0
100109,Clothing,94.78804016113281,2022-12-04,126,149,97.17792724609376,26742.377666015625,6,12,1,48,34295,0
100109,Clothing,94.78804016113281,2022-12-05,177,150,92.06108139038085,30147.202812194824,0,12,0,49,34472,0
100109,Clothing,94.78804016113281,2022-12-06,131,212,106.43274093627929,36776.748125305174,1,12,0,49,34603,0
100109,Clothing,94.78804016113281,2022-12-07,152,165,105.52826370239258,33465.48216552734,2,12,0,49,34755,0
100109,Clothing,94.78804016113281,2022-12-08,184,129,98.77537750244142,31070.438920898436,3,12,0,49,34939,0
100109,Clothing,94.78804016113281,2022-12-09,119,139,101.89768661499023,26292.249414367674,4,12,0,49,35058,0
100109,Clothing,94.78804016113281,2022-12-10,109,0,101.76537322998047,11092.425682067871,5,12,1,49,35167,0
100109,Clothing,94.78804016113281,2022-12-11,100,128,110.56749298095704,25278.61859619141,6,12,1,49,35267,0
100109,Clothing,94.78804016113281,2022-12-12,98,167,90.15138610839844,23547.091677246095,0,12,0,50,35365,0
100109,Clothing,94.78804016113281,2022-12-13,54,0,95.12277221679688,5136.629699707031,1,12,0,50,35419,0
100109,Clothing,94.78804016113281,2022-12-14,109,134,89.63824295043946,21734.3869631958,2,12,0,50,35528,0
100109,Clothing,94.78804016113281,2022-12-15,83,131,90.77242599487305,19410.782715148925,3,12,0,50,35611,0
100109,Clothing,94.78804016113281,2022-12-16,180,233,90.78256866455078,37488.294719238285,4,12,0,50,35791,0
100109,Clothing,94.78804016113281,2022-12-17,164,144,98.59280029296875,30292.038496093748,5,12,1,50,35955,0
100109,Clothing,94.78804016113281,2022-12-18,131,0,94.8656005859375,12427.393676757812,6,12,1,50,36086,0
100109,Clothing,94.78804016113281,2022-12-19,118,196,112.52426879882813,35651.307436523435,0,12,0,51,36204,0
100109,Clothing,94.78804016113281,2022-12-20,98,0,108.43853759765625,10626.976684570312,1,12,0,51,36302,0
100109,Clothing,94.78804016113281,2022-12-21,53,50,88.4856640625,9143.650390625,2,12,0,51,36355,0
100109,Clothing,94.78804016113281,2022-12-22,95,178,93.04074188232423,25307.100957641604,3,12,0,51,36450,0
100109,Clothing,94.78804016113281,2022-12-23,145,130,86.60919525146485,23863.566622924805,4,12,0,51,36595,0
100109,Clothing,94.78804016113281,2022-12-24,163,227,112.35045806884766,44200.009330444336,5,12,1,51,36758,0
100109,Clothing,94.78804016113281,2022-12-25,18,0,106.36091613769531,1914.4964904785156,6,12,1,51,36776,0
100109,Clothing,94.78804016113281,2022-12-26,101,157,102.31630096435546,26307.092794799806,0,12,0,52,36877,0
100109,Clothing,94.78804016113281,2022-12-27,199,0,103.93260192871094,20682.587783813477,1,12,0,52,37076,0
100109,Clothing,94.78804016113281,2022-12-28,66,151,101.75970321655274,22048.730824584964,2,12,0,52,37142,0
100109,Clothing,94.78804016113281,2022-12-29,79,138,90.43320037841798,19379.55565979004,3,12,0,52,37221,0
100109,Clothing,94.78804016113281,2022-12-30,129,192,100.13488082885742,32267.099253845212,4,12,0,52,37350,0
100109,Clothing,94.78804016113281,2022-12-31,81,0,98.16976165771484,7951.750694274902,5,12,1,52,37431,0
100109,Clothing,94.78804016113281,2023-01-01,115,162,101.87230682373047,28283.380569458008,6,1,1,52,37546,0
100109,Clothing,94.78804016113281,2023-01-02,195,206,98.23834045410156,39384.46277709961,0,1,0,1,37741,0
100109,Clothing,94.78804016113281,2023-01-03,166,191,104.24257614135743,37265.78527893066,1,1,0,1,37907,0
100109,Clothing,94.78804016113281,2023-01-04,95,0,102.19515228271484,9708.53946685791,2,1,0,1,38002,0
100109,Clothing,94.78804016113281,2023-01-05,131,172,117.58381896972656,35844.63057006836,3,1,0,1,38133,0
100109,Clothing,94.78804016113281,2023-01-06,54,0,112.29763793945312,6064.072448730469,4,1,0,1,38187,0
100109,Clothing,94.78804016113281,2023-01-07,98,95,101.30310256958008,19566.928103637692,5,1,1,1,38285,0
100109,Clothing,94.78804016113281,2023-01-08,58,91,89.7797216796875,13116.48771484375,6,1,1,1,38343,0
100109,Clothing,94.78804016113281,2023-01-09,123,135,96.32244110107422,24844.320510864258,0,1,0,2,38466,0
100109,Clothing,94.78804016113281,2023-01-10,128,198,107.36355041503907,35253.66890625,1,1,0,2,38594,0
100109,Clothing,94.78804016113281,2023-01-11,144,238,107.05690826416016,41010.709580078124,2,1,0,2,38738,0
100109,Clothing,94.78804016113281,2023-01-12,41,0,105.83381652832031,4339.186477661133,3,1,0,2,38779,0
100109,Clothing,94.78804016113281,2023-01-13,299,246,122.26120132446289,66281.5583920288,4,1,0,2,39078,0
100109,Clothing,94.78804016113281,2023-01-14,89,0,115.64240264892578,10292.173835754395,5,1,1,2,39167,0
100109,Clothing,94.78804016113281,2023-01-15,73,0,115.64240264892578,8441.895393371582,6,1,1,2,39240,0
100109,Clothing,94.78804016113281,2023-01-16,113,117,89.81060180664062,20621.996008300783,0,1,0,3,39353,0
100109,Clothing,94.78804016113281,2023-01-17,121,176,98.99358016967773,29409.14640106201,1,1,0,3,39474,0
100109,Clothing,94.78804016113281,2023-01-18,158,145,109.68626083374023,33181.71842346191,2,1,0,3,39632,0
100109,Clothing,94.78804016113281,2023-01-19,147,126,102.0294660949707,27883.433031921384,3,1,0,3,39779,0
100109,Clothing,94.78804016113281,2023-01-20,142,178,114.93045089721679,36895.80805480957,4,1,0,3,39921,0
100109,Clothing,94.78804016113281,2023-01-21,144,165,98.5133267211914,30343.948095703126,5,1,1,3,40065,0
100109,Clothing,94.78804016113281,2023-01-22,137,180,116.93925445556641,37281.3357208252,6,1,1,3,40202,0
100109,Clothing,94.78804016113281,2023-01-23,221,220,95.23532165527344,42004.73217163086,0,1,0,4,40423,0
100109,Clothing,94.78804016113281,2023-01-24,131,162,104.11333053588868,30543.85260040283,1,1,0,4,40554,0
100109,Clothing,94.78804016113281,2023-01-25,215,212,91.68129470825195,39161.02672454834,2,1,0,4,40769,0
100109,Clothing,94.78804016113281,2023-01-26,191,204,109.9843423461914,43515.77877624512,3,1,0,4,40960,0
100109,Clothing,94.78804016113281,2023-01-27,103,0,104.44868469238281,10758.21452331543,4,1,0,4,41063,0
100109,Clothing,94.78804016113281,2023-01-28,48,0,104.44868469238281,5013.536865234375,5,1,1,4,41111,0
100109,Clothing,94.78804016113281,2023-01-29,36,50,85.08253555297851,7163.342559814453,6,1,1,4,41147,0
100109,Clothing,94.78804016113281,2023-01-30,124,160,99.2247280883789,28215.292565917967,0,1,0,5,41271,0
100109,Clothing,94.78804016113281,2023-01-31,57,0,98.23945617675781,5599.649002075195,1,1,0,5,41328,0
100109,Clothing,94.78804016113281,2023-02-01,124,174,113.69867980957031,34085.27259277344,2,2,0,5,41452,0
100109,Clothing,94.78804016113281,2023-02-02,105,130,105.16361862182617,24668.609910583495,3,2,0,5,41557,0
100109,Clothing,94.78804016113281,2023-02-03,66,0,106.95723724365234,7059.177658081055,4,2,0,5,41623,0
100109,Clothing,94.78804016113281,2023-02-04,133,135,98.93690826416017,26509.797598266603,5,2,1,5,41756,0
100109,Clothing,94.78804016113281,2023-02-05,135,151,92.62698715209962,26447.046531066895,6,2,1,5,41891,0
100109,Clothing,94.78804016113281,2023-02-06,151,295,116.69857742309571,52672.730381774905,0,2,0,6,42042,0
100109,Clothing,94.78804016113281,2023-02-07,124,0,112.3571548461914,13932.287200927734,1,2,0,6,42166,0
100109,Clothing,94.78804016113281,2023-02-08,158,210,109.49742980957032,40252.027819824216,2,2,0,6,42324,0
100109,Clothing,94.78804016113281,2023-02-09,95,167,111.5924919128418,29273.773463439942,3,2,0,6,42419,0
100109,Clothing,94.78804016113281,2023-02-10,124,0,111.0849838256836,13774.537994384766,4,2,0,6,42543,0
100109,Clothing,94.78804016113281,2023-02-11,103,106,99.69523971557618,20821.04938140869,5,2,1,6,42646,0
100109,Clothing,94.78804016113281,2023-02-12,97,125,103.31953750610352,22920.150276184082,6,2,1,6,42743,0
100109,Clothing,94.78804016113281,2023-02-13,139,211,91.55309143066407,31755.35941772461,0,2,0,7,42882,0
100109,Clothing,94.78804016113281,2023-02-14,98,0,95.55618286132812,9364.505920410156,1,2,0,7,42980,0
100109,Clothing,94.78804016113281,2023-02-15,176,183,108.65613754272461,39037.33041503906,2,2,0,7,43156,0
100109,Clothing,94.78804016113281,2023-02-16,88,92,98.09502944946288,17644.52518310547,3,2,0,7,43244,0
100109,Clothing,94.78804016113281,2023-02-17,126,111,95.0912939453125,22578.80607421875,4,2,0,7,43370,0
100109,Clothing,94.78804016113281,2023-02-18,84,120,95.54446151733399,19455.62953491211,5,2,1,7,43454,0
100109,Clothing,94.78804016113281,2023-02-19,82,108,90.3172395324707,17081.047283325195,6,2,1,7,43536,0
100109,Clothing,94.78804016113281,2023-02-20,164,199,104.63649871826172,38129.121579589846,0,2,0,8,43700,0
100109,Clothing,94.78804016113281,2023-02-21,97,0,100.46299743652344,9744.910751342773,1,2,0,8,43797,0
100109,Clothing,94.78804016113281,2023-02-22,74,132,89.71861099243165,18236.194426879883,2,2,0,8,43871,0
100109,Clothing,94.78804016113281,2023-02-23,100,0,93.95722198486328,9395.722198486328,3,2,0,8,43971,0
100109,Clothing,94.78804016113281,2023-02-24,130,124,95.78976150512696,24326.81799133301,4,2,0,8,44101,0
100109,Clothing,94.78804016113281,2023-02-25,93,91,76.87102554321288,14159.090751037598,5,2,1,8,44194,0
100109,Clothing,94.78804016113281,2023-02-26,122,116,96.84157653808595,23022.32467529297,6,2,1,8,44316,0
100109,Clothing,94.78804016113281,2023-02-27,116,198,98.45402374267579,31024.93350830078,0,2,0,9,44432,0
100109,Clothing,94.78804016113281,2023-02-28,90,128,90.7241618347168,19672.069130249023,1,2,0,9,44522,0
100109,Clothing,94.78804016113281,2023-03-01,72,0,93.5083236694336,6732.599304199219,2,3,0,9,44594,0
100109,Clothing,94.78804016113281,2023-03-02,160,174,96.19077529907227,32139.748095703126,3,3,0,9,44754,0
100109,Clothing,94.78804016113281,2023-03-03,85,115,97.10589736938476,19444.402552795407,4,3,0,9,44839,0
100109,Clothing,94.78804016113281,2023-03-04,121,0,96.33179473876953,11656.147163391113,5,3,1,9,44960,0
100109,Clothing,94.78804016113281,2023-03-05,87,94,86.67504364013672,15666.79759338379,6,3,1,9,45047,0
100109,Clothing,94.78804016113281,2023-03-06,94,122,106.42659393310547,23118.15965942383,0,3,0,10,45141,0
100109,Clothing,94.78804016113281,2023-03-07,84,62,86.79377334594727,12835.43392211914,1,3,0,10,45225,0
100109,Clothing,94.78804016113281,2023-03-08,78,84,95.25618011474609,15433.80409790039,2,3,0,10,45303,0
100109,Clothing,94.78804016113281,2023-03-09,106,204,99.71195266723632,31008.5139654541,3,3,0,10,45409,0
100109,Clothing,94.78804016113281,2023-03-10,117,95,90.38989547729491,19257.47554168701,4,3,0,10,45526,0
100109,Clothing,94.78804016113281,2023-03-11,72,93,93.87694869995117,15481.150612792968,5,3,1,10,45598,0
100109,Clothing,94.78804016113281,2023-03-12,107,118,89.09118530273437,20019.103654785155,6,3,1,10,45705,0
100109,Clothing,94.78804016113281,2023-03-13,115,0,91.49237060546875,10521.622619628906,0,3,0,11,45820,0
100109,Clothing,94.78804016113281,2023-03-14,89,111,84.4056314086914,16833.04239074707,1,3,0,11,45909,0
100109,Clothing,94.78804016113281,2023-03-15,121,149,85.52726684570312,23083.758576660155,2,3,0,11,46030,0
100109,Clothing,94.78804016113281,2023-03-16,99,105,87.72526824951171,17900.663113403323,3,3,0,11,46129,0
100109,Clothing,94.78804016113281,2023-03-17,61,65,80.1649610900879,10086.045252990723,4,3,0,11,46190,0
100109,Clothing,94.78804016113281,2023-03-18,159,245,102.9585383605957,41997.85519866944,5,3,1,11,46349,0
100109,Clothing,94.78804016113281,2023-03-19,199,167,91.92699539184571,33731.26416595459,6,3,1,11,46548,0
100109,Clothing,94.78804016113281,2023-03-20,122,154,106.94054626464845,29676.85328857422,0,3,0,12,46670,0
100109,Clothing,94.78804016113281,2023-03-21,122,163,108.63897003173828,31080.63868774414,1,3,0,12,46792,0
100109,Clothing,94.78804016113281,2023-03-22,5,0,105.74794006347656,528.7397003173828,2,3,0,12,46797,0
100109,Clothing,94.78804016113281,2023-03-23,99,0,105.74794006347656,10469.04606628418,3,3,0,12,46896,0
100109,Clothing,94.78804016113281,2023-03-24,88,0,105.74794006347656,9305.818725585938,4,3,0,12,46984,0
100109,Clothing,94.78804016113281,2023-03-25,94,111,83.50621063232421,17006.297598876954,5,3,1,12,47078,0
100109,Clothing,94.78804016113281,2023-03-26,98,125,94.77073822021484,21172.46469116211,6,3,1,12,47176,0
100109,Clothing,94.78804016113281,2023-03-27,94,99,94.02093734741212,18147.436221313474,0,3,0,13,47270,0
100109,Clothing,94.78804016113281,2023-03-28,47,50,85.77709381103516,8306.316818237305,1,3,0,13,47317,0
100109,Clothing,94.78804016113281,2023-03-29,103,111,95.65184829711913,20485.96074920654,2,3,0,13,47420,0
100109,Clothing,94.78804016113281,2023-03-30,80,85,88.73796829223633,14630.224926757812,3,3,0,13,47500,0
100109,Clothing,94.78804016113281,2023-03-31,122,116,91.21944381713868,21709.804291381835,4,3,0,13,47622,0
100109,Clothing,94.78804016113281,2023-04-01,106,114,88.46698410034179,19454.12062927246,5,4,1,13,47728,0
100109,Clothing,94.78804016113281,2023-04-02,47,0,89.5439682006836,4208.566505432129,6,4,1,13,47775,0
100109,Clothing,94.78804016113281,2023-04-03,104,97,82.41036010742187,16582.96490234375,0,4,0,14,47879,0
100109,Clothing,94.78804016113281,2023-04-04,107,125,80.9031201171875,18747.147705078125,1,4,0,14,47986,0
100109,Clothing,94.78804016113281,2023-04-05,121,127,76.84005920410156,19045.83432739258,2,4,0,14,48107,0
100109,Clothing,94.78804016113281,2023-04-06,102,138,77.87891311645508,18682.698275756837,3,4,0,14,48209,0
100109,Clothing,94.78804016113281,2023-04-07,155,122,89.77807403564452,24712.042951049803,4,4,0,14,48364,0
100109,Clothing,94.78804016113281,2023-04-08,134,196,90.67379348754883,30011.396654663087,5,4,1,14,48498,0
100109,Clothing,94.78804016113281,2023-04-09,102,0,89.23758697509766,9102.233871459961,6,4,1,14,48600,0
100109,Clothing,94.78804016113281,2023-04-10,94,144,91.0451937866211,21690.996431884763,0,4,0,15,48694,0
100109,Clothing,94.78804016113281,2023-04-11,70,85,90.1819125366211,13975.317755126953,1,4,0,15,48764,0
100109,Clothing,94.78804016113281,2023-04-12,64,68,89.22772567749024,11775.58888671875,2,4,0,15,48828,0
100109,Clothing,94.78804016113281,2023-04-13,74,101,92.33723220825195,16189.06036682129,3,4,0,15,48902,0
100109,Clothing,94.78804016113281,2023-04-14,79,0,91.2244644165039,7206.732688903809,4,4,0,15,48981,0
100109,Clothing,94.78804016113281,2023-04-15,111,103,87.36234939575195,18706.361565856932,5,4,1,15,49092,0
100109,Clothing,94.78804016113281,2023-04-16,103,100,76.91956527709961,15626.70044708252,6,4,1,15,49195,0
100109,Clothing,94.78804016113281,2023-04-17,100,176,88.98723388671874,24695.966777343747,0,4,0,16,49295,0
100109,Clothing,94.78804016113281,2023-04-18,87,0,87.2044677734375,7586.7886962890625,1,4,0,16,49382,0
100109,Clothing,94.78804016113281,2023-04-19,44,56,78.97423461914062,7853.692646484375,2,4,0,16,49426,0
100109,Clothing,94.78804016113281,2023-04-20,83,123,97.63825119018554,20288.349697570804,3,4,0,16,49509,0
100109,Clothing,94.78804016113281,2023-04-21,130,113,85.4016470336914,20803.968228759764,4,4,0,16,49639,0
100109,Clothing,94.78804016113281,2023-04-22,65,75,90.3004753112793,12650.561790466309,5,4,1,16,49704,0
100109,Clothing,94.78804016113281,2023-04-23,85,88,92.19420761108398,15953.155293884276,6,4,1,16,49789,0
100109,Clothing,94.78804016113281,2023-04-24,107,119,90.48955764770508,20448.365336608884,0,4,0,17,49896,0
100109,Clothing,94.78804016113281,2023-04-25,95,102,79.33732833862305,15595.942384338377,1,4,0,17,49991,0
100109,Clothing,94.78804016113281,2023-04-26,91,136,97.43028701782227,22334.912237243654,2,4,0,17,50082,0
100109,Clothing,94.78804016113281,2023-04-27,95,0,92.58057403564453,8795.15453338623,3,4,0,17,50177,0
100109,Clothing,94.78804016113281,2023-04-28,85,62,88.71946594238281,13082.689210205077,4,4,0,17,50262,0
100109,Clothing,94.78804016113281,2023-04-29,83,121,93.82944091796875,19173.52719238281,5,4,1,17,50345,0
100109,Clothing,94.78804016113281,2023-04-30,69,111,94.47294235229492,17027.2660446167,6,4,1,17,50414,0
100109,Clothing,94.78804016113281,2023-05-01,54,0,93.94588470458984,5073.077774047852,0,5,0,18,50468,0
100109,Clothing,94.78804016113281,2023-05-02,20,50,73.8635562133789,4856.242248535156,1,5,0,18,50488,0
100109,Clothing,94.78804016113281,2023-05-03,100,83,88.68740554809571,16196.091109619141,2,5,0,18,50588,0
100109,Clothing,94.78804016113281,2023-05-04,122,117,79.30566192626952,18966.731510009766,3,5,0,18,50710,0
100109,Clothing,94.78804016113281,2023-05-05,117,161,99.94508148193358,27997.029066772462,4,5,0,18,50827,0
100109,Clothing,94.78804016113281,2023-05-06,84,101,95.96520416259766,17759.934299316406,5,5,1,18,50911,0
100109,Clothing,94.78804016113281,2023-05-07,121,143,86.18724731445312,22674.07385009766,6,5,1,18,51032,0
100109,Clothing,94.78804016113281,2023-05-08,95,122,80.0771728515625,17258.562841796876,0,5,0,19,51127,0
100109,Clothing,94.78804016113281,2023-05-09,124,0,84.454345703125,10472.3388671875,1,5,0,19,51251,0
100109,Clothing,94.78804016113281,2023-05-10,103,135,96.50291351318359,23074.16018371582,2,5,0,19,51354,0
100109,Clothing,94.78804016113281,2023-05-11,30,0,93.17582702636719,2795.2748107910156,3,5,0,19,51384,0
100109,Clothing,94.78804016113281,2023-05-12,41,50,81.12326583862304,7326.65779876709,4,5,0,19,51425,0
100109,Clothing,94.78804016113281,2023-05-13,114,125,97.4424348449707,23323.69514465332,5,5,1,19,51539,0
100109,Clothing,94.78804016113281,2023-05-14,105,97,86.42287902832031,17482.004595947266,6,5,1,19,51644,0
100109,Clothing,94.78804016113281,2023-05-15,91,80,80.46460266113282,13801.407684326172,0,5,0,20,51735,0
100109,Clothing,94.78804016113281,2023-05-16,87,111,99.12294097900391,19741.471730346682,1,5,0,20,51822,0
100109,Clothing,94.78804016113281,2023-05-17,105,81,87.48541519165039,16345.377190246581,2,5,0,20,51927,0
100109,Clothing,94.78804016113281,2023-05-18,106,146,103.0861280822754,26111.45915344238,3,5,0,20,52033,0
100109,Clothing,94.78804016113281,2023-05-19,100,85,84.8093701171875,15793.224023437499,4,5,0,20,52133,0
100109,Clothing,94.78804016113281,2023-05-20,64,78,88.33151962280274,12521.49451171875,5,5,1,20,52197,0
100109,Clothing,94.78804016113281,2023-05-21,81,81,85.6259523010254,13871.404272766114,6,5,1,20,52278,0
100109,Clothing,94.78804016113281,2023-05-22,64,106,89.08130737304688,15168.54734375,0,5,0,21,52342,0
100109,Clothing,94.78804016113281,2023-05-23,74,122,84.452783203125,16468.6119140625,1,5,0,21,52416,0
100109,Clothing,94.78804016113281,2023-05-24,102,0,86.20556640625,8792.9677734375,2,5,0,21,52518,0
100109,Clothing,94.78804016113281,2023-05-25,102,93,83.39274536132812,16272.140053710937,3,5,0,21,52620,0
100109,Clothing,94.78804016113281,2023-05-26,98,121,86.99641052246093,19071.156462402345,4,5,0,21,52718,0
100109,Clothing,94.78804016113281,2023-05-27,73,72,84.24423385620116,12216.38814300537,5,5,1,21,52791,0
100109,Clothing,94.78804016113281,2023-05-28,126,155,83.38653793334962,23414.6075592041,6,5,1,21,52917,0
100109,Clothing,94.78804016113281,2023-05-29,93,120,92.41158996582031,19779.74573364258,0,5,0,22,53010,0
100109,Clothing,94.78804016113281,2023-05-30,84,0,88.85317993164062,7463.6671142578125,1,5,0,22,53094,0
100109,Clothing,94.78804016113281,2023-05-31,54,75,78.33231887817382,10007.590438842773,2,5,0,22,53148,0
100109,Clothing,94.78804016113281,2023-06-01,108,87,80.41310562133789,15704.350814208985,3,6,0,22,53256,0
100109,Clothing,94.78804016113281,2023-06-02,57,50,81.9639079284668,8768.555503845215,4,6,0,22,53313,0
100109,Clothing,94.78804016113281,2023-06-03,93,170,96.44923034667968,25644.94684448242,5,6,1,22,53406,0
100109,Clothing,94.78804016113281,2023-06-04,154,186,97.66597702026368,33258.40092224121,6,6,1,22,53560,0
100109,Clothing,94.78804016113281,2023-06-05,125,164,104.69582077026368,30392.58519256592,0,6,0,23,53685,0
100109,Clothing,94.78804016113281,2023-06-06,174,236,98.70254257202149,40412.70481506348,1,6,0,23,53859,0
100109,Clothing,94.78804016113281,2023-06-07,52,0,99.59508514404297,5178.944427490234,2,6,0,23,53911,0
100109,Clothing,94.78804016113281,2023-06-08,84,0,99.59508514404297,8365.98715209961,3,6,0,23,53995,0
100109,Clothing,94.78804016113281,2023-06-09,122,122,96.27970962524414,23492.249148559567,4,6,0,23,54117,0
100109,Clothing,94.78804016113281,2023-06-10,170,187,97.40180435180665,34770.713479614256,5,6,1,23,54287,0
100109,Clothing,94.78804016113281,2023-06-11,185,174,101.92583694458008,36573.509669494626,6,6,1,23,54472,0
100109,Clothing,94.78804016113281,2023-06-12,26,0,100.30167388916016,2607.843521118164,0,6,0,24,54498,0
100109,Clothing,94.78804016113281,2023-06-13,108,115,96.64674240112305,21541.53635864258,1,6,0,24,54606,0
100109,Clothing,94.78804016113281,2023-06-14,102,114,95.21300765991211,20550.73356262207,2,6,0,24,54708,0
100109,Clothing,94.78804016113281,2023-06-15,89,113,92.25762145996094,18590.496619873047,3,6,0,24,54797,0
100109,Clothing,94.78804016113281,2023-06-16,64,0,94.15524291992188,6025.935546875,4,6,0,24,54861,0
100109,Clothing,94.78804016113281,2023-06-17,97,95,94.16555496215821,18079.777662658693,5,6,1,24,54958,0
100109,Clothing,94.78804016113281,2023-06-18,98,158,92.4351303100586,23631.285540771485,6,6,1,24,55056,0
100109,Clothing,94.78804016113281,2023-06-19,125,100,90.42763824462891,20378.159561157227,0,6,0,25,55181,0
100109,Clothing,94.78804016113281,2023-06-20,86,96,93.8237971496582,17086.09310974121,1,6,0,25,55267,0
100109,Clothing,94.78804016113281,2023-06-21,69,0,92.8075942993164,6403.724006652832,2,6,0,25,55336,0
100109,Clothing,94.78804016113281,2023-06-22,83,60,82.88139389038085,11965.231385803221,3,6,0,25,55419,0
100109,Clothing,94.78804016113281,2023-06-23,53,79,72.2281736755371,9382.066409606934,4,6,0,25,55472,0
100109,Clothing,94.78804016113281,2023-06-24,43,50,73.55531600952148,6823.317176818848,5,6,1,25,55515,0
100109,Clothing,94.78804016113281,2023-06-25,76,92,73.3710905456543,12308.885762939453,6,6,1,25,55591,0
100109,Clothing,94.78804016113281,2023-06-26,92,123,93.9021597290039,20411.47739013672,0,6,0,26,55683,0
100109,Clothing,94.78804016113281,2023-06-27,74,0,86.72431945800781,6417.599639892578,1,6,0,26,55757,0
100109,Clothing,94.78804016113281,2023-06-28,79,97,83.01870346069336,14588.45514678955,2,6,0,26,55836,0
100109,Clothing,94.78804016113281,2023-06-29,119,134,89.9337777709961,22779.28910949707,3,6,0,26,55955,0
100109,Clothing,94.78804016113281,2023-06-30,74,77,82.39827499389648,12434.044699096681,4,6,0,26,56029,0
100109,Clothing,94.78804016113281,2023-07-01,137,185,96.27845993041993,31146.69802093506,5,7,1,26,56166,0
100109,Clothing,94.78804016113281,2023-07-02,123,158,89.98733200073242,25244.183672180174,6,7,1,26,56289,0
100109,Clothing,94.78804016113281,2023-07-03,215,241,100.12219711303712,45728.46475860596,0,7,0,27,56504,0
100109,Clothing,94.78804016113281,2023-07-04,83,0,97.32439422607422,8077.92472076416,1,7,0,27,56587,0
100109,Clothing,94.78804016113281,2023-07-05,114,97,91.76041732788086,19404.635150756836,2,7,0,27,56701,0
100109,Clothing,94.78804016113281,2023-07-06,146,242,101.02232269287109,39346.19822631836,3,7,0,27,56847,0
100109,Clothing,94.78804016113281,2023-07-07,142,0,99.46464538574219,14123.97964477539,4,7,0,27,56989,0
100109,Clothing,94.78804016113281,2023-07-08,100,200,100.31077407836915,30110.154815673828,5,7,1,27,57089,0
100109,Clothing,94.78804016113281,2023-07-09,95,110,89.93856338500976,18364.527043151855,6,7,1,27,57184,0
100109,Clothing,94.78804016113281,2023-07-10,164,191,116.6279689025879,41615.203800048825,0,7,0,28,57348,0
100109,Clothing,94.78804016113281,2023-07-11,25,0,108.76593780517578,2719.1484451293945,1,7,0,28,57373,0
100109,Clothing,94.78804016113281,2023-07-12,175,185,108.0899104309082,38909.86865081787,2,7,0,28,57548,0
100109,Clothing,94.78804016113281,2023-07-13,102,0,108.3398208618164,11050.661727905273,3,7,0,28,57650,0
100109,Clothing,94.78804016113281,2023-07-14,63,64,88.30073471069336,11204.292573547364,4,7,0,28,57713,0
100109,Clothing,94.78804016113281,2023-07-15,41,61,86.1718342590332,8667.290409240723,5,7,1,28,57754,0
100109,Clothing,94.78804016113281,2023-07-16,91,162,93.12778503417968,23579.946876220703,6,7,1,28,57845,0
100109,Clothing,94.78804016113281,2023-07-17,69,0,92.86557006835938,6407.724334716797,0,7,0,29,57914,0
100109,Clothing,94.78804016113281,2023-07-18,81,74,90.63519073486327,14056.260899047851,1,7,0,29,57995,0
100109,Clothing,94.78804016113281,2023-07-19,64,56,82.87587341308594,9984.671796875,2,7,0,29,58059,0
100109,Clothing,94.78804016113281,2023-07-20,56,61,79.95371704101562,9334.066308593749,3,7,0,29,58115,0
100109,Clothing,94.78804016113281,2023-07-21,112,142,90.83397521972657,23138.31044921875,4,7,0,29,58227,0
100109,Clothing,94.78804016113281,2023-07-22,99,97,88.97452194213867,17438.67534454346,5,7,1,29,58326,0
100109,Clothing,94.78804016113281,2023-07-23,130,116,97.49656158447266,23933.42601196289,6,7,1,29,58456,0
100109,Clothing,94.78804016113281,2023-07-24,97,115,92.28995330810547,19554.130941772462,0,7,0,30,58553,0
100109,Clothing,94.78804016113281,2023-07-25,79,0,92.91990661621094,7340.672622680664,1,7,0,30,58632,0
100109,Clothing,94.78804016113281,2023-07-26,91,158,94.60355590820313,23581.50717529297,2,7,0,30,58723,0
100109,Clothing,94.78804016113281,2023-07-27,132,179,86.53525909423828,26801.768400878907,3,7,0,30,58855,0
100109,Clothing,94.78804016113281,2023-07-28,79,0,88.89051818847656,7022.350936889648,4,7,0,30,58934,0
100109,Clothing,94.78804016113281,2023-07-29,83,137,90.79886932373047,20008.21230773926,5,7,1,30,59017,0
100109,Clothing,94.78804016113281,2023-07-30,69,0,90.19773864746094,6223.643966674805,6,7,1,30,59086,0
100109,Clothing,94.78804016113281,2023-07-31,45,50,79.26915908813476,7501.824317932129,0,7,0,31,59131,0
100109,Clothing,94.78804016113281,2023-08-01,67,95,73.1928562927246,11731.722743225098,1,8,0,31,59198,0
100109,Clothing,94.78804016113281,2023-08-02,144,186,90.70415679931641,30085.077158203127,2,8,0,31,59342,0
100109,Clothing,94.78804016113281,2023-08-03,90,0,87.06831359863281,7836.148223876953,3,8,0,31,59432,0
100109,Clothing,94.78804016113281,2023-08-04,96,159,90.63332794189452,23163.57896484375,4,8,0,31,59528,0
100109,Clothing,94.78804016113281,2023-08-05,99,122,89.35012145996095,19742.234049072264,5,8,1,31,59627,0
100109,Clothing,94.78804016113281,2023-08-06,126,147,86.39049407958984,23559.39450805664,6,8,1,31,59753,0
100109,Clothing,94.78804016113281,2023-08-07,89,134,90.65109954833984,20274.54571960449,0,8,0,32,59842,0
100109,Clothing,94.78804016113281,2023-08-08,123,144,101.13089935302735,27116.591240844726,1,8,0,32,59965,0
100109,Clothing,94.78804016113281,2023-08-09,106,0,95.67179870605469,10141.210662841797,2,8,0,32,60071,0
100109,Clothing,94.78804016113281,2023-08-10,48,0,95.67179870605469,4592.246337890625,3,8,0,32,60119,0
100109,Clothing,94.78804016113281,2023-08-11,82,112,91.75777038574219,17761.17434326172,4,8,0,32,60201,0
100109,Clothing,94.78804016113281,2023-08-12,100,99,94.6841847229004,18841.476944580078,5,8,1,32,60301,0
100109,Clothing,94.78804016113281,2023-08-13,25,0,94.00836944580078,2350.2092361450195,6,8,1,32,60326,0
100109,Clothing,94.78804016113281,2023-08-14,100,125,91.49919387817383,20567.088775634766,0,8,0,33,60426,0
100109,Clothing,94.78804016113281,2023-08-15,89,110,95.27599868774413,18984.577766418457,1,8,0,33,60515,0
100109,Clothing,94.78804016113281,2023-08-16,68,124,90.3063998413086,17253.910378417968,2,8,0,33,60583,0
100109,Clothing,94.78804016113281,2023-08-17,133,144,106.58184539794922,29593.66087585449,3,8,0,33,60716,0
100109,Clothing,94.78804016113281,2023-08-18,189,185,97.74570205688477,36560.63537750245,4,8,0,33,60905,0
100109,Clothing,94.78804016113281,2023-08-19,137,118,87.18104232788086,22338.535597839356,5,8,1,33,61042,0
100109,Clothing,94.78804016113281,2023-08-20,59,0,92.83208465576172,5477.092994689941,6,8,1,33,61101,0
100109,Clothing,94.78804016113281,2023-08-21,60,52,77.37072479248047,8738.566975097656,0,8,0,34,61161,0
100109,Clothing,94.78804016113281,2023-08-22,75,98,91.61268127441406,15898.38219116211,1,8,0,34,61236,0
100109,Clothing,94.78804016113281,2023-08-23,59,113,89.2013949584961,15336.62460510254,2,8,0,34,61295,0
100109,Clothing,94.78804016113281,2023-08-24,196,192,96.26504852294923,37340.739020996094,3,8,0,34,61491,0
100109,Clothing,94.78804016113281,2023-08-25,46,0,93.74009704589844,4312.044464111328,4,8,0,34,61537,0
100109,Clothing,94.78804016113281,2023-08-26,64,70,82.55009826660157,11024.992578125,5,8,1,34,61601,0
100109,Clothing,94.78804016113281,2023-08-27,124,143,84.41522827148438,22508.176611328126,6,8,1,34,61725,0
100109,Clothing,94.78804016113281,2023-08-28,109,0,86.03045654296875,9377.319763183594,0,8,0,35,61834,0
100109,Clothing,94.78804016113281,2023-08-29,85,170,92.0217431640625,23567.396337890626,1,8,0,35,61919,0
100109,Clothing,94.78804016113281,2023-08-30,63,111,87.80083953857422,15214.425781860351,2,8,0,35,61982,0
100109,Clothing,94.78804016113281,2023-08-31,101,142,96.04089584350587,23461.310960388182,3,8,0,35,62083,0
100109,Clothing,94.78804016113281,2023-09-01,181,161,95.84563522338867,32754.119950866698,4,9,0,35,62264,0
100109,Clothing,94.78804016113281,2023-09-02,26,0,94.59127044677734,2459.373031616211,5,9,1,35,62290,0
100109,Clothing,94.78804016113281,2023-09-03,101,0,94.59127044677734,9553.718315124512,6,9,1,35,62391,0
100109,Clothing,94.78804016113281,2023-09-04,71,120,90.36478973388671,17193.780142211916,0,9,0,36,62462,0
100109,Clothing,94.78804016113281,2023-09-05,102,136,84.79937957763673,20094.89343383789,1,9,0,36,62564,0
100109,Clothing,94.78804016113281,2023-09-06,75,0,87.36875915527344,6552.656936645508,2,9,0,36,62639,0
100109,Clothing,94.78804016113281,2023-09-07,91,96,86.97243133544922,16263.082503051757,3,9,0,36,62730,0
100109,Clothing,94.78804016113281,2023-09-08,110,106,82.49668182373047,17826.150001220703,4,9,0,36,62840,0
100109,Clothing,94.78804016113281,2023-09-09,121,134,89.86273818969727,22937.84264190674,5,9,1,36,62961,0
100109,Clothing,94.78804016113281,2023-09-10,73,87,84.46419281005859,13492.092150268554,6,9,1,36,63034,0
100109,Clothing,94.78804016113281,2023-09-11,148,204,103.61420776367189,36734.04549804688,0,9,0,37,63182,0
100109,Clothing,94.78804016113281,2023-09-12,87,0,98.93841552734375,8607.642150878906,1,9,0,37,63269,0
100109,Clothing,94.78804016113281,2023-09-13,65,84,83.15110488891602,12266.37363555908,2,9,0,37,63334,0
100109,Clothing,94.78804016113281,2023-09-14,122,135,94.4845768737793,24303.666757202147,3,9,0,37,63456,0
100109,Clothing,94.78804016113281,2023-09-15,54,80,80.76959487915039,10671.556246948243,4,9,0,37,63510,0
100109,Clothing,94.78804016113281,2023-09-16,104,136,92.53581588745118,22282.969704589843,5,9,1,37,63614,0
100109,Clothing,94.78804016113281,2023-09-17,81,0,90.21163177490234,7307.14217376709,6,9,1,37,63695,0
100109,Clothing,94.78804016113281,2023-09-18,126,177,93.29152755737304,28308.56494445801,0,9,0,38,63821,0
100109,Clothing,94.78804016113281,2023-09-19,85,128,86.21303482055664,18253.16591949463,1,9,0,38,63906,0
100109,Clothing,94.78804016113281,2023-09-20,89,0,88.77606964111328,7901.070198059082,2,9,0,38,63995,0
100109,Clothing,94.78804016113281,2023-09-21,79,81,90.20923309326172,14434.75882873535,3,9,0,38,64074,0
100109,Clothing,94.78804016113281,2023-09-22,81,88,87.12270751953125,14716.368618164062,4,9,0,38,64155,0
100109,Clothing,94.78804016113281,2023-09-23,86,84,79.08294067382812,13452.365795898437,5,9,1,38,64241,0
100109,Clothing,94.78804016113281,2023-09-24,138,113,92.92795150756837,23232.864616088867,6,9,1,38,64379,0
100109,Clothing,94.78804016113281,2023-09-25,113,167,103.97622833251953,29314.427603149416,0,9,0,39,64492,0
100109,Clothing,94.78804016113281,2023-09-26,137,123,97.82255355834961,25447.619674987793,1,9,0,39,64629,0
100109,Clothing,94.78804016113281,2023-09-27,62,72,85.4961360168457,11387.920866088867,2,9,0,39,64691,0
100109,Clothing,94.78804016113281,2023-09-28,148,139,102.229306640625,29306.954765625,3,9,0,39,64839,0
100109,Clothing,94.78804016113281,2023-09-29,91,92,91.36615280151366,16716.71980987549,4,9,0,39,64930,0
100109,Clothing,94.78804016113281,2023-09-30,85,81,88.61969848632813,14722.668742675782,5,9,1,39,65015,0
100109,Clothing,94.78804016113281,2023-10-01,96,100,89.22049758911132,17483.175537109375,6,10,1,39,65111,0
100109,Clothing,94.78804016113281,2023-10-02,108,184,91.51844329833985,26752.38375244141,0,10,0,40,65219,0
100109,Clothing,94.78804016113281,2023-10-03,71,0,91.13688659667969,6470.718948364258,1,10,0,40,65290,0
100109,Clothing,94.78804016113281,2023-10-04,110,91,89.08155685424805,17923.66250793457,2,10,0,40,65400,0
100109,Clothing,94.78804016113281,2023-10-05,109,92,86.21905258178711,17358.23346282959,3,10,0,40,65509,0
100109,Clothing,94.78804016113281,2023-10-06,77,131,89.11322296142578,18556.97633605957,4,10,0,40,65586,0
100109,Clothing,94.78804016113281,2023-10-07,150,148,98.19903076171875,29256.18922851563,5,10,1,40,65736,0
100109,Clothing,94.78804016113281,2023-10-08,133,135,83.33170181274414,22323.972682189942,6,10,1,40,65869,0
100109,Clothing,94.78804016113281,2023-10-09,81,106,83.34863677978515,15535.479158325195,0,10,0,41,65950,0
100109,Clothing,94.78804016113281,2023-10-10,42,0,85.37727355957031,3585.845489501953,1,10,0,41,65992,0
100109,Clothing,94.78804016113281,2023-10-11,129,137,93.32020462036132,24846.692792053225,2,10,0,41,66121,0
100109,Clothing,94.78804016113281,2023-10-12,84,109,92.28032272338868,17830.844217529295,3,10,0,41,66205,0
100109,Clothing,94.78804016113281,2023-10-13,82,0,91.45064544677734,7498.952926635742,4,10,0,41,66287,0
100109,Clothing,94.78804016113281,2023-10-14,112,136,92.41014358520508,22924.432163085938,5,10,1,41,66399,0
100109,Clothing,94.78804016113281,2023-10-15,90,102,93.0300830078125,17866.09494140625,6,10,1,41,66489,0
100109,Clothing,94.78804016113281,2023-10-16,102,98,86.06273208618164,17223.917345581052,0,10,0,42,66591,0
100109,Clothing,94.78804016113281,2023-10-17,142,141,108.43759109497071,30681.23587097168,1,10,0,42,66733,0
100109,Clothing,94.78804016113281,2023-10-18,83,122,78.44345321655274,15743.813233947754,2,10,0,42,66816,0
100109,Clothing,94.78804016113281,2023-10-19,51,0,87.08690643310547,4441.432228088379,3,10,0,42,66867,0
100109,Clothing,94.78804016113281,2023-10-20,131,153,92.46715835571288,26296.155489196775,4,10,0,42,66998,0
100109,Clothing,94.78804016113281,2023-10-21,153,137,93.00086380004882,26957.94432281494,5,10,1,42,67151,0
100109,Clothing,94.78804016113281,2023-10-22,93,101,88.58410995483399,17173.52445159912,6,10,1,42,67244,0
100109,Clothing,94.78804016113281,2023-10-23,138,177,103.32493957519532,32697.703322753907,0,10,0,43,67382,0
100109,Clothing,94.78804016113281,2023-10-24,84,141,97.68482803344727,21938.91110961914,1,10,0,43,67466,0
100109,Clothing,94.78804016113281,2023-10-25,141,0,98.38965606689453,13872.941505432129,2,10,0,43,67607,0
100109,Clothing,94.78804016113281,2023-10-26,100,168,103.67725021362304,27867.97004272461,3,10,0,43,67707,0
100109,Clothing,94.78804016113281,2023-10-27,167,142,91.75902618408203,28453.0147454834,4,10,0,43,67874,0
100109,Clothing,94.78804016113281,2023-10-28,143,223,122.87224243164063,45498.26133544922,5,10,1,43,68017,0
100109,Clothing,94.78804016113281,2023-10-29,143,0,116.28448486328125,16628.68133544922,6,10,1,43,68160,0
100109,Clothing,94.78804016113281,2023-10-30,76,106,93.2820379638672,16788.269770507814,0,10,0,44,68236,0
100109,Clothing,94.78804016113281,2023-10-31,86,140,90.49389633178711,20313.170169067384,1,10,0,44,68322,0
100109,Clothing,94.78804016113281,2023-11-01,62,68,89.36094467163086,11604.797139282226,2,11,0,44,68384,0
100109,Clothing,94.78804016113281,2023-11-02,165,168,92.03917205810546,30649.706779174805,3,11,0,44,68549,0
100109,Clothing,94.78804016113281,2023-11-03,150,115,85.4526628112793,22740.59884338379,4,11,0,44,68699,0
100109,Clothing,94.78804016113281,2023-11-04,65,90,76.19384872436524,11679.950334167479,5,11,1,44,68764,0
100109,Clothing,94.78804016113281,2023-11-05,46,0,81.39769744873047,3744.2940826416016,6,11,1,44,68810,0
100109,Clothing,94.78804016113281,2023-11-06,117,172,108.88406723022462,31851.171731872557,0,11,0,45,68927,0
100109,Clothing,94.78804016113281,2023-11-07,63,116,88.3586100769043,15510.454869689942,1,11,0,45,68990,0
100109,Clothing,94.78804016113281,2023-11-08,83,0,94.1272201538086,7812.559272766113,2,11,0,45,69073,0
100109,Clothing,94.78804016113281,2023-11-09,63,93,90.61886291503906,14090.976727294921,3,11,0,45,69136,0
100109,Clothing,94.78804016113281,2023-11-10,95,94,88.525732421875,16733.08916015625,4,11,0,45,69231,0
100109,Clothing,94.78804016113281,2023-11-11,159,166,106.81802520751953,34755.28201599121,5,11,1,45,69390,0
100109,Clothing,94.78804016113281,2023-11-12,175,168,104.33092208862305,35777.882731018064,6,11,1,45,69565,0
100109,Clothing,94.78804016113281,2023-11-13,166,138,84.02240463256837,25748.678338012694,0,11,0,46,69731,0
100109,Clothing,94.78804016113281,2023-11-14,143,204,110.2272592163086,38547.316135864254,1,11,0,46,69874,0
100109,Clothing,94.78804016113281,2023-11-15,34,0,105.33451843261719,3581.3736267089844,2,11,0,46,69908,0
100109,Clothing,94.78804016113281,2023-11-16,37,0,105.33451843261719,3897.377182006836,3,11,0,46,69945,0
100109,Clothing,94.78804016113281,2023-11-17,86,74,88.71579818725586,14288.917288208007,4,11,0,46,70031,0
100109,Clothing,94.78804016113281,2023-11-18,121,112,92.33824615478515,21528.205569458005,5,11,1,46,70152,0
100109,Clothing,94.78804016113281,2023-11-19,53,50,78.39335357666016,8098.975479125977,6,11,1,46,70205,0
100109,Clothing,94.78804016113281,2023-11-20,109,129,92.02340621948242,21934.102555847167,0,11,0,47,70314,0
100109,Clothing,94.78804016113281,2023-11-21,102,90,78.6246075439453,15154.899938964843,1,11,0,47,70416,0
100109,Clothing,94.78804016113281,2023-11-22,117,160,99.05569885253905,27617.06353149414,2,11,0,47,70533,0
100109,Clothing,94.78804016113281,2023-11-23,102,126,97.16207077026368,22174.02243713379,3,11,0,47,70635,0
100109,Clothing,94.78804016113281,2023-11-24,79,142,102.50442276000976,22807.548796081544,4,11,0,47,70714,0
100109,Clothing,94.78804016113281,2023-11-25,127,147,101.73481750488281,27890.643646240234,5,11,1,47,70841,0
100109,Clothing,94.78804016113281,2023-11-26,129,0,100.96963500976562,13025.082916259766,6,11,1,47,70970,0
100109,Clothing,94.78804016113281,2023-11-27,138,223,124.73436431884765,45506.434552001956,0,11,0,48,71108,0
100109,Clothing,94.78804016113281,2023-11-28,140,157,107.80729644775391,31938.913005371094,1,11,0,48,71248,0
100109,Clothing,94.78804016113281,2023-11-29,30,0,112.50459289550781,3375.1377868652344,2,11,0,48,71278,0
100109,Clothing,94.78804016113281,2023-11-30,151,168,104.36183380126954,33238.1838079834,3,11,0,48,71429,0
100109,Clothing,94.78804016113281,2023-12-01,163,122,99.45450119018554,28503.38738800049,4,12,0,48,71592,0
100109,Clothing,94.78804016113281,2023-12-02,137,225,112.83108871459962,41089.39830780029,5,12,1,48,71729,0
100109,Clothing,94.78804016113281,2023-12-03,142,0,110.05217742919922,15627.409194946289,6,12,1,48,71871,0
100109,Clothing,94.78804016113281,2023-12-04,120,214,91.93943496704102,30306.444392089845,0,12,0,49,71991,0
100109,Clothing,94.78804016113281,2023-12-05,212,214,109.88425415039063,46820.143759765626,1,12,0,49,72203,0
100109,Clothing,94.78804016113281,2023-12-06,43,0,105.15850830078125,4521.815856933594,2,12,0,49,72246,0
100109,Clothing,94.78804016113281,2023-12-07,183,196,114.00394241333008,43244.36292327881,3,12,0,49,72429,0
100109,Clothing,94.78804016113281,2023-12-08,198,383,157.76850311279298,93434.22723266602,4,12,0,49,72627,0
100109,Clothing,94.78804016113281,2023-12-09,98,0,148.19700622558594,14523.306610107422,5,12,1,49,72725,0
100109,Clothing,94.78804016113281,2023-12-10,196,236,127.44343322753906,54743.02582519531,6,12,1,49,72921,0
100109,Clothing,94.78804016113281,2023-12-11,69,0,135.25686645507812,9332.72378540039,0,12,0,50,72990,0
100109,Clothing,94.78804016113281,2023-12-12,182,293,120.8808544921875,56933.24103515625,1,12,0,50,73172,0
100109,Clothing,94.78804016113281,2023-12-13,234,273,117.27600494384765,59333.900313720704,2,12,0,50,73406,0
100109,Clothing,94.78804016113281,2023-12-14,90,0,120.48200988769531,10843.380889892578,3,12,0,50,73496,0
100109,Clothing,94.78804016113281,2023-12-15,193,0,120.48200988769531,23253.027908325195,4,12,0,50,73689,0
100109,Clothing,94.78804016113281,2023-12-16,110,202,105.67573486328125,32652.901669921874,5,12,1,50,73799,0
100109,Clothing,94.78804016113281,2023-12-17,76,0,109.1314697265625,8293.99169921875,6,12,1,50,73875,0
100109,Clothing,94.78804016113281,2023-12-18,139,121,96.02252685546875,25051.942465820313,0,12,0,51,74014,0
100109,Clothing,94.78804016113281,2023-12-19,121,218,115.25168258666992,39374.737185974125,1,12,0,51,74135,0
100109,Clothing,94.78804016113281,2023-12-20,207,171,112.55721496582032,42540.40699584961,2,12,0,51,74342,0
100109,Clothing,94.78804016113281,2023-12-21,126,157,96.44773941040039,27113.430331420896,3,12,0,51,74468,0
100109,Clothing,94.78804016113281,2023-12-22,162,150,103.18900421142578,32190.517364501953,4,12,0,51,74630,0
100109,Clothing,94.78804016113281,2023-12-23,100,0,102.81800842285156,10281.800842285156,5,12,1,51,74730,0
100109,Clothing,94.78804016113281,2023-12-24,101,120,89.04839263916016,19602.205313110353,6,12,1,51,74831,0
100109,Clothing,94.78804016113281,2023-12-25,69,90,88.16479476928711,13976.521678161622,0,12,0,52,74900,0
100109,Clothing,94.78804016113281,2023-12-26,141,177,88.3208984375,28067.293359375,1,12,0,52,75041,0
100109,Clothing,94.78804016113281,2023-12-27,91,102,86.73073196411133,16728.24321746826,2,12,0,52,75132,0
100109,Clothing,94.78804016113281,2023-12-28,87,0,87.71146392822266,7630.897361755371,3,12,0,52,75219,0
100109,Clothing,94.78804016113281,2023-12-29,93,152,94.48163696289063,23247.614475097656,4,12,0,52,75312,0
100109,Clothing,94.78804016113281,2023-12-30,106,96,92.23414825439454,18633.839429931642,5,12,1,52,75418,0
100109,Clothing,94.78804016113281,2023-12-31,137,162,101.37708923339844,30382.07244995117,6,12,1,52,75555,0
100109,Clothing,94.78804016113281,2024-01-01,63,0,98.56417846679688,6209.543243408203,0,1,0,1,75618,0
100109,Clothing,94.78804016113281,2024-01-02,112,237,109.64261901855468,38529.94666015625,1,1,0,1,75730,0
100109,Clothing,94.78804016113281,2024-01-03,84,0,107.52523803710938,9032.119995117188,2,1,0,1,75814,0
100109,Clothing,94.78804016113281,2024-01-04,142,119,105.11365982055665,27456.369389038086,3,1,0,1,75956,0
100109,Clothing,94.78804016113281,2024-01-05,39,50,86.64958938598633,7591.147972106934,4,1,0,1,75995,0
100109,Clothing,94.78804016113281,2024-01-06,107,132,88.40715179443359,21049.13048400879,5,1,1,1,76102,0
100109,Clothing,94.78804016113281,2024-01-07,128,175,98.79873245239258,30044.6455078125,6,1,1,1,76230,0
100109,Clothing,94.78804016113281,2024-01-08,89,163,100.51028137207031,25446.230084228515,0,1,0,2,76319,0
100109,Clothing,94.78804016113281,2024-01-09,155,0,98.92056274414062,15332.687225341797,1,1,0,2,76474,0
100109,Clothing,94.78804016113281,2024-01-10,102,101,90.30496520996094,18335.312902832033,2,1,0,2,76576,0
100109,Clothing,94.78804016113281,2024-01-11,131,210,105.23897766113282,36103.0321472168,3,1,0,2,76707,0
100109,Clothing,94.78804016113281,2024-01-12,112,0,102.49795532226562,11479.77099609375,4,1,0,2,76819,0
100109,Clothing,94.78804016113281,2024-01-13,98,145,103.6332521057129,25196.357412719728,5,1,1,2,76917,0
100109,Clothing,94.78804016113281,2024-01-14,110,90,88.08083511352538,17752.383724975585,6,1,1,2,77027,0
100109,Clothing,94.78804016113281,2024-01-15,90,88,88.03673431396484,15676.232176513671,0,1,0,3,77117,0
100109,Clothing,94.78804016113281,2024-01-16,123,278,110.92881134033203,45045.28758972168,1,1,0,3,77240,0
100109,Clothing,94.78804016113281,2024-01-17,204,0,107.29762268066406,21888.71502685547,2,1,0,3,77444,0
100109,Clothing,94.78804016113281,2024-01-18,74,138,99.47411361694336,20982.648815307617,3,1,0,3,77518,0
100109,Clothing,94.78804016113281,2024-01-19,97,108,97.01389511108398,19870.20565155029,4,1,0,3,77615,0
100109,Clothing,94.78804016113281,2024-01-20,113,197,104.88913314819337,32660.184091491697,5,1,1,3,77728,0
100109,Clothing,94.78804016113281,2024-01-21,191,195,92.81288024902344,35810.280255126956,6,1,1,3,77919,0
100109,Clothing,94.78804016113281,2024-01-22,116,209,101.80697830200195,33259.598966064455,0,1,0,4,78035,0
100109,Clothing,94.78804016113281,2024-01-23,83,0,99.9539566040039,8296.178398132324,1,1,0,4,78118,0
100109,Clothing,94.78804016113281,2024-01-24,145,0,99.9539566040039,14493.323707580566,2,1,0,4,78263,0
100109,Clothing,94.78804016113281,2024-01-25,102,202,114.00714294433594,34941.45716064453,3,1,0,4,78365,0
100109,Clothing,94.78804016113281,2024-01-26,108,110,97.89597274780274,21328.610113525392,4,1,0,4,78473,0
100109,Clothing,94.78804016113281,2024-01-27,142,198,97.04154006958008,32856.83737976074,5,1,1,4,78615,0
100109,Clothing,94.78804016113281,2024-01-28,167,0,99.49308013916016,16615.344383239746,6,1,1,4,78782,0
100109,Clothing,94.78804016113281,2024-01-29,93,128,96.38754776000977,21272.683883361817,0,1,0,5,78875,0
100109,Clothing,94.78804016113281,2024-01-30,90,70,92.5690200805664,14855.423614501953,1,1,0,5,78965,0
100110,Furniture,119.89337921142578,2022-01-01,70,492,113.34999923706054,63702.699893188474,5,1,1,52,70,2
100110,Furniture,119.89337921142578,2022-01-02,105,498,125.43382705688477,77049.8936819458,6,1,1,52,175,2
100110,Furniture,119.89337921142578,2022-01-03,17,0,121.83765411376953,2071.240119934082,0,1,0,1,192,2
100110,Furniture,119.89337921142578,2022-01-05,86,0,121.83765411376953,10478.03825378418,2,1,0,1,278,2
100110,Furniture,119.89337921142578,2022-01-06,37,0,121.83765411376953,4507.993202209473,3,1,0,1,315,2
100110,Furniture,119.89337921142578,2022-01-07,36,0,121.83765411376953,4386.155548095703,4,1,0,1,351,2
100110,Furniture,119.89337921142578,2022-01-08,74,0,121.83765411376953,9015.986404418945,5,1,1,1,425,2
100110,Furniture,119.89337921142578,2022-01-09,101,0,121.83765411376953,12305.603065490723,6,1,1,1,526,2
100110,Furniture,119.89337921142578,2022-01-10,60,0,121.83765411376953,7310.259246826172,0,1,0,2,586,2
100110,Furniture,119.89337921142578,2022-01-11,82,500,139.23416625976563,83126.72326660156,1,1,0,2,668,2
100110,Furniture,119.89337921142578,2022-01-12,67,0,134.22833251953125,8993.298278808594,2,1,0,2,735,2
100110,Furniture,119.89337921142578,2022-01-13,41,0,134.22833251953125,5503.361633300781,3,1,0,2,776,2
100110,Furniture,119.89337921142578,2022-01-14,50,0,134.22833251953125,6711.4166259765625,4,1,0,2,826,2
100110,Furniture,119.89337921142578,2022-01-15,59,0,134.22833251953125,7919.471618652344,5,1,1,2,885,2
100110,Furniture,119.89337921142578,2022-01-16,35,0,134.22833251953125,4697.991638183594,6,1,1,2,920,2
100110,Furniture,119.89337921142578,2022-01-17,65,0,134.22833251953125,8724.841613769531,0,1,0,3,985,2
100110,Furniture,119.89337921142578,2022-01-18,138,444,133.39287750244142,77541.97419067382,1,1,0,3,1123,2
100110,Furniture,119.89337921142578,2022-01-19,38,0,133.6957550048828,5080.438690185547,2,1,0,3,1161,2
100110,Furniture,119.89337921142578,2022-01-20,61,0,133.6957550048828,8155.441055297852,3,1,0,3,1222,2
100110,Furniture,119.89337921142578,2022-01-21,57,0,133.6957550048828,7620.65803527832,4,1,0,3,1279,2
100110,Furniture,119.89337921142578,2022-01-22,57,0,133.6957550048828,7620.65803527832,5,1,1,3,1336,2
100110,Furniture,119.89337921142578,2022-01-23,60,0,133.6957550048828,8021.745300292969,6,1,1,3,1396,2
100110,Furniture,119.89337921142578,2022-01-24,47,0,133.6957550048828,6283.700485229492,0,1,0,4,1443,2
100110,Furniture,119.89337921142578,2022-01-25,49,0,133.6957550048828,6551.091995239258,1,1,0,4,1492,2
100110,Furniture,119.89337921142578,2022-01-26,35,0,133.6957550048828,4679.351425170898,2,1,0,4,1527,2
100110,Furniture,119.89337921142578,2022-01-27,55,350,134.87605407714844,54752.81594848633,3,1,0,4,1582,2
100110,Furniture,119.89337921142578,2022-01-28,53,0,134.44210815429688,7125.431732177734,4,1,0,4,1635,2
100110,Furniture,119.89337921142578,2022-01-29,120,0,134.44210815429688,16133.052978515625,5,1,1,4,1755,2
100110,Furniture,119.89337921142578,2022-01-30,47,0,134.44210815429688,6318.779083251953,6,1,1,4,1802,2
100110,Furniture,119.89337921142578,2022-01-31,33,0,134.44210815429688,4436.589569091797,0,1,0,5,1835,2
100110,Furniture,119.89337921142578,2022-02-01,81,0,134.44210815429688,10889.810760498047,1,2,0,5,1916,2
100110,Furniture,119.89337921142578,2022-02-02,93,502,123.99274322509766,72629.36023986817,2,2,0,5,2009,2
100110,Furniture,119.89337921142578,2022-02-03,126,0,126.79548645019531,15976.23129272461,3,2,0,5,2135,2
100110,Furniture,119.89337921142578,2022-02-04,114,0,126.79548645019531,14454.685455322266,4,2,0,5,2249,2
100110,Furniture,119.89337921142578,2022-02-05,35,0,126.79548645019531,4437.842025756836,5,2,1,5,2284,2
100110,Furniture,119.89337921142578,2022-02-06,59,0,126.79548645019531,7480.933700561523,6,2,1,5,2343,2
100110,Furniture,119.89337921142578,2022-02-07,78,0,126.79548645019531,9890.047943115234,0,2,0,6,2421,2
100110,Furniture,119.89337921142578,2022-02-08,55,0,126.79548645019531,6973.751754760742,1,2,0,6,2476,2
100110,Furniture,119.89337921142578,2022-02-09,89,298,127.88664520263671,49570.16284606933,2,2,0,6,2565,2
100110,Furniture,119.89337921142578,2022-02-10,112,648,132.790869140625,101729.95468750001,3,2,0,6,2677,2
100110,Furniture,119.89337921142578,2022-02-11,95,0,131.28173828125,12471.76513671875,4,2,0,6,2772,2
100110,Furniture,119.89337921142578,2022-02-12,14,0,131.28173828125,1837.9443359375,5,2,1,6,2786,2
100110,Furniture,119.89337921142578,2022-02-13,117,0,131.28173828125,15359.96337890625,6,2,1,6,2903,2
100110,Furniture,119.89337921142578,2022-02-14,108,0,131.28173828125,14178.427734375,0,2,0,7,3011,2
100110,Furniture,119.89337921142578,2022-02-15,49,0,131.28173828125,6432.80517578125,1,2,0,7,3060,2
100110,Furniture,119.89337921142578,2022-02-16,42,0,131.28173828125,5513.8330078125,2,2,0,7,3102,2
100110,Furniture,119.89337921142578,2022-02-17,48,0,131.28173828125,6301.5234375,3,2,0,7,3150,2
100110,Furniture,119.89337921142578,2022-02-18,97,0,131.28173828125,12734.32861328125,4,2,0,7,3247,2
100110,Furniture,119.89337921142578,2022-02-19,112,0,131.28173828125,14703.5546875,5,2,1,7,3359,2
100110,Furniture,119.89337921142578,2022-02-20,59,0,131.28173828125,7745.62255859375,6,2,1,7,3418,2
100110,Furniture,119.89337921142578,2022-02-21,75,231,112.66361755371094,33299.82263305664,0,2,0,8,3493,2
100110,Furniture,119.89337921142578,2022-02-22,55,0,120.19723510742188,6610.847930908203,1,2,0,8,3548,2
100110,Furniture,119.89337921142578,2022-02-23,57,0,120.19723510742188,6851.242401123047,2,2,0,8,3605,2
100110,Furniture,119.89337921142578,2022-02-24,29,0,120.19723510742188,3485.7198181152344,3,2,0,8,3634,2
100110,Furniture,119.89337921142578,2022-02-25,30,0,120.19723510742188,3605.9170532226562,4,2,0,8,3664,2
100110,Furniture,119.89337921142578,2022-02-26,68,283,98.99787231445313,33172.760634765626,5,2,1,8,3732,2
100110,Furniture,119.89337921142578,2022-02-27,66,0,106.32574462890625,7017.4991455078125,6,2,1,8,3798,2
100110,Furniture,119.89337921142578,2022-02-28,56,0,106.32574462890625,5954.24169921875,0,2,0,9,3854,2
100110,Furniture,119.89337921142578,2022-03-01,70,0,106.32574462890625,7442.8021240234375,1,3,0,9,3924,2
100110,Furniture,119.89337921142578,2022-03-02,58,293,100.21649780273438,34666.86374511718,2,3,0,9,3982,2
100110,Furniture,119.89337921142578,2022-03-03,124,0,102.38299560546875,12695.491455078125,3,3,0,9,4106,2
100110,Furniture,119.89337921142578,2022-03-04,71,0,102.38299560546875,7269.192687988281,4,3,0,9,4177,2
100110,Furniture,119.89337921142578,2022-03-05,69,416,126.43718933105468,63852.64212768554,5,3,1,9,4246,2
100110,Furniture,119.89337921142578,2022-03-06,71,0,119.14437866210938,8459.250885009766,6,3,1,9,4317,2
100110,Furniture,119.89337921142578,2022-03-07,113,0,119.14437866210938,13463.31478881836,0,3,0,10,4430,2
100110,Furniture,119.89337921142578,2022-03-08,69,0,119.14437866210938,8220.962127685547,1,3,0,10,4499,2
100110,Furniture,119.89337921142578,2022-03-09,68,0,119.14437866210938,8101.8177490234375,2,3,0,10,4567,2
100110,Furniture,119.89337921142578,2022-03-10,79,396,125.91404373168945,60514.79890960693,3,3,0,10,4646,2
100110,Furniture,119.89337921142578,2022-03-11,55,0,123.6880874633789,6802.84481048584,4,3,0,10,4701,2
100110,Furniture,119.89337921142578,2022-03-12,62,0,123.6880874633789,7668.661422729492,5,3,1,10,4763,2
100110,Furniture,119.89337921142578,2022-03-13,67,0,123.6880874633789,8287.101860046387,6,3,1,10,4830,2
100110,Furniture,119.89337921142578,2022-03-14,42,0,123.6880874633789,5194.899673461914,0,3,0,11,4872,2
100110,Furniture,119.89337921142578,2022-03-15,82,0,123.6880874633789,10142.42317199707,1,3,0,11,4954,2
100110,Furniture,119.89337921142578,2022-03-16,89,0,123.6880874633789,11008.239784240723,2,3,0,11,5043,2
100110,Furniture,119.89337921142578,2022-03-17,82,326,136.56776580810546,56727.913592529294,3,3,0,11,5125,2
100110,Furniture,119.89337921142578,2022-03-18,104,0,132.43553161621094,13773.295288085938,4,3,0,11,5229,2
100110,Furniture,119.89337921142578,2022-03-19,72,0,132.43553161621094,9535.358276367188,5,3,1,11,5301,2
100110,Furniture,119.89337921142578,2022-03-20,50,476,134.48088958740234,70983.64895874023,6,3,1,11,5351,2
100110,Furniture,119.89337921142578,2022-03-21,79,0,133.9017791748047,10578.24055480957,0,3,0,12,5430,2
100110,Furniture,119.89337921142578,2022-03-22,114,0,133.9017791748047,15264.802825927734,1,3,0,12,5544,2
100110,Furniture,119.89337921142578,2022-03-23,133,469,147.00264556884764,90228.46372131347,2,3,0,12,5677,2
100110,Furniture,119.89337921142578,2022-03-24,36,0,141.8452911376953,5106.430480957031,3,3,0,12,5713,2
100110,Furniture,119.89337921142578,2022-03-25,177,0,141.8452911376953,25106.61653137207,4,3,0,12,5890,2
100110,Furniture,119.89337921142578,2022-03-26,76,0,141.8452911376953,10780.242126464844,5,3,1,12,5966,2
100110,Furniture,119.89337921142578,2022-03-27,112,0,141.8452911376953,15886.672607421875,6,3,1,12,6078,2
100110,Furniture,119.89337921142578,2022-03-28,88,0,141.8452911376953,12482.385620117188,0,3,0,13,6166,2
100110,Furniture,119.89337921142578,2022-03-29,75,503,144.67683532714844,84001.20529907227,1,3,0,13,6241,2
100110,Furniture,119.89337921142578,2022-03-30,97,0,143.79367065429688,13947.986053466797,2,3,0,13,6338,2
100110,Furniture,119.89337921142578,2022-03-31,59,0,143.79367065429688,8483.826568603516,3,3,0,13,6397,2
100110,Furniture,119.89337921142578,2022-04-01,125,0,143.79367065429688,17974.20883178711,4,4,0,13,6522,2
100110,Furniture,119.89337921142578,2022-04-02,66,0,143.79367065429688,9490.382263183594,5,4,1,13,6588,2
100110,Furniture,119.89337921142578,2022-04-03,79,0,143.79367065429688,11359.699981689453,6,4,1,13,6667,2
100110,Furniture,119.89337921142578,2022-04-04,56,0,143.79367065429688,8052.445556640625,0,4,0,14,6723,2
100110,Furniture,119.89337921142578,2022-04-05,76,511,149.00798248291017,88108.01333740234,1,4,0,14,6799,2
100110,Furniture,119.89337921142578,2022-04-06,47,0,147.5359649658203,6934.190353393555,2,4,0,14,6846,2
100110,Furniture,119.89337921142578,2022-04-07,116,0,147.5359649658203,17114.171936035156,3,4,0,14,6962,2
100110,Furniture,119.89337921142578,2022-04-08,65,0,147.5359649658203,9589.83772277832,4,4,0,14,7027,2
100110,Furniture,119.89337921142578,2022-04-09,46,0,147.5359649658203,6786.654388427734,5,4,1,14,7073,2
100110,Furniture,119.89337921142578,2022-04-10,32,0,147.5359649658203,4721.15087890625,6,4,1,14,7105,2
100110,Furniture,119.89337921142578,2022-04-11,107,648,142.26264404296876,106579.1358251953,0,4,0,15,7212,2
100110,Furniture,119.89337921142578,2022-04-12,132,0,143.7952880859375,18980.97802734375,1,4,0,15,7344,2
100110,Furniture,119.89337921142578,2022-04-13,41,0,143.7952880859375,5895.6068115234375,2,4,0,15,7385,2
100110,Furniture,119.89337921142578,2022-04-14,116,0,143.7952880859375,16680.25341796875,3,4,0,15,7501,2
100110,Furniture,119.89337921142578,2022-04-15,32,0,143.7952880859375,4601.44921875,4,4,0,15,7533,2
100110,Furniture,119.89337921142578,2022-04-16,91,0,143.7952880859375,13085.371215820312,5,4,1,15,7624,2
100110,Furniture,119.89337921142578,2022-04-17,128,0,143.7952880859375,18405.796875,6,4,1,15,7752,2
100110,Furniture,119.89337921142578,2022-04-18,65,0,143.7952880859375,9346.693725585938,0,4,0,16,7817,2
100110,Furniture,119.89337921142578,2022-04-19,79,394,145.61344482421873,69088.27428222656,1,4,0,16,7896,2
100110,Furniture,119.89337921142578,2022-04-20,135,0,144.9368896484375,19566.480102539062,2,4,0,16,8031,2
100110,Furniture,119.89337921142578,2022-04-21,74,0,144.9368896484375,10725.329833984375,3,4,0,16,8105,2
100110,Furniture,119.89337921142578,2022-04-22,60,0,144.9368896484375,8696.21337890625,4,4,0,16,8165,2
100110,Furniture,119.89337921142578,2022-04-23,42,0,144.9368896484375,6087.349365234375,5,4,1,16,8207,2
100110,Furniture,119.89337921142578,2022-04-24,39,0,144.9368896484375,5652.5386962890625,6,4,1,16,8246,2
100110,Furniture,119.89337921142578,2022-04-25,35,0,144.9368896484375,5072.7911376953125,0,4,0,17,8281,2
100110,Furniture,119.89337921142578,2022-04-26,33,0,144.9368896484375,4782.9173583984375,1,4,0,17,8314,2
100110,Furniture,119.89337921142578,2022-04-27,45,0,144.9368896484375,6522.1600341796875,2,4,0,17,8359,2
100110,Furniture,119.89337921142578,2022-04-28,15,0,144.9368896484375,2174.0533447265625,3,4,0,17,8374,2
100110,Furniture,119.89337921142578,2022-04-29,42,0,144.9368896484375,6087.349365234375,4,4,0,17,8416,2
100110,Furniture,119.89337921142578,2022-04-30,30,0,144.9368896484375,4348.106689453125,5,4,1,17,8446,2
100110,Furniture,119.89337921142578,2022-05-01,75,321,116.15898681640624,44119.768022460936,6,5,1,17,8521,2
100110,Furniture,119.89337921142578,2022-05-02,41,0,123.7979736328125,5075.7169189453125,0,5,0,18,8562,2
100110,Furniture,119.89337921142578,2022-05-03,18,0,123.7979736328125,2228.363525390625,1,5,0,18,8580,2
100110,Furniture,119.89337921142578,2022-05-04,42,0,123.7979736328125,5199.514892578125,2,5,0,18,8622,2
100110,Furniture,119.89337921142578,2022-05-05,40,0,123.7979736328125,4951.9189453125,3,5,0,18,8662,2
100110,Furniture,119.89337921142578,2022-05-06,27,0,123.7979736328125,3342.5452880859375,4,5,0,18,8689,2
100110,Furniture,119.89337921142578,2022-05-07,21,0,123.7979736328125,2599.7574462890625,5,5,1,18,8710,2
100110,Furniture,119.89337921142578,2022-05-08,24,0,123.7979736328125,2971.1513671875,6,5,1,18,8734,2
100110,Furniture,119.89337921142578,2022-05-09,25,0,123.7979736328125,3094.9493408203125,0,5,0,19,8759,2
100110,Furniture,119.89337921142578,2022-05-10,56,184,122.75263397216797,29407.815004882814,1,5,0,19,8815,2
100110,Furniture,119.89337921142578,2022-05-11,22,0,123.16526794433594,2709.6358947753906,2,5,0,19,8837,2
100110,Furniture,119.89337921142578,2022-05-12,39,0,123.16526794433594,4803.445449829102,3,5,0,19,8876,2
100110,Furniture,119.89337921142578,2022-05-13,23,0,123.16526794433594,2832.8011627197266,4,5,0,19,8899,2
100110,Furniture,119.89337921142578,2022-05-14,32,0,123.16526794433594,3941.28857421875,5,5,1,19,8931,2
100110,Furniture,119.89337921142578,2022-05-15,46,194,114.924716796875,27101.713945312502,6,5,1,19,8977,2
100110,Furniture,119.89337921142578,2022-05-16,21,0,118.16943359375,2481.55810546875,0,5,0,20,8998,2
100110,Furniture,119.89337921142578,2022-05-17,47,0,118.16943359375,5553.96337890625,1,5,0,20,9045,2
100110,Furniture,119.89337921142578,2022-05-18,63,0,118.16943359375,7444.67431640625,2,5,0,20,9108,2
100110,Furniture,119.89337921142578,2022-05-19,43,0,118.16943359375,5081.28564453125,3,5,0,20,9151,2
100110,Furniture,119.89337921142578,2022-05-20,60,232,103.59398666381836,29428.3183996582,4,5,0,20,9211,2
100110,Furniture,119.89337921142578,2022-05-21,28,0,108.36797332763672,3034.303253173828,5,5,1,20,9239,2
100110,Furniture,119.89337921142578,2022-05-22,45,0,108.36797332763672,4876.558799743652,6,5,1,20,9284,2
100110,Furniture,119.89337921142578,2022-05-23,21,0,108.36797332763672,2275.727439880371,0,5,0,21,9305,2
100110,Furniture,119.89337921142578,2022-05-24,30,0,108.36797332763672,3251.0391998291016,1,5,0,21,9335,2
100110,Furniture,119.89337921142578,2022-05-25,48,0,108.36797332763672,5201.6627197265625,2,5,0,21,9383,2
100110,Furniture,119.89337921142578,2022-05-26,48,241,123.17383499145508,36509.38815917969,3,5,0,21,9431,2
100110,Furniture,119.89337921142578,2022-05-27,35,0,118.44766998291016,4145.6684494018555,4,5,0,21,9466,2
100110,Furniture,119.89337921142578,2022-05-28,129,497,142.5918618774414,91738.46036437988,5,5,1,21,9595,2
100110,Furniture,119.89337921142578,2022-05-29,14,0,135.8637237548828,1902.0921325683594,6,5,1,21,9609,2
100110,Furniture,119.89337921142578,2022-05-30,55,0,135.8637237548828,7472.504806518555,0,5,0,22,9664,2
100110,Furniture,119.89337921142578,2022-05-31,57,0,135.8637237548828,7744.23225402832,1,5,0,22,9721,2
100110,Furniture,119.89337921142578,2022-06-01,35,0,135.8637237548828,4755.230331420898,2,6,0,22,9756,2
100110,Furniture,119.89337921142578,2022-06-02,32,0,135.8637237548828,4347.63916015625,3,6,0,22,9788,2
100110,Furniture,119.89337921142578,2022-06-03,38,0,135.8637237548828,5162.821502685547,4,6,0,22,9826,2
100110,Furniture,119.89337921142578,2022-06-04,37,0,135.8637237548828,5026.957778930664,5,6,1,22,9863,2
100110,Furniture,119.89337921142578,2022-06-05,51,0,135.8637237548828,6929.049911499023,6,6,1,22,9914,2
100110,Furniture,119.89337921142578,2022-06-06,33,0,135.8637237548828,4483.502883911133,0,6,0,23,9947,2
100110,Furniture,119.89337921142578,2022-06-07,81,0,135.8637237548828,11004.961624145508,1,6,0,23,10028,2
100110,Furniture,119.89337921142578,2022-06-08,116,493,117.4910888671875,69858.9326171875,2,6,0,23,10144,2
100110,Furniture,119.89337921142578,2022-06-09,83,0,121.982177734375,10124.520751953125,3,6,0,23,10227,2
100110,Furniture,119.89337921142578,2022-06-10,61,0,121.982177734375,7440.912841796875,4,6,0,23,10288,2
100110,Furniture,119.89337921142578,2022-06-11,59,0,121.982177734375,7196.948486328125,5,6,1,23,10347,2
100110,Furniture,119.89337921142578,2022-06-12,92,400,136.0906594848633,68613.44134521484,6,6,1,23,10439,2
100110,Furniture,119.89337921142578,2022-06-13,49,0,130.71131896972656,6404.854629516602,0,6,0,24,10488,2
100110,Furniture,119.89337921142578,2022-06-14,45,0,130.71131896972656,5882.009353637695,1,6,0,24,10533,2
100110,Furniture,119.89337921142578,2022-06-15,72,0,130.71131896972656,9411.214965820312,2,6,0,24,10605,2
100110,Furniture,119.89337921142578,2022-06-16,78,0,130.71131896972656,10195.482879638672,3,6,0,24,10683,2
100110,Furniture,119.89337921142578,2022-06-17,71,0,130.71131896972656,9280.503646850586,4,6,0,24,10754,2
100110,Furniture,119.89337921142578,2022-06-18,63,0,130.71131896972656,8234.813095092773,5,6,1,24,10817,2
100110,Furniture,119.89337921142578,2022-06-19,69,365,124.63076705932617,53429.44585418701,6,6,1,24,10886,2
100110,Furniture,119.89337921142578,2022-06-20,30,0,126.86153411865234,3805.8460235595703,0,6,0,25,10916,2
100110,Furniture,119.89337921142578,2022-06-21,75,0,126.86153411865234,9514.615058898926,1,6,0,25,10991,2
100110,Furniture,119.89337921142578,2022-06-22,117,0,126.86153411865234,14842.799491882324,2,6,0,25,11108,2
100110,Furniture,119.89337921142578,2022-06-23,66,0,126.86153411865234,8372.861251831055,3,6,0,25,11174,2
100110,Furniture,119.89337921142578,2022-06-24,60,0,126.86153411865234,7611.692047119141,4,6,0,25,11234,2
100110,Furniture,119.89337921142578,2022-06-25,160,619,136.8555889892578,107668.2284765625,5,6,1,25,11394,2
100110,Furniture,119.89337921142578,2022-06-26,52,0,134.55117797851562,6996.6612548828125,6,6,1,25,11446,2
100110,Furniture,119.89337921142578,2022-06-27,66,0,134.55117797851562,8880.377746582031,0,6,0,26,11512,2
100110,Furniture,119.89337921142578,2022-06-28,59,0,134.55117797851562,7938.519500732422,1,6,0,26,11571,2
100110,Furniture,119.89337921142578,2022-06-29,24,0,134.55117797851562,3229.228271484375,2,6,0,26,11595,2
100110,Furniture,119.89337921142578,2022-06-30,29,0,134.55117797851562,3901.984161376953,3,6,0,26,11624,2
100110,Furniture,119.89337921142578,2022-07-01,28,0,134.55117797851562,3767.4329833984375,4,7,0,26,11652,2
100110,Furniture,119.89337921142578,2022-07-02,27,0,134.55117797851562,3632.881805419922,5,7,1,26,11679,2
100110,Furniture,119.89337921142578,2022-07-03,18,0,134.55117797851562,2421.9212036132812,6,7,1,26,11697,2
100110,Furniture,119.89337921142578,2022-07-04,28,0,134.55117797851562,3767.4329833984375,0,7,0,27,11725,2
100110,Furniture,119.89337921142578,2022-07-05,24,0,134.55117797851562,3229.228271484375,1,7,0,27,11749,2
100110,Furniture,119.89337921142578,2022-07-06,35,0,134.55117797851562,4709.291229248047,2,7,0,27,11784,2
100110,Furniture,119.89337921142578,2022-07-07,10,0,134.55117797851562,1345.5117797851562,3,7,0,27,11794,2
100110,Furniture,119.89337921142578,2022-07-08,39,0,134.55117797851562,5247.495941162109,4,7,0,27,11833,2
100110,Furniture,119.89337921142578,2022-07-09,25,0,134.55117797851562,3363.7794494628906,5,7,1,27,11858,2
100110,Furniture,119.89337921142578,2022-07-10,13,0,134.55117797851562,1749.1653137207031,6,7,1,27,11871,2
100110,Furniture,119.89337921142578,2022-07-11,35,0,134.55117797851562,4709.291229248047,0,7,0,28,11906,2
100110,Furniture,119.89337921142578,2022-07-12,44,0,134.55117797851562,5920.2518310546875,1,7,0,28,11950,2
100110,Furniture,119.89337921142578,2022-07-13,38,249,121.02923797607423,33722.752086181645,2,7,0,28,11988,2
100110,Furniture,119.89337921142578,2022-07-14,32,0,125.82847595214844,4026.51123046875,3,7,0,28,12020,2
100110,Furniture,119.89337921142578,2022-07-15,35,0,125.82847595214844,4403.996658325195,4,7,0,28,12055,2
100110,Furniture,119.89337921142578,2022-07-16,49,0,125.82847595214844,6165.595321655273,5,7,1,28,12104,2
100110,Furniture,119.89337921142578,2022-07-17,23,0,125.82847595214844,2894.054946899414,6,7,1,28,12127,2
100110,Furniture,119.89337921142578,2022-07-18,26,0,125.82847595214844,3271.5403747558594,0,7,0,29,12153,2
100110,Furniture,119.89337921142578,2022-07-19,44,314,105.8752635192871,36084.823189697265,1,7,0,29,12197,2
100110,Furniture,119.89337921142578,2022-07-20,18,0,112.61052703857422,2026.989486694336,2,7,0,29,12215,2
100110,Furniture,119.89337921142578,2022-07-21,19,0,112.61052703857422,2139.60001373291,3,7,0,29,12234,2
100110,Furniture,119.89337921142578,2022-07-22,24,0,112.61052703857422,2702.6526489257812,4,7,0,29,12258,2
100110,Furniture,119.89337921142578,2022-07-23,35,0,112.61052703857422,3941.3684463500977,5,7,1,29,12293,2
100110,Furniture,119.89337921142578,2022-07-24,27,0,112.61052703857422,3040.484230041504,6,7,1,29,12320,2
100110,Furniture,119.89337921142578,2022-07-25,83,0,112.61052703857422,9346.67374420166,0,7,0,30,12403,2
100110,Furniture,119.89337921142578,2022-07-26,39,0,112.61052703857422,4391.8105545043945,1,7,0,30,12442,2
100110,Furniture,119.89337921142578,2022-07-27,41,0,112.61052703857422,4617.031608581543,2,7,0,30,12483,2
100110,Furniture,119.89337921142578,2022-07-28,118,493,134.8978073120117,84392.13252563476,3,7,0,30,12601,2
100110,Furniture,119.89337921142578,2022-07-29,32,0,129.64561462402344,4148.65966796875,4,7,0,30,12633,2
100110,Furniture,119.89337921142578,2022-07-30,54,0,129.64561462402344,7000.863189697266,5,7,1,30,12687,2
100110,Furniture,119.89337921142578,2022-07-31,76,0,129.64561462402344,9853.066711425781,6,7,1,30,12763,2
100110,Furniture,119.89337921142578,2022-08-01,63,0,129.64561462402344,8167.673721313477,0,8,0,31,12826,2
100110,Furniture,119.89337921142578,2022-08-02,36,0,129.64561462402344,4667.242126464844,1,8,0,31,12862,2
100110,Furniture,119.89337921142578,2022-08-03,64,450,125.18475128173827,63798.8681640625,2,8,0,31,12926,2
100110,Furniture,119.89337921142578,2022-08-04,59,0,126.59950256347656,7469.370651245117,3,8,0,31,12985,2
100110,Furniture,119.89337921142578,2022-08-05,106,0,126.59950256347656,13419.547271728516,4,8,0,31,13091,2
100110,Furniture,119.89337921142578,2022-08-06,94,0,126.59950256347656,11900.353240966797,5,8,1,31,13185,2
100110,Furniture,119.89337921142578,2022-08-07,88,0,126.59950256347656,11140.756225585938,6,8,1,31,13273,2
100110,Furniture,119.89337921142578,2022-08-08,29,0,126.59950256347656,3671.3855743408203,0,8,0,32,13302,2
100110,Furniture,119.89337921142578,2022-08-09,161,514,140.7889294433594,96504.91528076172,1,8,0,32,13463,2
100110,Furniture,119.89337921142578,2022-08-10,72,0,136.61785888671875,9836.48583984375,2,8,0,32,13535,2
100110,Furniture,119.89337921142578,2022-08-11,69,0,136.61785888671875,9426.632263183594,3,8,0,32,13604,2
100110,Furniture,119.89337921142578,2022-08-12,75,0,136.61785888671875,10246.339416503906,4,8,0,32,13679,2
100110,Furniture,119.89337921142578,2022-08-13,131,0,136.61785888671875,17896.939514160156,5,8,1,32,13810,2
100110,Furniture,119.89337921142578,2022-08-14,104,558,129.04140563964845,84462.29237304688,6,8,1,32,13914,2
100110,Furniture,119.89337921142578,2022-08-15,112,0,131.16281127929688,14690.23486328125,0,8,0,33,14026,2
100110,Furniture,119.89337921142578,2022-08-16,53,0,131.16281127929688,6951.628997802734,1,8,0,33,14079,2
100110,Furniture,119.89337921142578,2022-08-17,82,0,131.16281127929688,10755.350524902344,2,8,0,33,14161,2
100110,Furniture,119.89337921142578,2022-08-18,90,0,131.16281127929688,11804.653015136719,3,8,0,33,14251,2
100110,Furniture,119.89337921142578,2022-08-19,65,0,131.16281127929688,8525.582733154297,4,8,0,33,14316,2
100110,Furniture,119.89337921142578,2022-08-20,80,0,131.16281127929688,10493.02490234375,5,8,1,33,14396,2
100110,Furniture,119.89337921142578,2022-08-21,58,0,131.16281127929688,7607.443054199219,6,8,1,33,14454,2
100110,Furniture,119.89337921142578,2022-08-22,77,400,126.69450561523438,59995.773864746094,0,8,0,34,14531,2
100110,Furniture,119.89337921142578,2022-08-23,117,0,128.04901123046875,14981.734313964844,1,8,0,34,14648,2
100110,Furniture,119.89337921142578,2022-08-24,54,0,128.04901123046875,6914.6466064453125,2,8,0,34,14702,2
100110,Furniture,119.89337921142578,2022-08-25,66,0,128.04901123046875,8451.234741210938,3,8,0,34,14768,2
100110,Furniture,119.89337921142578,2022-08-26,70,0,128.04901123046875,8963.430786132812,4,8,0,34,14838,2
100110,Furniture,119.89337921142578,2022-08-27,29,0,128.04901123046875,3713.4213256835938,5,8,1,34,14867,2
100110,Furniture,119.89337921142578,2022-08-28,39,0,128.04901123046875,4993.911437988281,6,8,1,34,14906,2
100110,Furniture,119.89337921142578,2022-08-29,48,285,116.5428273010254,37876.681420898436,0,8,0,35,14954,2
100110,Furniture,119.89337921142578,2022-08-30,74,0,120.47565460205078,8915.198440551758,1,8,0,35,15028,2
100110,Furniture,119.89337921142578,2022-08-31,46,0,120.47565460205078,5541.880111694336,2,8,0,35,15074,2
100110,Furniture,119.89337921142578,2022-09-01,75,352,120.28901229858398,51344.2918447876,3,9,0,35,15149,2
100110,Furniture,119.89337921142578,2022-09-02,117,0,120.35802459716797,14081.888877868652,4,9,0,35,15266,2
100110,Furniture,119.89337921142578,2022-09-03,88,0,120.35802459716797,10591.506164550781,5,9,1,35,15354,2
100110,Furniture,119.89337921142578,2022-09-04,53,0,120.35802459716797,6378.975303649902,6,9,1,35,15407,2
100110,Furniture,119.89337921142578,2022-09-05,64,0,120.35802459716797,7702.91357421875,0,9,0,36,15471,2
100110,Furniture,119.89337921142578,2022-09-06,135,478,126.31444107055664,77998.6090890503,1,9,0,36,15606,2
100110,Furniture,119.89337921142578,2022-09-07,89,0,124.65888214111328,11094.640510559082,2,9,0,36,15695,2
100110,Furniture,119.89337921142578,2022-09-08,51,0,124.65888214111328,6357.602989196777,3,9,0,36,15746,2
100110,Furniture,119.89337921142578,2022-09-09,75,0,124.65888214111328,9349.416160583496,4,9,0,36,15821,2
100110,Furniture,119.89337921142578,2022-09-10,103,526,116.04121841430664,71821.93099334717,5,9,1,36,15924,2
100110,Furniture,119.89337921142578,2022-09-11,71,0,118.80243682861328,8434.973014831543,6,9,1,36,15995,2
100110,Furniture,119.89337921142578,2022-09-12,60,0,118.80243682861328,7128.146209716797,0,9,0,37,16055,2
100110,Furniture,119.89337921142578,2022-09-13,65,0,118.80243682861328,7722.158393859863,1,9,0,37,16120,2
100110,Furniture,119.89337921142578,2022-09-14,65,0,118.80243682861328,7722.158393859863,2,9,0,37,16185,2
100110,Furniture,119.89337921142578,2022-09-15,69,0,118.80243682861328,8197.368141174316,3,9,0,37,16254,2
100110,Furniture,119.89337921142578,2022-09-16,35,0,118.80243682861328,4158.085289001465,4,9,0,37,16289,2
100110,Furniture,119.89337921142578,2022-09-17,61,0,118.80243682861328,7246.94864654541,5,9,1,37,16350,2
100110,Furniture,119.89337921142578,2022-09-18,74,0,118.80243682861328,8791.380325317383,6,9,1,37,16424,2
100110,Furniture,119.89337921142578,2022-09-19,94,0,118.80243682861328,11167.429061889648,0,9,0,38,16518,2
100110,Furniture,119.89337921142578,2022-09-20,101,281,120.27166870117188,46040.67707763672,1,9,0,38,16619,2
100110,Furniture,119.89337921142578,2022-09-21,67,0,119.73333740234375,8022.133605957031,2,9,0,38,16686,2
100110,Furniture,119.89337921142578,2022-09-22,90,396,110.32889770507813,52595.081586914064,3,9,0,38,16776,2
100110,Furniture,119.89337921142578,2022-09-23,67,0,113.67779541015625,7616.412292480469,4,9,0,38,16843,2
100110,Furniture,119.89337921142578,2022-09-24,90,0,113.67779541015625,10231.001586914062,5,9,1,38,16933,2
100110,Furniture,119.89337921142578,2022-09-25,68,0,113.67779541015625,7730.090087890625,6,9,1,38,17001,2
100110,Furniture,119.89337921142578,2022-09-26,197,724,136.13467529296875,128502.68206542969,0,9,0,39,17198,2
100110,Furniture,119.89337921142578,2022-09-27,49,0,130.2093505859375,6380.2581787109375,1,9,0,39,17247,2
100110,Furniture,119.89337921142578,2022-09-28,108,0,130.2093505859375,14062.60986328125,2,9,0,39,17355,2
100110,Furniture,119.89337921142578,2022-09-29,55,0,130.2093505859375,7161.5142822265625,3,9,0,39,17410,2
100110,Furniture,119.89337921142578,2022-09-30,13,0,130.2093505859375,1692.7215576171875,4,9,0,39,17423,2
100110,Furniture,119.89337921142578,2022-10-01,57,0,130.2093505859375,7421.9329833984375,5,10,1,39,17480,2
100110,Furniture,119.89337921142578,2022-10-02,22,0,130.2093505859375,2864.605712890625,6,10,1,39,17502,2
100110,Furniture,119.89337921142578,2022-10-03,87,0,130.2093505859375,11328.213500976562,0,10,0,40,17589,2
100110,Furniture,119.89337921142578,2022-10-04,69,0,130.2093505859375,8984.445190429688,1,10,0,40,17658,2
100110,Furniture,119.89337921142578,2022-10-05,65,0,130.2093505859375,8463.607788085938,2,10,0,40,17723,2
100110,Furniture,119.89337921142578,2022-10-06,50,0,130.2093505859375,6510.467529296875,3,10,0,40,17773,2
100110,Furniture,119.89337921142578,2022-10-07,85,0,130.2093505859375,11067.794799804688,4,10,0,40,17858,2
100110,Furniture,119.89337921142578,2022-10-08,94,467,132.69355865478514,74712.0490270996,5,10,1,40,17952,2
100110,Furniture,119.89337921142578,2022-10-09,54,0,131.9671173095703,7126.224334716797,6,10,1,40,18006,2
100110,Furniture,119.89337921142578,2022-10-10,69,0,131.9671173095703,9105.731094360352,0,10,0,41,18075,2
100110,Furniture,119.89337921142578,2022-10-11,56,0,131.9671173095703,7390.1585693359375,1,10,0,41,18131,2
100110,Furniture,119.89337921142578,2022-10-12,82,0,131.9671173095703,10821.303619384766,2,10,0,41,18213,2
100110,Furniture,119.89337921142578,2022-10-13,76,0,131.9671173095703,10029.500915527344,3,10,0,41,18289,2
100110,Furniture,119.89337921142578,2022-10-14,55,0,131.9671173095703,7258.191452026367,4,10,0,41,18344,2
100110,Furniture,119.89337921142578,2022-10-15,73,368,137.10911193847656,60969.83034301757,5,10,1,41,18417,2
100110,Furniture,119.89337921142578,2022-10-16,43,0,135.39822387695312,5822.123626708984,6,10,1,41,18460,2
100110,Furniture,119.89337921142578,2022-10-17,57,0,135.39822387695312,7717.698760986328,0,10,0,42,18517,2
100110,Furniture,119.89337921142578,2022-10-18,27,0,135.39822387695312,3655.7520446777344,1,10,0,42,18544,2
100110,Furniture,119.89337921142578,2022-10-19,81,0,135.39822387695312,10967.256134033203,2,10,0,42,18625,2
100110,Furniture,119.89337921142578,2022-10-20,50,0,135.39822387695312,6769.911193847656,3,10,0,42,18675,2
100110,Furniture,119.89337921142578,2022-10-21,84,474,125.40587707519532,68811.98734863281,4,10,0,42,18759,2
100110,Furniture,119.89337921142578,2022-10-22,124,0,128.39175415039062,15920.577514648438,5,10,1,42,18883,2
100110,Furniture,119.89337921142578,2022-10-23,88,0,128.39175415039062,11298.474365234375,6,10,1,42,18971,2
100110,Furniture,119.89337921142578,2022-10-24,59,0,128.39175415039062,7575.113494873047,0,10,0,43,19030,2
100110,Furniture,119.89337921142578,2022-10-25,35,0,128.39175415039062,4493.711395263672,1,10,0,43,19065,2
100110,Furniture,119.89337921142578,2022-10-26,23,0,128.39175415039062,2953.0103454589844,2,10,0,43,19088,2
100110,Furniture,119.89337921142578,2022-10-27,59,0,128.39175415039062,7575.113494873047,3,10,0,43,19147,2
100110,Furniture,119.89337921142578,2022-10-28,91,0,128.39175415039062,11683.649627685547,4,10,0,43,19238,2
100110,Furniture,119.89337921142578,2022-10-29,125,477,134.79943878173827,81709.13969543457,5,10,1,43,19363,2
100110,Furniture,119.89337921142578,2022-10-30,84,0,133.20887756347656,11189.545715332031,6,10,1,43,19447,2
100110,Furniture,119.89337921142578,2022-10-31,46,0,133.20887756347656,6127.608367919922,0,10,0,44,19493,2
100110,Furniture,119.89337921142578,2022-11-01,60,0,133.20887756347656,7992.532653808594,1,11,0,44,19553,2
100110,Furniture,119.89337921142578,2022-11-02,103,518,125.7739828491211,77132.89046691895,2,11,0,44,19656,2
100110,Furniture,119.89337921142578,2022-11-03,24,0,128.1179656982422,3074.8311767578125,3,11,0,44,19680,2
100110,Furniture,119.89337921142578,2022-11-04,52,0,128.1179656982422,6662.134216308594,4,11,0,44,19732,2
100110,Furniture,119.89337921142578,2022-11-05,81,0,128.1179656982422,10377.555221557617,5,11,1,44,19813,2
100110,Furniture,119.89337921142578,2022-11-06,57,0,128.1179656982422,7302.724044799805,6,11,1,44,19870,2
100110,Furniture,119.89337921142578,2022-11-07,105,0,128.1179656982422,13452.38639831543,0,11,0,45,19975,2
100110,Furniture,119.89337921142578,2022-11-08,112,0,128.1179656982422,14349.212158203125,1,11,0,45,20087,2
100110,Furniture,119.89337921142578,2022-11-09,114,447,145.6986654663086,83728.73572631837,2,11,0,45,20201,2
100110,Furniture,119.89337921142578,2022-11-10,76,0,139.7173309326172,10618.517150878906,3,11,0,45,20277,2
100110,Furniture,119.89337921142578,2022-11-11,71,0,139.7173309326172,9919.93049621582,4,11,0,45,20348,2
100110,Furniture,119.89337921142578,2022-11-12,71,0,139.7173309326172,9919.93049621582,5,11,1,45,20419,2
100110,Furniture,119.89337921142578,2022-11-13,45,0,139.7173309326172,6287.279891967773,6,11,1,45,20464,2
100110,Furniture,119.89337921142578,2022-11-14,50,0,139.7173309326172,6985.866546630859,0,11,0,46,20514,2
100110,Furniture,119.89337921142578,2022-11-15,87,0,139.7173309326172,12155.407791137695,1,11,0,46,20601,2
100110,Furniture,119.89337921142578,2022-11-16,67,0,139.7173309326172,9361.061172485352,2,11,0,46,20668,2
100110,Furniture,119.89337921142578,2022-11-17,67,300,115.0288735961914,40186.42906188965,3,11,0,46,20735,2
100110,Furniture,119.89337921142578,2022-11-18,79,0,123.73774719238281,9775.282028198242,4,11,0,46,20814,2
100110,Furniture,119.89337921142578,2022-11-19,81,0,123.73774719238281,10022.757522583008,5,11,1,46,20895,2
100110,Furniture,119.89337921142578,2022-11-20,39,0,123.73774719238281,4825.77214050293,6,11,1,46,20934,2
100110,Furniture,119.89337921142578,2022-11-21,31,0,123.73774719238281,3835.870162963867,0,11,0,47,20965,2
100110,Furniture,119.89337921142578,2022-11-22,33,0,123.73774719238281,4083.345657348633,1,11,0,47,20998,2
100110,Furniture,119.89337921142578,2022-11-23,49,0,123.73774719238281,6063.149612426758,2,11,0,47,21047,2
100110,Furniture,119.89337921142578,2022-11-24,44,257,119.78609848022461,35781.676666259766,3,11,0,47,21091,2
100110,Furniture,119.89337921142578,2022-11-25,71,0,121.07219696044922,8596.125984191895,4,11,0,47,21162,2
100110,Furniture,119.89337921142578,2022-11-26,133,536,165.5856823730469,115562.17151123047,5,11,1,47,21295,2
100110,Furniture,119.89337921142578,2022-11-28,26,0,153.71136474609375,3996.4954833984375,0,11,0,48,21321,2
100110,Furniture,119.89337921142578,2022-11-29,51,0,153.71136474609375,7839.279602050781,1,11,0,48,21372,2
100110,Furniture,119.89337921142578,2022-11-30,68,0,153.71136474609375,10452.372802734375,2,11,0,48,21440,2
100110,Furniture,119.89337921142578,2022-12-01,68,0,153.71136474609375,10452.372802734375,3,12,0,48,21508,2
100110,Furniture,119.89337921142578,2022-12-02,74,0,153.71136474609375,11374.640991210938,4,12,0,48,21582,2
100110,Furniture,119.89337921142578,2022-12-03,83,0,153.71136474609375,12758.043273925781,5,12,1,48,21665,2
100110,Furniture,119.89337921142578,2022-12-04,113,375,142.32579742431642,68379.27021789551,6,12,1,48,21778,2
100110,Furniture,119.89337921142578,2022-12-05,98,0,146.4315948486328,14350.296295166016,0,12,0,49,21876,2
100110,Furniture,119.89337921142578,2022-12-06,60,0,146.4315948486328,8785.895690917969,1,12,0,49,21936,2
100110,Furniture,119.89337921142578,2022-12-07,67,0,146.4315948486328,9810.916854858398,2,12,0,49,22003,2
100110,Furniture,119.89337921142578,2022-12-08,50,0,146.4315948486328,7321.579742431641,3,12,0,49,22053,2
100110,Furniture,119.89337921142578,2022-12-09,78,444,145.44244140625,75806.600859375,4,12,0,49,22131,2
100110,Furniture,119.89337921142578,2022-12-10,27,0,145.7548828125,3935.3818359375,5,12,1,49,22158,2
100110,Furniture,119.89337921142578,2022-12-11,21,0,145.7548828125,3060.8525390625,6,12,1,49,22179,2
100110,Furniture,119.89337921142578,2022-12-12,54,0,145.7548828125,7870.763671875,0,12,0,50,22233,2
100110,Furniture,119.89337921142578,2022-12-13,100,0,145.7548828125,14575.48828125,1,12,0,50,22333,2
100110,Furniture,119.89337921142578,2022-12-14,88,0,145.7548828125,12826.4296875,2,12,0,50,22421,2
100110,Furniture,119.89337921142578,2022-12-15,66,0,145.7548828125,9619.822265625,3,12,0,50,22487,2
100110,Furniture,119.89337921142578,2022-12-16,92,0,145.7548828125,13409.44921875,4,12,0,50,22579,2
100110,Furniture,119.89337921142578,2022-12-17,63,381,115.98751892089844,48649.9673840332,5,12,1,50,22642,2
100110,Furniture,119.89337921142578,2022-12-18,53,0,124.94503784179688,6622.087005615234,6,12,1,50,22695,2
100110,Furniture,119.89337921142578,2022-12-19,77,0,124.94503784179688,9620.76791381836,0,12,0,51,22772,2
100110,Furniture,119.89337921142578,2022-12-20,60,0,124.94503784179688,7496.7022705078125,1,12,0,51,22832,2
100110,Furniture,119.89337921142578,2022-12-21,51,0,124.94503784179688,6372.196929931641,2,12,0,51,22883,2
100110,Furniture,119.89337921142578,2022-12-22,34,0,124.94503784179688,4248.131286621094,3,12,0,51,22917,2
100110,Furniture,119.89337921142578,2022-12-23,43,0,124.94503784179688,5372.636627197266,4,12,0,51,22960,2
100110,Furniture,119.89337921142578,2022-12-24,89,604,162.20371826171873,116504.66185058594,5,12,1,51,23049,2
100110,Furniture,119.89337921142578,2022-12-25,76,0,154.2474365234375,11722.80517578125,6,12,1,51,23125,2
100110,Furniture,119.89337921142578,2022-12-26,110,0,154.2474365234375,16967.218017578125,0,12,0,52,23235,2
100110,Furniture,119.89337921142578,2022-12-27,53,0,154.2474365234375,8175.1141357421875,1,12,0,52,23288,2
100110,Furniture,119.89337921142578,2022-12-28,124,470,151.63281982421876,89715.99931640626,2,12,0,52,23412,2
100110,Furniture,119.89337921142578,2022-12-29,58,0,152.6556396484375,8854.027099609375,3,12,0,52,23470,2
100110,Furniture,119.89337921142578,2022-12-30,70,0,152.6556396484375,10685.894775390625,4,12,0,52,23540,2
100110,Furniture,119.89337921142578,2022-12-31,44,0,152.6556396484375,6716.84814453125,5,12,1,52,23584,2
100110,Furniture,119.89337921142578,2023-01-01,138,0,152.6556396484375,21066.478271484375,6,1,1,52,23722,2
100110,Furniture,119.89337921142578,2023-01-02,80,0,152.6556396484375,12212.451171875,0,1,0,1,23802,2
100110,Furniture,119.89337921142578,2023-01-03,74,0,152.6556396484375,11296.517333984375,1,1,0,1,23876,2
100110,Furniture,119.89337921142578,2023-01-04,85,0,152.6556396484375,12975.729370117188,2,1,0,1,23961,2
100110,Furniture,119.89337921142578,2023-01-05,61,0,152.6556396484375,9311.994018554688,3,1,0,1,24022,2
100110,Furniture,119.89337921142578,2023-01-06,140,451,134.15467254638673,77710.29831298828,4,1,0,1,24162,2
100110,Furniture,119.89337921142578,2023-01-07,125,0,139.21934509277344,17402.41813659668,5,1,1,1,24287,2
100110,Furniture,119.89337921142578,2023-01-08,43,0,139.21934509277344,5986.431838989258,6,1,1,1,24330,2
100110,Furniture,119.89337921142578,2023-01-09,32,0,139.21934509277344,4455.01904296875,0,1,0,2,24362,2
100110,Furniture,119.89337921142578,2023-01-10,101,489,135.66254760742186,79605.35461669922,1,1,0,2,24463,2
100110,Furniture,119.89337921142578,2023-01-11,76,0,136.78509521484375,10395.667236328125,2,1,0,2,24539,2
100110,Furniture,119.89337921142578,2023-01-12,29,0,136.78509521484375,3966.7677612304688,3,1,0,2,24568,2
100110,Furniture,119.89337921142578,2023-01-13,95,0,136.78509521484375,12994.584045410156,4,1,0,2,24663,2
100110,Furniture,119.89337921142578,2023-01-14,53,0,136.78509521484375,7249.610046386719,5,1,1,2,24716,2
100110,Furniture,119.89337921142578,2023-01-15,37,0,136.78509521484375,5061.048522949219,6,1,1,2,24753,2
100110,Furniture,119.89337921142578,2023-01-16,53,0,136.78509521484375,7249.610046386719,0,1,0,3,24806,2
100110,Furniture,119.89337921142578,2023-01-17,113,409,141.71071258544922,74523.34104431153,1,1,0,3,24919,2
100110,Furniture,119.89337921142578,2023-01-18,54,0,139.85142517089844,7551.976959228516,2,1,0,3,24973,2
100110,Furniture,119.89337921142578,2023-01-19,130,0,139.85142517089844,18180.685272216797,3,1,0,3,25103,2
100110,Furniture,119.89337921142578,2023-01-20,115,0,139.85142517089844,16082.91389465332,4,1,0,3,25218,2
100110,Furniture,119.89337921142578,2023-01-21,41,0,139.85142517089844,5733.908432006836,5,1,1,3,25259,2
100110,Furniture,119.89337921142578,2023-01-22,13,0,139.85142517089844,1818.0685272216797,6,1,1,3,25272,2
100110,Furniture,119.89337921142578,2023-01-23,97,0,139.85142517089844,13565.588241577148,0,1,0,4,25369,2
100110,Furniture,119.89337921142578,2023-01-24,74,374,122.22918090820312,53099.918774414065,1,1,0,4,25443,2
100110,Furniture,119.89337921142578,2023-01-25,83,0,127.75836181640625,10603.944030761719,2,1,0,4,25526,2
100110,Furniture,119.89337921142578,2023-01-26,81,0,127.75836181640625,10348.427307128906,3,1,0,4,25607,2
100110,Furniture,119.89337921142578,2023-01-27,55,0,127.75836181640625,7026.709899902344,4,1,0,4,25662,2
100110,Furniture,119.89337921142578,2023-01-28,145,629,146.11964141845704,115332.85601135255,5,1,1,4,25807,2
100110,Furniture,119.89337921142578,2023-01-29,27,0,141.49928283691406,3820.4806365966797,6,1,1,4,25834,2
100110,Furniture,119.89337921142578,2023-01-30,32,0,141.49928283691406,4527.97705078125,0,1,0,5,25866,2
100110,Furniture,119.89337921142578,2023-01-31,19,0,141.49928283691406,2688.486373901367,1,1,0,5,25885,2
100110,Furniture,119.89337921142578,2023-02-01,22,0,141.49928283691406,3112.9842224121094,2,2,0,5,25907,2
100110,Furniture,119.89337921142578,2023-02-02,24,0,141.49928283691406,3395.9827880859375,3,2,0,5,25931,2
100110,Furniture,119.89337921142578,2023-02-03,25,0,141.49928283691406,3537.4820709228516,4,2,0,5,25956,2
100110,Furniture,119.89337921142578,2023-02-04,16,0,141.49928283691406,2263.988525390625,5,2,1,5,25972,2
100110,Furniture,119.89337921142578,2023-02-05,16,0,141.49928283691406,2263.988525390625,6,2,1,5,25988,2
100110,Furniture,119.89337921142578,2023-02-06,27,0,141.49928283691406,3820.4806365966797,0,2,0,6,26015,2
100110,Furniture,119.89337921142578,2023-02-07,33,0,141.49928283691406,4669.476333618164,1,2,0,6,26048,2
100110,Furniture,119.89337921142578,2023-02-08,32,0,141.49928283691406,4527.97705078125,2,2,0,6,26080,2
100110,Furniture,119.89337921142578,2023-02-09,62,0,141.49928283691406,8772.955535888672,3,2,0,6,26142,2
100110,Furniture,119.89337921142578,2023-02-10,58,0,141.49928283691406,8206.958404541016,4,2,0,6,26200,2
100110,Furniture,119.89337921142578,2023-02-11,34,0,141.49928283691406,4810.975616455078,5,2,1,6,26234,2
100110,Furniture,119.89337921142578,2023-02-12,36,0,141.49928283691406,5093.974182128906,6,2,1,6,26270,2
100110,Furniture,119.89337921142578,2023-02-13,33,0,141.49928283691406,4669.476333618164,0,2,0,7,26303,2
100110,Furniture,119.89337921142578,2023-02-14,38,0,141.49928283691406,5376.972747802734,1,2,0,7,26341,2
100110,Furniture,119.89337921142578,2023-02-15,23,0,141.49928283691406,3254.4835052490234,2,2,0,7,26364,2
100110,Furniture,119.89337921142578,2023-02-16,55,0,141.49928283691406,7782.460556030273,3,2,0,7,26419,2
100110,Furniture,119.89337921142578,2023-02-17,19,0,141.49928283691406,2688.486373901367,4,2,0,7,26438,2
100110,Furniture,119.89337921142578,2023-02-18,45,208,108.35099166870117,25257.779250183106,5,2,1,7,26483,2
100110,Furniture,119.89337921142578,2023-02-19,23,0,121.57198333740234,2796.155616760254,6,2,1,7,26506,2
100110,Furniture,119.89337921142578,2023-02-20,29,0,121.57198333740234,3525.587516784668,0,2,0,8,26535,2
100110,Furniture,119.89337921142578,2023-02-21,62,0,121.57198333740234,7537.462966918945,1,2,0,8,26597,2
100110,Furniture,119.89337921142578,2023-02-22,27,0,121.57198333740234,3282.4435501098633,2,2,0,8,26624,2
100110,Furniture,119.89337921142578,2023-02-23,41,0,121.57198333740234,4984.451316833496,3,2,0,8,26665,2
100110,Furniture,119.89337921142578,2023-02-24,19,0,121.57198333740234,2309.8676834106445,4,2,0,8,26684,2
100110,Furniture,119.89337921142578,2023-02-25,34,0,121.57198333740234,4133.44743347168,5,2,1,8,26718,2
100110,Furniture,119.89337921142578,2023-02-26,29,155,106.45123062133788,18830.871376037598,6,2,1,8,26747,2
100110,Furniture,119.89337921142578,2023-02-27,23,0,112.45246124267578,2586.406608581543,0,2,0,9,26770,2
100110,Furniture,119.89337921142578,2023-02-28,19,0,112.45246124267578,2136.59676361084,1,2,0,9,26789,2
100110,Furniture,119.89337921142578,2023-03-01,54,0,112.45246124267578,6072.432907104492,2,3,0,9,26843,2
100110,Furniture,119.89337921142578,2023-03-02,79,385,128.8567007446289,60959.43871765137,3,3,0,9,26922,2
100110,Furniture,119.89337921142578,2023-03-03,81,0,125.03340148925781,10127.705520629883,4,3,0,9,27003,2
100110,Furniture,119.89337921142578,2023-03-04,74,0,125.03340148925781,9252.471710205078,5,3,1,9,27077,2
100110,Furniture,119.89337921142578,2023-03-05,0,401,134.22,53822.22,6,3,1,9,27077,2
100110,Furniture,119.89337921142578,2023-03-06,81,0,129.72019958496094,10507.336166381836,0,3,0,10,27158,2
100110,Furniture,119.89337921142578,2023-03-07,46,0,129.72019958496094,5967.129180908203,1,3,0,10,27204,2
100110,Furniture,119.89337921142578,2023-03-08,156,0,129.72019958496094,20236.351135253906,2,3,0,10,27360,2
100110,Furniture,119.89337921142578,2023-03-09,95,0,129.72019958496094,12323.418960571289,3,3,0,10,27455,2
100110,Furniture,119.89337921142578,2023-03-10,49,0,129.72019958496094,6356.289779663086,4,3,0,10,27504,2
100110,Furniture,119.89337921142578,2023-03-11,77,0,129.72019958496094,9988.455368041992,5,3,1,10,27581,2
100110,Furniture,119.89337921142578,2023-03-12,30,0,129.72019958496094,3891.605987548828,6,3,1,10,27611,2
100110,Furniture,119.89337921142578,2023-03-13,46,251,126.52716873168944,37359.79952331543,0,3,0,11,27657,2
100110,Furniture,119.89337921142578,2023-03-14,67,0,127.5943374633789,8548.820610046387,1,3,0,11,27724,2
100110,Furniture,119.89337921142578,2023-03-15,74,422,132.95559997558593,66535.62879638672,2,3,0,11,27798,2
100110,Furniture,119.89337921142578,2023-03-16,65,0,131.26119995117188,8531.977996826172,3,3,0,11,27863,2
100110,Furniture,119.89337921142578,2023-03-17,57,0,131.26119995117188,7481.888397216797,4,3,0,11,27920,2
100110,Furniture,119.89337921142578,2023-03-18,60,0,131.26119995117188,7875.6719970703125,5,3,1,11,27980,2
100110,Furniture,119.89337921142578,2023-03-19,80,0,131.26119995117188,10500.89599609375,6,3,1,11,28060,2
100110,Furniture,119.89337921142578,2023-03-20,50,0,131.26119995117188,6563.059997558594,0,3,0,12,28110,2
100110,Furniture,119.89337921142578,2023-03-21,52,0,131.26119995117188,6825.5823974609375,1,3,0,12,28162,2
100110,Furniture,119.89337921142578,2023-03-22,84,286,132.72234191894532,49223.953442382815,2,3,0,12,28246,2
100110,Furniture,119.89337921142578,2023-03-23,122,481,139.38748626708986,85024.44664916991,3,3,0,12,28368,2
100110,Furniture,119.89337921142578,2023-03-24,68,0,136.6749725341797,9293.898132324219,4,3,0,12,28436,2
100110,Furniture,119.89337921142578,2023-03-25,100,0,136.6749725341797,13667.497253417969,5,3,1,12,28536,2
100110,Furniture,119.89337921142578,2023-03-26,59,0,136.6749725341797,8063.823379516602,6,3,1,12,28595,2
100110,Furniture,119.89337921142578,2023-03-27,50,0,136.6749725341797,6833.748626708984,0,3,0,13,28645,2
100110,Furniture,119.89337921142578,2023-03-28,170,0,136.6749725341797,23234.745330810547,1,3,0,13,28815,2
100110,Furniture,119.89337921142578,2023-03-29,61,0,136.6749725341797,8337.173324584961,2,3,0,13,28876,2
100110,Furniture,119.89337921142578,2023-03-30,105,441,141.6704544067383,77899.59542541504,3,3,0,13,28981,2
100110,Furniture,119.89337921142578,2023-03-31,59,0,140.04090881347656,8262.413619995117,4,3,0,13,29040,2
100110,Furniture,119.89337921142578,2023-04-01,48,0,140.04090881347656,6721.963623046875,5,4,1,13,29088,2
100110,Furniture,119.89337921142578,2023-04-02,66,0,140.04090881347656,9242.699981689453,6,4,1,13,29154,2
100110,Furniture,119.89337921142578,2023-04-03,56,0,140.04090881347656,7842.2908935546875,0,4,0,14,29210,2
100110,Furniture,119.89337921142578,2023-04-04,61,0,140.04090881347656,8542.49543762207,1,4,0,14,29271,2
100110,Furniture,119.89337921142578,2023-04-05,101,0,140.04090881347656,14144.131790161133,2,4,0,14,29372,2
100110,Furniture,119.89337921142578,2023-04-06,90,0,140.04090881347656,12603.68179321289,3,4,0,14,29462,2
100110,Furniture,119.89337921142578,2023-04-07,111,390,118.00210876464844,57486.31814575195,4,4,0,14,29573,2
100110,Furniture,119.89337921142578,2023-04-08,61,0,123.85421752929688,7555.107269287109,5,4,1,14,29634,2
100110,Furniture,119.89337921142578,2023-04-09,52,0,123.85421752929688,6440.4193115234375,6,4,1,14,29686,2
100110,Furniture,119.89337921142578,2023-04-10,58,0,123.85421752929688,7183.544616699219,0,4,0,15,29744,2
100110,Furniture,119.89337921142578,2023-04-11,42,0,123.85421752929688,5201.877136230469,1,4,0,15,29786,2
100110,Furniture,119.89337921142578,2023-04-12,23,0,123.85421752929688,2848.647003173828,2,4,0,15,29809,2
100110,Furniture,119.89337921142578,2023-04-13,27,0,123.85421752929688,3344.0638732910156,3,4,0,15,29836,2
100110,Furniture,119.89337921142578,2023-04-14,12,0,123.85421752929688,1486.2506103515625,4,4,0,15,29848,2
100110,Furniture,119.89337921142578,2023-04-15,20,0,123.85421752929688,2477.0843505859375,5,4,1,15,29868,2
100110,Furniture,119.89337921142578,2023-04-16,25,0,123.85421752929688,3096.355438232422,6,4,1,15,29893,2
100110,Furniture,119.89337921142578,2023-04-17,42,167,107.09450546264648,21504.688458862303,0,4,0,16,29935,2
100110,Furniture,119.89337921142578,2023-04-18,20,0,114.11901092529297,2282.3802185058594,1,4,0,16,29955,2
100110,Furniture,119.89337921142578,2023-04-19,30,0,114.11901092529297,3423.570327758789,2,4,0,16,29985,2
100110,Furniture,119.89337921142578,2023-04-20,19,0,114.11901092529297,2168.2612075805664,3,4,0,16,30004,2
100110,Furniture,119.89337921142578,2023-04-21,20,0,114.11901092529297,2282.3802185058594,4,4,0,16,30024,2
100110,Furniture,119.89337921142578,2023-04-22,29,0,114.11901092529297,3309.451316833496,5,4,1,16,30053,2
100110,Furniture,119.89337921142578,2023-04-23,36,229,103.06351837158203,26562.313322753907,6,4,1,16,30089,2
100110,Furniture,119.89337921142578,2023-04-24,60,0,106.94703674316406,6416.822204589844,0,4,0,17,30149,2
100110,Furniture,119.89337921142578,2023-04-25,31,0,106.94703674316406,3315.358139038086,1,4,0,17,30180,2
100110,Furniture,119.89337921142578,2023-04-26,27,0,106.94703674316406,2887.5699920654297,2,4,0,17,30207,2
100110,Furniture,119.89337921142578,2023-04-27,50,0,106.94703674316406,5347.351837158203,3,4,0,17,30257,2
100110,Furniture,119.89337921142578,2023-04-28,29,0,106.94703674316406,3101.464065551758,4,4,0,17,30286,2
100110,Furniture,119.89337921142578,2023-04-29,37,0,106.94703674316406,3957.0403594970703,5,4,1,17,30323,2
100110,Furniture,119.89337921142578,2023-04-30,36,159,110.54957138061523,21731.879139404296,6,4,1,17,30359,2
100110,Furniture,119.89337921142578,2023-05-01,35,0,109.12914276123047,3819.5199966430664,0,5,0,18,30394,2
100110,Furniture,119.89337921142578,2023-05-02,89,327,108.45084869384766,45065.37106750488,1,5,0,18,30483,2
100110,Furniture,119.89337921142578,2023-05-03,13,0,108.66169738769531,1412.602066040039,2,5,0,18,30496,2
100110,Furniture,119.89337921142578,2023-05-04,26,0,108.66169738769531,2825.204132080078,3,5,0,18,30522,2
100110,Furniture,119.89337921142578,2023-05-05,11,0,108.66169738769531,1195.2786712646484,4,5,0,18,30533,2
100110,Furniture,119.89337921142578,2023-05-06,23,0,108.66169738769531,2499.219039916992,5,5,1,18,30556,2
100110,Furniture,119.89337921142578,2023-05-07,59,0,108.66169738769531,6411.040145874023,6,5,1,18,30615,2
100110,Furniture,119.89337921142578,2023-05-08,17,0,108.66169738769531,1847.2488555908203,0,5,0,19,30632,2
100110,Furniture,119.89337921142578,2023-05-09,9,0,108.66169738769531,977.9552764892578,1,5,0,19,30641,2
100110,Furniture,119.89337921142578,2023-05-10,32,0,108.66169738769531,3477.17431640625,2,5,0,19,30673,2
100110,Furniture,119.89337921142578,2023-05-11,26,0,108.66169738769531,2825.204132080078,3,5,0,19,30699,2
100110,Furniture,119.89337921142578,2023-05-12,11,0,108.66169738769531,1195.2786712646484,4,5,0,19,30710,2
100110,Furniture,119.89337921142578,2023-05-13,61,284,123.84433944702148,43911.68941253662,5,5,1,19,30771,2
100110,Furniture,119.89337921142578,2023-05-14,43,0,118.52867889404297,5096.733192443848,6,5,1,19,30814,2
100110,Furniture,119.89337921142578,2023-05-15,103,0,118.52867889404297,12208.453926086426,0,5,0,20,30917,2
100110,Furniture,119.89337921142578,2023-05-16,72,457,118.46021530151367,62657.67100341797,1,5,0,20,30989,2
100110,Furniture,119.89337921142578,2023-05-17,48,0,118.48043060302734,5687.0606689453125,2,5,0,20,31037,2
100110,Furniture,119.89337921142578,2023-05-18,130,0,118.48043060302734,15402.455978393555,3,5,0,20,31167,2
100110,Furniture,119.89337921142578,2023-05-19,62,0,118.48043060302734,7345.786697387695,4,5,0,20,31229,2
100110,Furniture,119.89337921142578,2023-05-20,14,0,118.48043060302734,1658.7260284423828,5,5,1,20,31243,2
100110,Furniture,119.89337921142578,2023-05-21,60,0,118.48043060302734,7108.825836181641,6,5,1,20,31303,2
100110,Furniture,119.89337921142578,2023-05-22,104,468,117.80169204711913,67301.87194580078,0,5,0,21,31407,2
100110,Furniture,119.89337921142578,2023-05-23,62,0,118.02338409423828,7317.449813842773,1,5,0,21,31469,2
100110,Furniture,119.89337921142578,2023-05-24,111,0,118.02338409423828,13100.59563446045,2,5,0,21,31580,2
100110,Furniture,119.89337921142578,2023-05-25,47,0,118.02338409423828,5547.099052429199,3,5,0,21,31627,2
100110,Furniture,119.89337921142578,2023-05-26,145,503,117.25606857299805,75879.51988616944,4,5,0,21,31772,2
100110,Furniture,119.89337921142578,2023-05-27,72,0,117.5421371459961,8463.033874511719,5,5,1,21,31844,2
100110,Furniture,119.89337921142578,2023-05-28,67,0,117.5421371459961,7875.323188781738,6,5,1,21,31911,2
100110,Furniture,119.89337921142578,2023-05-29,86,0,117.5421371459961,10108.623794555664,0,5,0,22,31997,2
100110,Furniture,119.89337921142578,2023-05-30,42,0,117.5421371459961,4936.769760131836,1,5,0,22,32039,2
100110,Furniture,119.89337921142578,2023-05-31,105,0,117.5421371459961,12341.92440032959,2,5,0,22,32144,2
100110,Furniture,119.89337921142578,2023-06-01,88,0,117.5421371459961,10343.708068847656,3,6,0,22,32232,2
100110,Furniture,119.89337921142578,2023-06-02,43,0,117.5421371459961,5054.311897277832,4,6,0,22,32275,2
100110,Furniture,119.89337921142578,2023-06-03,55,0,117.5421371459961,6464.817543029785,5,6,1,22,32330,2
100110,Furniture,119.89337921142578,2023-06-04,120,401,129.2176303100586,68410.52127441406,6,6,1,22,32450,2
100110,Furniture,119.89337921142578,2023-06-05,62,0,125.34526062011719,7771.406158447266,0,6,0,23,32512,2
100110,Furniture,119.89337921142578,2023-06-06,34,0,125.34526062011719,4261.738861083984,1,6,0,23,32546,2
100110,Furniture,119.89337921142578,2023-06-07,77,0,125.34526062011719,9651.585067749023,2,6,0,23,32623,2
100110,Furniture,119.89337921142578,2023-06-08,47,0,125.34526062011719,5891.227249145508,3,6,0,23,32670,2
100110,Furniture,119.89337921142578,2023-06-09,40,0,125.34526062011719,5013.8104248046875,4,6,0,23,32710,2
100110,Furniture,119.89337921142578,2023-06-10,65,324,127.86178665161133,49994.182264709474,5,6,1,23,32775,2
100110,Furniture,119.89337921142578,2023-06-11,56,0,126.87357330322266,7104.920104980469,6,6,1,23,32831,2
100110,Furniture,119.89337921142578,2023-06-12,48,0,126.87357330322266,6089.9315185546875,0,6,0,24,32879,2
100110,Furniture,119.89337921142578,2023-06-13,75,0,126.87357330322266,9515.5179977417,1,6,0,24,32954,2
100110,Furniture,119.89337921142578,2023-06-14,144,463,152.2231872558594,95231.1779296875,2,6,0,24,33098,2
100110,Furniture,119.89337921142578,2023-06-15,64,0,143.34637451171875,9174.16796875,3,6,0,24,33162,2
100110,Furniture,119.89337921142578,2023-06-16,28,0,143.34637451171875,4013.698486328125,4,6,0,24,33190,2
100110,Furniture,119.89337921142578,2023-06-17,69,0,143.34637451171875,9890.899841308594,5,6,1,24,33259,2
100110,Furniture,119.89337921142578,2023-06-18,82,0,143.34637451171875,11754.402709960938,6,6,1,24,33341,2
100110,Furniture,119.89337921142578,2023-06-19,137,0,143.34637451171875,19638.45330810547,0,6,0,25,33478,2
100110,Furniture,119.89337921142578,2023-06-20,147,650,133.42924865722657,105085.98910522461,1,6,0,25,33625,2
100110,Furniture,119.89337921142578,2023-06-21,171,0,135.92849731445312,23243.773040771484,2,6,0,25,33796,2
100110,Furniture,119.89337921142578,2023-06-22,52,0,135.92849731445312,7068.2818603515625,3,6,0,25,33848,2
100110,Furniture,119.89337921142578,2023-06-23,68,0,135.92849731445312,9243.137817382812,4,6,0,25,33916,2
100110,Furniture,119.89337921142578,2023-06-24,21,0,135.92849731445312,2854.4984436035156,5,6,1,25,33937,2
100110,Furniture,119.89337921142578,2023-06-25,11,0,135.92849731445312,1495.2134704589844,6,6,1,25,33948,2
100110,Furniture,119.89337921142578,2023-06-26,79,0,135.92849731445312,10738.351287841797,0,6,0,26,34027,2
100110,Furniture,119.89337921142578,2023-06-27,75,0,135.92849731445312,10194.637298583984,1,6,0,26,34102,2
100110,Furniture,119.89337921142578,2023-06-28,81,0,135.92849731445312,11010.208282470703,2,6,0,26,34183,2
100110,Furniture,119.89337921142578,2023-06-29,40,0,135.92849731445312,5437.139892578125,3,6,0,26,34223,2
100110,Furniture,119.89337921142578,2023-06-30,52,0,135.92849731445312,7068.2818603515625,4,6,0,26,34275,2
100110,Furniture,119.89337921142578,2023-07-01,59,294,121.32470046997071,41691.46465545654,5,7,1,26,34334,2
100110,Furniture,119.89337921142578,2023-07-02,18,0,126.1594009399414,2270.8692169189453,6,7,1,26,34352,2
100110,Furniture,119.89337921142578,2023-07-03,144,469,117.87161300659179,71309.02454589843,0,7,0,27,34496,2
100110,Furniture,119.89337921142578,2023-07-04,70,0,120.7832260131836,8454.825820922852,1,7,0,27,34566,2
100110,Furniture,119.89337921142578,2023-07-05,114,0,120.7832260131836,13769.28776550293,2,7,0,27,34680,2
100110,Furniture,119.89337921142578,2023-07-06,84,0,120.7832260131836,10145.790985107422,3,7,0,27,34764,2
100110,Furniture,119.89337921142578,2023-07-07,94,0,120.7832260131836,11353.623245239258,4,7,0,27,34858,2
100110,Furniture,119.89337921142578,2023-07-08,121,387,126.31663711547851,64725.6861819458,5,7,1,27,34979,2
100110,Furniture,119.89337921142578,2023-07-09,67,0,124.22327423095703,8322.959373474121,6,7,1,27,35046,2
100110,Furniture,119.89337921142578,2023-07-10,89,0,124.22327423095703,11055.871406555176,0,7,0,28,35135,2
100110,Furniture,119.89337921142578,2023-07-11,141,510,129.76053787231444,85215.60167999269,1,7,0,28,35276,2
100110,Furniture,119.89337921142578,2023-07-12,81,0,127.7510757446289,10347.837135314941,2,7,0,28,35357,2
100110,Furniture,119.89337921142578,2023-07-13,86,0,127.7510757446289,10986.592514038086,3,7,0,28,35443,2
100110,Furniture,119.89337921142578,2023-07-14,97,0,127.7510757446289,12391.854347229004,4,7,0,28,35540,2
100110,Furniture,119.89337921142578,2023-07-15,84,0,127.7510757446289,10731.090362548828,5,7,1,28,35624,2
100110,Furniture,119.89337921142578,2023-07-16,45,0,127.7510757446289,5748.798408508301,6,7,1,28,35669,2
100110,Furniture,119.89337921142578,2023-07-17,57,0,127.7510757446289,7281.811317443848,0,7,0,29,35726,2
100110,Furniture,119.89337921142578,2023-07-18,51,0,127.7510757446289,6515.304862976074,1,7,0,29,35777,2
100110,Furniture,119.89337921142578,2023-07-19,83,0,127.7510757446289,10603.3392868042,2,7,0,29,35860,2
100110,Furniture,119.89337921142578,2023-07-20,83,368,135.26459014892578,61715.52196472167,3,7,0,29,35943,2
100110,Furniture,119.89337921142578,2023-07-21,84,0,132.76918029785156,11152.611145019531,4,7,0,29,36027,2
100110,Furniture,119.89337921142578,2023-07-22,104,0,132.76918029785156,13807.994750976562,5,7,1,29,36131,2
100110,Furniture,119.89337921142578,2023-07-23,70,379,137.50440826416016,62294.317156982426,6,7,1,29,36201,2
100110,Furniture,119.89337921142578,2023-07-24,40,0,135.7088165283203,5428.3526611328125,0,7,0,30,36241,2
100110,Furniture,119.89337921142578,2023-07-25,42,0,135.7088165283203,5699.770294189453,1,7,0,30,36283,2
100110,Furniture,119.89337921142578,2023-07-26,55,0,135.7088165283203,7463.984909057617,2,7,0,30,36338,2
100110,Furniture,119.89337921142578,2023-07-27,45,0,135.7088165283203,6106.896743774414,3,7,0,30,36383,2
100110,Furniture,119.89337921142578,2023-07-28,64,0,135.7088165283203,8685.3642578125,4,7,0,30,36447,2
100110,Furniture,119.89337921142578,2023-07-29,86,0,135.7088165283203,11670.958221435547,5,7,1,30,36533,2
100110,Furniture,119.89337921142578,2023-07-30,36,0,135.7088165283203,4885.517395019531,6,7,1,30,36569,2
100110,Furniture,119.89337921142578,2023-07-31,55,0,135.7088165283203,7463.984909057617,0,7,0,31,36624,2
100110,Furniture,119.89337921142578,2023-08-01,61,0,135.7088165283203,8278.237808227539,1,8,0,31,36685,2
100110,Furniture,119.89337921142578,2023-08-02,60,352,136.25223358154295,56181.988029785156,2,8,0,31,36745,2
100110,Furniture,119.89337921142578,2023-08-03,98,0,136.09446716308594,13337.257781982422,3,8,0,31,36843,2
100110,Furniture,119.89337921142578,2023-08-04,96,478,135.92634826660156,78000.1988671875,4,8,0,31,36939,2
100110,Furniture,119.89337921142578,2023-08-05,34,0,135.98269653320312,4623.411682128906,5,8,1,31,36973,2
100110,Furniture,119.89337921142578,2023-08-06,82,0,135.98269653320312,11150.581115722656,6,8,1,31,37055,2
100110,Furniture,119.89337921142578,2023-08-07,39,0,135.98269653320312,5303.325164794922,0,8,0,32,37094,2
100110,Furniture,119.89337921142578,2023-08-08,66,0,135.98269653320312,8974.857971191406,1,8,0,32,37160,2
100110,Furniture,119.89337921142578,2023-08-09,63,0,135.98269653320312,8566.909881591797,2,8,0,32,37223,2
100110,Furniture,119.89337921142578,2023-08-10,69,0,135.98269653320312,9382.806060791016,3,8,0,32,37292,2
100110,Furniture,119.89337921142578,2023-08-11,91,0,135.98269653320312,12374.425384521484,4,8,0,32,37383,2
100110,Furniture,119.89337921142578,2023-08-12,42,0,135.98269653320312,5711.273254394531,5,8,1,32,37425,2
100110,Furniture,119.89337921142578,2023-08-13,119,479,113.8204559326172,65807.26851196289,6,8,1,32,37544,2
100110,Furniture,119.89337921142578,2023-08-14,146,0,120.09091186523438,17533.27313232422,0,8,0,33,37690,2
100110,Furniture,119.89337921142578,2023-08-15,68,0,120.09091186523438,8166.1820068359375,1,8,0,33,37758,2
100110,Furniture,119.89337921142578,2023-08-16,45,0,120.09091186523438,5404.091033935547,2,8,0,33,37803,2
100110,Furniture,119.89337921142578,2023-08-17,67,0,120.09091186523438,8046.091094970703,3,8,0,33,37870,2
100110,Furniture,119.89337921142578,2023-08-18,139,580,133.24301025390625,97321.84685058593,4,8,0,33,38009,2
100110,Furniture,119.89337921142578,2023-08-19,52,0,129.7960205078125,6749.39306640625,5,8,1,33,38061,2
100110,Furniture,119.89337921142578,2023-08-20,65,0,129.7960205078125,8436.741333007812,6,8,1,33,38126,2
100110,Furniture,119.89337921142578,2023-08-21,53,0,129.7960205078125,6879.1890869140625,0,8,0,34,38179,2
100110,Furniture,119.89337921142578,2023-08-22,129,0,129.7960205078125,16743.686645507812,1,8,0,34,38308,2
100110,Furniture,119.89337921142578,2023-08-23,72,0,129.7960205078125,9345.3134765625,2,8,0,34,38380,2
100110,Furniture,119.89337921142578,2023-08-24,42,0,129.7960205078125,5451.432861328125,3,8,0,34,38422,2
100110,Furniture,119.89337921142578,2023-08-25,103,0,129.7960205078125,13368.990112304688,4,8,0,34,38525,2
100110,Furniture,119.89337921142578,2023-08-26,82,362,128.2204431152344,56789.75267089844,5,8,1,34,38607,2
100110,Furniture,119.89337921142578,2023-08-27,66,0,128.72088623046875,8495.578491210938,6,8,1,34,38673,2
100110,Furniture,119.89337921142578,2023-08-28,54,0,128.72088623046875,6950.9278564453125,0,8,0,35,38727,2
100110,Furniture,119.89337921142578,2023-08-29,80,0,128.72088623046875,10297.6708984375,1,8,0,35,38807,2
100110,Furniture,119.89337921142578,2023-08-30,101,0,128.72088623046875,13000.809509277344,2,8,0,35,38908,2
100110,Furniture,119.89337921142578,2023-08-31,63,367,129.5349966430664,55774.52957702637,3,8,0,35,38971,2
100110,Furniture,119.89337921142578,2023-09-01,106,0,129.2899932861328,13704.739288330078,4,9,0,35,39077,2
100110,Furniture,119.89337921142578,2023-09-02,67,0,129.2899932861328,8662.429550170898,5,9,1,35,39144,2
100110,Furniture,119.89337921142578,2023-09-03,80,921,159.19926788330076,164270.52286132812,6,9,1,35,39224,2
100110,Furniture,119.89337921142578,2023-09-04,82,0,153.35853576660156,12575.399932861328,0,9,0,36,39306,2
100110,Furniture,119.89337921142578,2023-09-05,100,0,153.35853576660156,15335.853576660156,1,9,0,36,39406,2
100110,Furniture,119.89337921142578,2023-09-06,76,0,153.35853576660156,11655.248718261719,2,9,0,36,39482,2
100110,Furniture,119.89337921142578,2023-09-07,33,0,153.35853576660156,5060.831680297852,3,9,0,36,39515,2
100110,Furniture,119.89337921142578,2023-09-08,100,0,153.35853576660156,15335.853576660156,4,9,0,36,39615,2
100110,Furniture,119.89337921142578,2023-09-09,53,0,153.35853576660156,8128.002395629883,5,9,1,36,39668,2
100110,Furniture,119.89337921142578,2023-09-10,71,0,153.35853576660156,10888.456039428711,6,9,1,36,39739,2
100110,Furniture,119.89337921142578,2023-09-11,49,0,153.35853576660156,7514.568252563477,0,9,0,37,39788,2
100110,Furniture,119.89337921142578,2023-09-12,30,0,153.35853576660156,4600.756072998047,1,9,0,37,39818,2
100110,Furniture,119.89337921142578,2023-09-13,92,0,153.35853576660156,14108.985290527344,2,9,0,37,39910,2
100110,Furniture,119.89337921142578,2023-09-14,60,0,153.35853576660156,9201.512145996094,3,9,0,37,39970,2
100110,Furniture,119.89337921142578,2023-09-15,95,0,153.35853576660156,14569.060897827148,4,9,0,37,40065,2
100110,Furniture,119.89337921142578,2023-09-16,44,0,153.35853576660156,6747.775573730469,5,9,1,37,40109,2
100110,Furniture,119.89337921142578,2023-09-17,41,0,153.35853576660156,6287.699966430664,6,9,1,37,40150,2
100110,Furniture,119.89337921142578,2023-09-18,88,303,126.94703308105468,47512.727822265624,0,9,0,38,40238,2
100110,Furniture,119.89337921142578,2023-09-19,91,0,136.82406616210938,12450.990020751953,1,9,0,38,40329,2
100110,Furniture,119.89337921142578,2023-09-20,124,490,146.9448226928711,91452.11602783203,2,9,0,38,40453,2
100110,Furniture,119.89337921142578,2023-09-21,59,0,143.5896453857422,8471.789077758789,3,9,0,38,40512,2
100110,Furniture,119.89337921142578,2023-09-22,93,0,143.5896453857422,13353.837020874023,4,9,0,38,40605,2
100110,Furniture,119.89337921142578,2023-09-23,95,0,143.5896453857422,13641.016311645508,5,9,1,38,40700,2
100110,Furniture,119.89337921142578,2023-09-24,76,0,143.5896453857422,10912.813049316406,6,9,1,38,40776,2
100110,Furniture,119.89337921142578,2023-09-25,100,0,143.5896453857422,14358.964538574219,0,9,0,39,40876,2
100110,Furniture,119.89337921142578,2023-09-26,42,0,143.5896453857422,6030.765106201172,1,9,0,39,40918,2
100110,Furniture,119.89337921142578,2023-09-27,66,372,130.26825378417968,55662.669499511714,2,9,0,39,40984,2
100110,Furniture,119.89337921142578,2023-09-28,60,0,134.82650756835938,8089.5904541015625,3,9,0,39,41044,2
100110,Furniture,119.89337921142578,2023-09-29,62,0,134.82650756835938,8359.243469238281,4,9,0,39,41106,2
100110,Furniture,119.89337921142578,2023-09-30,73,0,134.82650756835938,9842.335052490234,5,9,1,39,41179,2
100110,Furniture,119.89337921142578,2023-10-01,55,0,134.82650756835938,7415.457916259766,6,10,1,39,41234,2
100110,Furniture,119.89337921142578,2023-10-02,118,423,112.1897412109375,58321.82892578125,0,10,0,40,41352,2
100110,Furniture,119.89337921142578,2023-10-03,62,0,119.969482421875,7438.10791015625,1,10,0,40,41414,2
100110,Furniture,119.89337921142578,2023-10-04,144,0,119.969482421875,17275.60546875,2,10,0,40,41558,2
100110,Furniture,119.89337921142578,2023-10-05,81,0,119.969482421875,9717.528076171875,3,10,0,40,41639,2
100110,Furniture,119.89337921142578,2023-10-06,60,0,119.969482421875,7198.1689453125,4,10,0,40,41699,2
100110,Furniture,119.89337921142578,2023-10-07,43,0,119.969482421875,5158.687744140625,5,10,1,40,41742,2
100110,Furniture,119.89337921142578,2023-10-08,17,0,119.969482421875,2039.481201171875,6,10,1,40,41759,2
100110,Furniture,119.89337921142578,2023-10-09,25,0,119.969482421875,2999.237060546875,0,10,0,41,41784,2
100110,Furniture,119.89337921142578,2023-10-10,28,0,119.969482421875,3359.1455078125,1,10,0,41,41812,2
100110,Furniture,119.89337921142578,2023-10-11,47,0,119.969482421875,5638.565673828125,2,10,0,41,41859,2
100110,Furniture,119.89337921142578,2023-10-12,50,268,107.17761657714843,33217.54165771484,3,10,0,41,41909,2
100110,Furniture,119.89337921142578,2023-10-13,38,0,111.14523315429688,4223.518859863281,4,10,0,41,41947,2
100110,Furniture,119.89337921142578,2023-10-14,68,0,111.14523315429688,7557.8758544921875,5,10,1,41,42015,2
100110,Furniture,119.89337921142578,2023-10-15,23,0,111.14523315429688,2556.340362548828,6,10,1,41,42038,2
100110,Furniture,119.89337921142578,2023-10-16,12,0,111.14523315429688,1333.7427978515625,0,10,0,42,42050,2
100110,Furniture,119.89337921142578,2023-10-17,14,0,111.14523315429688,1556.0332641601562,1,10,0,42,42064,2
100110,Furniture,119.89337921142578,2023-10-18,37,0,111.14523315429688,4112.373626708984,2,10,0,42,42101,2
100110,Furniture,119.89337921142578,2023-10-19,48,0,111.14523315429688,5334.97119140625,3,10,0,42,42149,2
100110,Furniture,119.89337921142578,2023-10-20,37,0,111.14523315429688,4112.373626708984,4,10,0,42,42186,2
100110,Furniture,119.89337921142578,2023-10-21,64,225,109.78244812011718,31663.943359375,5,10,1,42,42250,2
100110,Furniture,119.89337921142578,2023-10-22,20,0,110.17489624023438,2203.4979248046875,6,10,1,42,42270,2
100110,Furniture,119.89337921142578,2023-10-23,27,0,110.17489624023438,2974.722198486328,0,10,0,43,42297,2
100110,Furniture,119.89337921142578,2023-10-24,20,0,110.17489624023438,2203.4979248046875,1,10,0,43,42317,2
100110,Furniture,119.89337921142578,2023-10-25,73,233,119.33335220336915,37061.06942169189,2,10,0,43,42390,2
100110,Furniture,119.89337921142578,2023-10-26,49,0,115.92670440673828,5680.408515930176,3,10,0,43,42439,2
100110,Furniture,119.89337921142578,2023-10-27,88,336,121.94183380126952,52248.48274902344,4,10,0,43,42527,2
100110,Furniture,119.89337921142578,2023-10-28,66,0,119.74366760253906,7903.082061767578,5,10,1,43,42593,2
100110,Furniture,119.89337921142578,2023-10-29,79,0,119.74366760253906,9459.749740600586,6,10,1,43,42672,2
100110,Furniture,119.89337921142578,2023-10-30,107,0,119.74366760253906,12812.57243347168,0,10,0,44,42779,2
100110,Furniture,119.89337921142578,2023-10-31,61,0,119.74366760253906,7304.363723754883,1,10,0,44,42840,2
100110,Furniture,119.89337921142578,2023-11-01,97,340,128.90570907592775,57047.25756072998,2,11,0,44,42937,2
100110,Furniture,119.89337921142578,2023-11-02,92,0,125.96141815185547,11588.450469970703,3,11,0,44,43029,2
100110,Furniture,119.89337921142578,2023-11-03,77,0,125.96141815185547,9699.029197692871,4,11,0,44,43106,2
100110,Furniture,119.89337921142578,2023-11-04,56,364,112.19136993408203,45626.15343261719,5,11,1,44,43162,2
100110,Furniture,119.89337921142578,2023-11-05,59,0,117.04273986816406,6905.52165222168,6,11,1,44,43221,2
100110,Furniture,119.89337921142578,2023-11-06,78,0,117.04273986816406,9129.333709716797,0,11,0,45,43299,2
100110,Furniture,119.89337921142578,2023-11-07,96,0,117.04273986816406,11236.10302734375,1,11,0,45,43395,2
100110,Furniture,119.89337921142578,2023-11-08,141,679,138.1933444213867,116248.84312683105,2,11,0,45,43536,2
100110,Furniture,119.89337921142578,2023-11-09,78,0,132.74668884277344,10354.241729736328,3,11,0,45,43614,2
100110,Furniture,119.89337921142578,2023-11-10,39,0,132.74668884277344,5177.120864868164,4,11,0,45,43653,2
100110,Furniture,119.89337921142578,2023-11-11,65,0,132.74668884277344,8628.534774780273,5,11,1,45,43718,2
100110,Furniture,119.89337921142578,2023-11-12,69,0,132.74668884277344,9159.521530151367,6,11,1,45,43787,2
100110,Furniture,119.89337921142578,2023-11-13,56,0,132.74668884277344,7433.8145751953125,0,11,0,46,43843,2
100110,Furniture,119.89337921142578,2023-11-14,89,0,132.74668884277344,11814.455307006836,1,11,0,46,43932,2
100110,Furniture,119.89337921142578,2023-11-15,87,0,132.74668884277344,11548.961929321289,2,11,0,46,44019,2
100110,Furniture,119.89337921142578,2023-11-16,72,0,132.74668884277344,9557.761596679688,3,11,0,46,44091,2
100110,Furniture,119.89337921142578,2023-11-17,42,0,132.74668884277344,5575.360931396484,4,11,0,46,44133,2
100110,Furniture,119.89337921142578,2023-11-18,57,0,132.74668884277344,7566.561264038086,5,11,1,46,44190,2
100110,Furniture,119.89337921142578,2023-11-19,119,522,126.33658264160155,80326.23666870117,6,11,1,46,44309,2
100110,Furniture,119.89337921142578,2023-11-20,76,0,127.96316528320312,9725.200561523438,0,11,0,47,44385,2
100110,Furniture,119.89337921142578,2023-11-21,56,0,127.96316528320312,7165.937255859375,1,11,0,47,44441,2
100110,Furniture,119.89337921142578,2023-11-22,104,0,127.96316528320312,13308.169189453125,2,11,0,47,44545,2
100110,Furniture,119.89337921142578,2023-11-23,124,0,127.96316528320312,15867.432495117188,3,11,0,47,44669,2
100110,Furniture,119.89337921142578,2023-11-24,77,407,128.10381622314452,62017.48769836426,4,11,0,47,44746,2
100110,Furniture,119.89337921142578,2023-11-25,27,0,128.05763244628906,3457.5560760498047,5,11,1,47,44773,2
100110,Furniture,119.89337921142578,2023-11-26,75,0,128.05763244628906,9604.32243347168,6,11,1,47,44848,2
100110,Furniture,119.89337921142578,2023-11-27,70,0,128.05763244628906,8964.034271240234,0,11,0,48,44918,2
100110,Furniture,119.89337921142578,2023-11-28,88,0,128.05763244628906,11269.071655273438,1,11,0,48,45006,2
100110,Furniture,119.89337921142578,2023-11-29,75,422,146.87699310302736,75327.27896545411,2,11,0,48,45081,2
100110,Furniture,119.89337921142578,2023-11-30,77,0,140.1639862060547,10792.626937866211,3,11,0,48,45158,2
100110,Furniture,119.89337921142578,2023-12-01,88,0,140.1639862060547,12334.430786132812,4,12,0,48,45246,2
100110,Furniture,119.89337921142578,2023-12-02,138,0,140.1639862060547,19342.630096435547,5,12,1,48,45384,2
100110,Furniture,119.89337921142578,2023-12-03,130,0,140.1639862060547,18221.31820678711,6,12,1,48,45514,2
100110,Furniture,119.89337921142578,2023-12-04,101,402,140.00213012695312,70405.38028564453,0,12,0,49,45615,2
100110,Furniture,119.89337921142578,2023-12-05,58,0,140.05426025390625,8123.1470947265625,1,12,0,49,45673,2
100110,Furniture,119.89337921142578,2023-12-06,141,0,140.05426025390625,19747.65069580078,2,12,0,49,45814,2
100110,Furniture,119.89337921142578,2023-12-07,47,0,140.05426025390625,6582.550231933594,3,12,0,49,45861,2
100110,Furniture,119.89337921142578,2023-12-08,123,483,120.0353874206543,70496.70530548095,4,12,0,49,45984,2
100110,Furniture,119.89337921142578,2023-12-09,47,0,126.2707748413086,5934.726417541504,5,12,1,49,46031,2
100110,Furniture,119.89337921142578,2023-12-10,67,0,126.2707748413086,8460.141914367676,6,12,1,49,46098,2
100110,Furniture,119.89337921142578,2023-12-11,102,0,126.2707748413086,12879.619033813477,0,12,0,50,46200,2
100110,Furniture,119.89337921142578,2023-12-12,85,0,126.2707748413086,10733.01586151123,1,12,0,50,46285,2
100110,Furniture,119.89337921142578,2023-12-13,69,0,126.2707748413086,8712.683464050293,2,12,0,50,46354,2
100110,Furniture,119.89337921142578,2023-12-14,69,0,126.2707748413086,8712.683464050293,3,12,0,50,46423,2
100110,Furniture,119.89337921142578,2023-12-15,100,531,147.27465454101562,95212.60090820312,4,12,0,50,46523,2
100110,Furniture,119.89337921142578,2023-12-16,28,0,141.97930908203125,3975.420654296875,5,12,1,50,46551,2
100110,Furniture,119.89337921142578,2023-12-17,118,0,141.97930908203125,16753.558471679688,6,12,1,50,46669,2
100110,Furniture,119.89337921142578,2023-12-18,43,0,141.97930908203125,6105.110290527344,0,12,0,51,46712,2
100110,Furniture,119.89337921142578,2023-12-19,64,0,141.97930908203125,9086.67578125,1,12,0,51,46776,2
100110,Furniture,119.89337921142578,2023-12-20,132,0,141.97930908203125,18741.268798828125,2,12,0,51,46908,2
100110,Furniture,119.89337921142578,2023-12-21,125,371,142.0167852783203,70443.57631958008,3,12,0,51,47033,2
100110,Furniture,119.89337921142578,2023-12-22,80,0,142.00357055664062,11360.28564453125,4,12,0,51,47113,2
100110,Furniture,119.89337921142578,2023-12-23,49,0,142.00357055664062,6958.174957275391,5,12,1,51,47162,2
100110,Furniture,119.89337921142578,2023-12-24,50,0,142.00357055664062,7100.178527832031,6,12,1,51,47212,2
100110,Furniture,119.89337921142578,2023-12-25,94,0,142.00357055664062,13348.335632324219,0,12,0,52,47306,2
100110,Furniture,119.89337921142578,2023-12-26,62,0,142.00357055664062,8804.221374511719,1,12,0,52,47368,2
100110,Furniture,119.89337921142578,2023-12-27,44,0,142.00357055664062,6248.1571044921875,2,12,0,52,47412,2
100110,Furniture,119.89337921142578,2023-12-28,23,0,142.00357055664062,3266.0821228027344,3,12,0,52,47435,2
100110,Furniture,119.89337921142578,2023-12-29,22,0,142.00357055664062,3124.0785522460938,4,12,0,52,47457,2
100110,Furniture,119.89337921142578,2023-12-30,27,0,142.00357055664062,3834.096405029297,5,12,1,52,47484,2
100110,Furniture,119.89337921142578,2023-12-31,62,197,126.1276611328125,31947.82998046875,6,12,1,52,47546,2
100110,Furniture,119.89337921142578,2024-01-01,70,0,131.455322265625,9201.87255859375,0,1,0,1,47616,2
100110,Furniture,119.89337921142578,2024-01-02,22,0,131.455322265625,2892.01708984375,1,1,0,1,47638,2
100110,Furniture,119.89337921142578,2024-01-03,22,0,131.455322265625,2892.01708984375,2,1,0,1,47660,2
100110,Furniture,119.89337921142578,2024-01-04,38,0,131.455322265625,4995.30224609375,3,1,0,1,47698,2
100110,Furniture,119.89337921142578,2024-01-05,64,256,108.16724517822266,33440.9273828125,4,1,0,1,47762,2
100110,Furniture,119.89337921142578,2024-01-06,22,0,114.27449035644531,2514.038787841797,5,1,1,1,47784,2
100110,Furniture,119.89337921142578,2024-01-07,49,0,114.27449035644531,5599.45002746582,6,1,1,1,47833,2
100110,Furniture,119.89337921142578,2024-01-08,21,0,114.27449035644531,2399.7642974853516,0,1,0,2,47854,2
100110,Furniture,119.89337921142578,2024-01-09,69,239,116.2405046081543,35926.089635925295,1,1,0,2,47923,2
100110,Furniture,119.89337921142578,2024-01-10,53,0,115.5110092163086,6122.0834884643555,2,1,0,2,47976,2
100110,Furniture,119.89337921142578,2024-01-11,49,0,115.5110092163086,5660.039451599121,3,1,0,2,48025,2
100110,Furniture,119.89337921142578,2024-01-12,47,340,125.49678070068359,49561.467385864256,4,1,0,2,48072,2
100110,Furniture,119.89337921142578,2024-01-13,73,0,122.10356140136719,8913.559982299805,5,1,1,2,48145,2
100110,Furniture,119.89337921142578,2024-01-14,38,0,122.10356140136719,4639.935333251953,6,1,1,2,48183,2
100110,Furniture,119.89337921142578,2024-01-15,89,0,122.10356140136719,10867.21696472168,0,1,0,3,48272,2
100110,Furniture,119.89337921142578,2024-01-16,57,0,122.10356140136719,6959.90299987793,1,1,0,3,48329,2
100110,Furniture,119.89337921142578,2024-01-17,73,366,112.86105819702149,48611.02449676514,2,1,0,3,48402,2
100110,Furniture,119.89337921142578,2024-01-18,80,0,116.05211639404297,9284.169311523438,3,1,0,3,48482,2
100110,Furniture,119.89337921142578,2024-01-19,34,0,116.05211639404297,3945.771957397461,4,1,0,3,48516,2
100110,Furniture,119.89337921142578,2024-01-20,70,0,116.05211639404297,8123.648147583008,5,1,1,3,48586,2
100110,Furniture,119.89337921142578,2024-01-21,44,0,116.05211639404297,5106.293121337891,6,1,1,3,48630,2
100110,Furniture,119.89337921142578,2024-01-22,74,0,116.05211639404297,8587.85661315918,0,1,0,4,48704,2
100110,Furniture,119.89337921142578,2024-01-23,66,0,116.05211639404297,7659.439682006836,1,1,0,4,48770,2
100110,Furniture,119.89337921142578,2024-01-24,101,640,120.82668960571289,90035.63130035401,2,1,0,4,48871,2
100110,Furniture,119.89337921142578,2024-01-25,82,0,119.89337921142578,9831.257095336914,3,1,0,4,48953,2
100110,Furniture,119.89337921142578,2024-01-26,82,0,119.89337921142578,9831.257095336914,4,1,0,4,49035,2
100110,Furniture,119.89337921142578,2024-01-27,46,0,119.89337921142578,5515.095443725586,5,1,1,4,49081,2
100110,Furniture,119.89337921142578,2024-01-28,57,0,119.89337921142578,6833.9226150512695,6,1,1,4,49138,2
100110,Furniture,119.89337921142578,2024-01-29,65,0,119.89337921142578,7793.069648742676,0,1,0,5,49203,2
100110,Furniture,119.89337921142578,2024-01-30,64,0,119.89337921142578,7673.17626953125,1,1,0,5,49267,2
100111,Furniture,165.239013671875,2022-01-01,51,357,156.33999816894533,63786.71981323243,5,1,1,52,51,2
100111,Furniture,165.239013671875,2022-01-02,152,264,170.13026306152344,71340.87997070313,6,1,1,52,203,2
100111,Furniture,165.239013671875,2022-01-03,62,0,165.07052612304688,10234.372619628906,0,1,0,1,265,2
100111,Furniture,165.239013671875,2022-01-04,54,0,165.07052612304688,8913.808410644531,1,1,0,1,319,2
100111,Furniture,165.239013671875,2022-01-05,62,0,165.07052612304688,10234.372619628906,2,1,0,1,381,2
100111,Furniture,165.239013671875,2022-01-06,96,197,143.8739440917969,41344.647265625,3,1,0,1,477,2
100111,Furniture,165.239013671875,2022-01-07,59,0,151.89788818359375,8961.975402832031,4,1,0,1,536,2
100111,Furniture,165.239013671875,2022-01-08,63,0,151.89788818359375,9569.566955566406,5,1,1,1,599,2
100111,Furniture,165.239013671875,2022-01-09,130,179,167.46971649169922,52037.7462878418,6,1,1,1,729,2
100111,Furniture,165.239013671875,2022-01-10,89,188,168.29641418457032,46895.66172485352,0,1,0,2,818,2
100111,Furniture,165.239013671875,2022-01-11,69,0,165.49282836914062,11419.005157470703,1,1,0,2,887,2
100111,Furniture,165.239013671875,2022-01-12,97,0,165.49282836914062,16052.80435180664,2,1,0,2,984,2
100111,Furniture,165.239013671875,2022-01-13,66,188,165.55747894287111,42054.347220458985,3,1,0,2,1050,2
100111,Furniture,165.239013671875,2022-01-14,107,0,165.5349578857422,17712.240493774414,4,1,0,2,1157,2
100111,Furniture,165.239013671875,2022-01-15,121,197,174.79946044921877,55835.54942871094,5,1,1,2,1278,2
100111,Furniture,165.239013671875,2022-01-16,30,0,171.5189208984375,5145.567626953125,6,1,1,2,1308,2
100111,Furniture,165.239013671875,2022-01-17,115,432,180.9626217651367,99683.12300598144,0,1,0,3,1423,2
100111,Furniture,165.239013671875,2022-01-18,84,0,178.76524353027344,15016.280456542969,1,1,0,3,1507,2
100111,Furniture,165.239013671875,2022-01-19,45,0,178.76524353027344,8044.435958862305,2,1,0,3,1552,2
100111,Furniture,165.239013671875,2022-01-20,120,0,178.76524353027344,21451.829223632812,3,1,0,3,1672,2
100111,Furniture,165.239013671875,2022-01-21,49,0,178.76524353027344,8759.496932983398,4,1,0,3,1721,2
100111,Furniture,165.239013671875,2022-01-22,92,0,178.76524353027344,16446.402404785156,5,1,1,3,1813,2
100111,Furniture,165.239013671875,2022-01-23,6,0,178.76524353027344,1072.5914611816406,6,1,1,3,1819,2
100111,Furniture,165.239013671875,2022-01-24,77,185,156.70141143798827,40267.217361450195,0,1,0,4,1896,2
100111,Furniture,165.239013671875,2022-01-25,85,0,164.00282287597656,13940.239944458008,1,1,0,4,1981,2
100111,Furniture,165.239013671875,2022-01-26,128,219,148.51438262939453,51083.641953125,2,1,0,4,2109,2
100111,Furniture,165.239013671875,2022-01-27,78,0,153.46876525878906,11970.563690185547,3,1,0,4,2187,2
100111,Furniture,165.239013671875,2022-01-28,71,171,144.25630767822264,34550.39569030762,4,1,0,4,2258,2
100111,Furniture,165.239013671875,2022-01-29,86,0,147.8526153564453,12715.324920654297,5,1,1,4,2344,2
100111,Furniture,165.239013671875,2022-01-30,57,207,166.47400268554688,44955.036306152346,6,1,1,4,2401,2
100111,Furniture,165.239013671875,2022-01-31,38,0,159.76800537109375,6071.1842041015625,0,1,0,5,2439,2
100111,Furniture,165.239013671875,2022-02-01,54,0,159.76800537109375,8627.472290039062,1,2,0,5,2493,2
100111,Furniture,165.239013671875,2022-02-02,94,231,149.44093475341796,48021.545733642575,2,2,0,5,2587,2
100111,Furniture,165.239013671875,2022-02-03,80,0,153.43186950683594,12274.549560546875,3,2,0,5,2667,2
100111,Furniture,165.239013671875,2022-02-04,103,0,153.43186950683594,15803.482559204102,4,2,0,5,2770,2
100111,Furniture,165.239013671875,2022-02-05,71,0,153.43186950683594,10893.662734985352,5,2,1,5,2841,2
100111,Furniture,165.239013671875,2022-02-06,160,266,172.14739501953125,73823.72640625,6,2,1,5,3001,2
100111,Furniture,165.239013671875,2022-02-07,14,282,147.3022250366211,41802.58230102539,0,2,0,6,3015,2
100111,Furniture,165.239013671875,2022-02-08,140,0,154.0144500732422,21562.023010253906,1,2,0,6,3155,2
100111,Furniture,165.239013671875,2022-02-09,100,0,154.0144500732422,15401.445007324219,2,2,0,6,3255,2
100111,Furniture,165.239013671875,2022-02-10,95,300,188.3523406982422,76786.94473266602,3,2,0,6,3350,2
100111,Furniture,165.239013671875,2022-02-11,106,0,176.70468139648438,18730.696228027344,4,2,0,6,3456,2
100111,Furniture,165.239013671875,2022-02-12,160,0,176.70468139648438,28272.7490234375,5,2,1,6,3616,2
100111,Furniture,165.239013671875,2022-02-13,33,0,176.70468139648438,5831.254486083984,6,2,1,6,3649,2
100111,Furniture,165.239013671875,2022-02-14,109,183,154.20982177734373,44415.081147460936,0,2,0,7,3758,2
100111,Furniture,165.239013671875,2022-02-15,84,0,162.5096435546875,13650.81005859375,1,2,0,7,3842,2
100111,Furniture,165.239013671875,2022-02-16,153,309,206.43004516601565,97071.07382080078,2,2,0,7,3995,2
100111,Furniture,165.239013671875,2022-02-17,51,0,195.53009033203125,9972.034606933594,3,2,0,7,4046,2
100111,Furniture,165.239013671875,2022-02-18,76,0,195.53009033203125,14860.286865234375,4,2,0,7,4122,2
100111,Furniture,165.239013671875,2022-02-19,89,228,180.22555389404297,56412.09859313965,5,2,1,7,4211,2
100111,Furniture,165.239013671875,2022-02-20,113,0,185.40110778808594,20950.32518005371,6,2,1,7,4324,2
100111,Furniture,165.239013671875,2022-02-21,63,0,185.40110778808594,11680.269790649414,0,2,0,8,4387,2
100111,Furniture,165.239013671875,2022-02-22,117,259,175.72593322753906,65695.80837524415,1,2,0,8,4504,2
100111,Furniture,165.239013671875,2022-02-23,45,0,178.38186645507812,8027.183990478516,2,2,0,8,4549,2
100111,Furniture,165.239013671875,2022-02-24,110,241,147.20635314941404,50125.417692871095,3,2,0,8,4659,2
100111,Furniture,165.239013671875,2022-02-25,65,0,158.99270629882812,10334.525909423828,4,2,0,8,4724,2
100111,Furniture,165.239013671875,2022-02-26,128,0,158.99270629882812,20351.06640625,5,2,1,8,4852,2
100111,Furniture,165.239013671875,2022-02-27,17,0,158.99270629882812,2702.876007080078,6,2,1,8,4869,2
100111,Furniture,165.239013671875,2022-02-28,53,132,150.763991394043,27600.303087768556,0,2,0,9,4922,2
100111,Furniture,165.239013671875,2022-03-01,50,0,154.44798278808594,7722.399139404297,1,3,0,9,4972,2
100111,Furniture,165.239013671875,2022-03-02,56,0,154.44798278808594,8649.087036132812,2,3,0,9,5028,2
100111,Furniture,165.239013671875,2022-03-03,117,217,176.14610656738282,59486.18893676758,3,3,0,9,5145,2
100111,Furniture,165.239013671875,2022-03-04,70,221,172.65291290283204,50422.75780639648,4,3,0,9,5215,2
100111,Furniture,165.239013671875,2022-03-05,66,0,171.45582580566406,11316.084503173828,5,3,1,9,5281,2
100111,Furniture,165.239013671875,2022-03-06,46,0,171.45582580566406,7886.967987060547,6,3,1,9,5327,2
100111,Furniture,165.239013671875,2022-03-07,104,0,171.45582580566406,17831.405883789062,0,3,0,10,5431,2
100111,Furniture,165.239013671875,2022-03-08,38,0,171.45582580566406,6515.321380615234,1,3,0,10,5469,2
100111,Furniture,165.239013671875,2022-03-09,56,179,154.46731719970703,35590.43952636719,2,3,0,10,5525,2
100111,Furniture,165.239013671875,2022-03-10,63,0,160.23463439941406,10094.781967163086,3,3,0,10,5588,2
100111,Furniture,165.239013671875,2022-03-11,73,0,160.23463439941406,11697.128311157227,4,3,0,10,5661,2
100111,Furniture,165.239013671875,2022-03-12,108,254,166.75731964111327,60605.98104248047,5,3,1,10,5769,2
100111,Furniture,165.239013671875,2022-03-13,63,0,165.11463928222656,10402.222274780273,6,3,1,10,5832,2
100111,Furniture,165.239013671875,2022-03-14,31,0,165.11463928222656,5118.553817749023,0,3,0,11,5863,2
100111,Furniture,165.239013671875,2022-03-15,39,0,165.11463928222656,6439.470932006836,1,3,0,11,5902,2
100111,Furniture,165.239013671875,2022-03-16,88,196,155.97849395751953,43982.69493652344,2,3,0,11,5990,2
100111,Furniture,165.239013671875,2022-03-17,69,0,158.89698791503906,10963.892166137695,3,3,0,11,6059,2
100111,Furniture,165.239013671875,2022-03-18,33,0,158.89698791503906,5243.600601196289,4,3,0,11,6092,2
100111,Furniture,165.239013671875,2022-03-19,111,214,166.06595397949218,54198.451783447264,5,3,1,11,6203,2
100111,Furniture,165.239013671875,2022-03-20,79,316,159.8657958984375,62846.99575195312,6,3,1,11,6282,2
100111,Furniture,165.239013671875,2022-03-21,69,0,161.131591796875,11118.079833984375,0,3,0,12,6351,2
100111,Furniture,165.239013671875,2022-03-22,54,0,161.131591796875,8701.10595703125,1,3,0,12,6405,2
100111,Furniture,165.239013671875,2022-03-23,82,0,161.131591796875,13212.79052734375,2,3,0,12,6487,2
100111,Furniture,165.239013671875,2022-03-24,89,0,161.131591796875,14340.711669921875,3,3,0,12,6576,2
100111,Furniture,165.239013671875,2022-03-25,94,171,163.62281829833984,43438.36984008789,4,3,0,12,6670,2
100111,Furniture,165.239013671875,2022-03-26,84,0,162.6056365966797,13658.873474121094,5,3,1,12,6754,2
100111,Furniture,165.239013671875,2022-03-27,156,236,163.596360168457,64155.66437255859,6,3,1,12,6910,2
100111,Furniture,165.239013671875,2022-03-28,73,228,153.49103881835936,45588.391667480464,0,3,0,13,6983,2
100111,Furniture,165.239013671875,2022-03-29,103,0,157.44207763671875,16216.533996582031,1,3,0,13,7086,2
100111,Furniture,165.239013671875,2022-03-30,35,0,157.44207763671875,5510.472717285156,2,3,0,13,7121,2
100111,Furniture,165.239013671875,2022-03-31,54,0,157.44207763671875,8501.872192382812,3,3,0,13,7175,2
100111,Furniture,165.239013671875,2022-04-01,79,0,157.44207763671875,12437.924133300781,4,4,0,13,7254,2
100111,Furniture,165.239013671875,2022-04-02,87,196,156.26750701904297,44181.46622131347,5,4,1,13,7341,2
100111,Furniture,165.239013671875,2022-04-03,81,0,156.65501403808594,12689.056137084961,6,4,1,13,7422,2
100111,Furniture,165.239013671875,2022-04-04,56,169,155.90608947753907,35045.41202148438,0,4,0,14,7478,2
100111,Furniture,165.239013671875,2022-04-05,71,0,156.20217895507812,11090.354705810547,1,4,0,14,7549,2
100111,Furniture,165.239013671875,2022-04-06,112,199,165.44317108154297,51772.71032226562,2,4,0,14,7661,2
100111,Furniture,165.239013671875,2022-04-07,151,243,183.26102722167968,73032.75022094726,3,4,0,14,7812,2
100111,Furniture,165.239013671875,2022-04-08,65,0,174.26205444335938,11327.03353881836,4,4,0,14,7877,2
100111,Furniture,165.239013671875,2022-04-09,62,0,174.26205444335938,10804.247375488281,5,4,1,14,7939,2
100111,Furniture,165.239013671875,2022-04-10,38,0,174.26205444335938,6621.958068847656,6,4,1,14,7977,2
100111,Furniture,165.239013671875,2022-04-11,92,0,174.26205444335938,16032.109008789062,0,4,0,15,8069,2
100111,Furniture,165.239013671875,2022-04-12,98,198,143.36737884521483,41453.00625366211,1,4,0,15,8167,2
100111,Furniture,165.239013671875,2022-04-13,87,311,175.37394134521486,71359.22579406737,2,4,0,15,8254,2
100111,Furniture,165.239013671875,2022-04-14,115,0,168.4078826904297,19366.906509399414,3,4,0,15,8369,2
100111,Furniture,165.239013671875,2022-04-15,130,0,168.4078826904297,21893.02474975586,4,4,0,15,8499,2
100111,Furniture,165.239013671875,2022-04-16,54,0,168.4078826904297,9094.025665283203,5,4,1,15,8553,2
100111,Furniture,165.239013671875,2022-04-17,88,138,158.90582885742188,35707.42587890625,6,4,1,15,8641,2
100111,Furniture,165.239013671875,2022-04-18,110,225,165.50642486572264,55549.713470458984,0,4,0,16,8751,2
100111,Furniture,165.239013671875,2022-04-19,64,0,164.5928497314453,10533.9423828125,1,4,0,16,8815,2
100111,Furniture,165.239013671875,2022-04-20,52,0,164.5928497314453,8558.828186035156,2,4,0,16,8867,2
100111,Furniture,165.239013671875,2022-04-21,47,0,164.5928497314453,7735.86393737793,3,4,0,16,8914,2
100111,Furniture,165.239013671875,2022-04-22,78,161,150.88290283203125,35609.25284179687,4,4,0,16,8992,2
100111,Furniture,165.239013671875,2022-04-23,46,0,156.3258056640625,7190.987060546875,5,4,1,16,9038,2
100111,Furniture,165.239013671875,2022-04-24,25,0,156.3258056640625,3908.1451416015625,6,4,1,16,9063,2
100111,Furniture,165.239013671875,2022-04-25,11,0,156.3258056640625,1719.5838623046875,0,4,0,17,9074,2
100111,Furniture,165.239013671875,2022-04-26,26,0,156.3258056640625,4064.470947265625,1,4,0,17,9100,2
100111,Furniture,165.239013671875,2022-04-27,31,0,156.3258056640625,4846.0999755859375,2,4,0,17,9131,2
100111,Furniture,165.239013671875,2022-04-28,26,63,140.55453399658205,12186.545767822266,3,4,0,17,9157,2
100111,Furniture,165.239013671875,2022-04-29,45,0,149.27906799316406,6717.558059692383,4,4,0,17,9202,2
100111,Furniture,165.239013671875,2022-04-30,44,96,141.100207824707,19568.89828857422,5,4,1,17,9246,2
100111,Furniture,165.239013671875,2022-05-01,24,0,144.66041564941406,3471.8499755859375,6,5,1,17,9270,2
100111,Furniture,165.239013671875,2022-05-02,35,0,144.66041564941406,5063.114547729492,0,5,0,18,9305,2
100111,Furniture,165.239013671875,2022-05-03,26,69,145.89571166992187,13886.937006835939,1,5,0,18,9331,2
100111,Furniture,165.239013671875,2022-05-04,15,0,145.27142333984375,2179.0713500976562,2,5,0,18,9346,2
100111,Furniture,165.239013671875,2022-05-05,34,106,134.80332763671873,18538.146279296874,3,5,0,18,9380,2
100111,Furniture,165.239013671875,2022-05-06,26,0,139.4466552734375,3625.613037109375,4,5,0,18,9406,2
100111,Furniture,165.239013671875,2022-05-07,52,158,153.37176788330078,32805.72385986328,5,5,1,18,9458,2
100111,Furniture,165.239013671875,2022-05-08,23,0,147.73353576660156,3397.871322631836,6,5,1,18,9481,2
100111,Furniture,165.239013671875,2022-05-09,33,0,147.73353576660156,4875.206680297852,0,5,0,19,9514,2
100111,Furniture,165.239013671875,2022-05-10,32,0,147.73353576660156,4727.47314453125,1,5,0,19,9546,2
100111,Furniture,165.239013671875,2022-05-11,22,0,147.73353576660156,3250.1377868652344,2,5,0,19,9568,2
100111,Furniture,165.239013671875,2022-05-12,19,0,147.73353576660156,2806.9371795654297,3,5,0,19,9587,2
100111,Furniture,165.239013671875,2022-05-13,23,0,147.73353576660156,3397.871322631836,4,5,0,19,9610,2
100111,Furniture,165.239013671875,2022-05-14,20,0,147.73353576660156,2954.6707153320312,5,5,1,19,9630,2
100111,Furniture,165.239013671875,2022-05-15,37,58,123.83006317138671,11481.614674682616,6,5,1,19,9667,2
100111,Furniture,165.239013671875,2022-05-16,39,84,147.59633972167967,18388.064498291016,0,5,0,20,9706,2
100111,Furniture,165.239013671875,2022-05-17,45,0,142.40267944335938,6408.120574951172,1,5,0,20,9751,2
100111,Furniture,165.239013671875,2022-05-18,33,89,130.89941467285155,15655.041368408203,2,5,0,20,9784,2
100111,Furniture,165.239013671875,2022-05-19,34,0,136.51882934570312,4641.640197753906,3,5,0,20,9818,2
100111,Furniture,165.239013671875,2022-05-20,50,0,136.51882934570312,6825.941467285156,4,5,0,20,9868,2
100111,Furniture,165.239013671875,2022-05-21,22,0,136.51882934570312,3003.4142456054688,5,5,1,20,9890,2
100111,Furniture,165.239013671875,2022-05-22,33,100,133.84331695556642,17733.938919067383,6,5,1,20,9923,2
100111,Furniture,165.239013671875,2022-05-23,29,0,134.8466339111328,3910.5523834228516,0,5,0,21,9952,2
100111,Furniture,165.239013671875,2022-05-24,33,70,142.5667706298828,14835.826861572265,1,5,0,21,9985,2
100111,Furniture,165.239013671875,2022-05-25,41,91,135.2812094116211,17774.55917175293,2,5,0,21,10026,2
100111,Furniture,165.239013671875,2022-05-26,63,0,136.9324188232422,8626.742385864258,3,5,0,21,10089,2
100111,Furniture,165.239013671875,2022-05-27,79,147,157.7936456298828,36203.75600952149,4,5,0,21,10168,2
100111,Furniture,165.239013671875,2022-05-28,79,0,149.81729125976562,11835.566009521484,5,5,1,21,10247,2
100111,Furniture,165.239013671875,2022-05-29,55,156,145.53580261230468,30554.95828735352,6,5,1,21,10302,2
100111,Furniture,165.239013671875,2022-05-30,72,0,147.05160522460938,10587.715576171875,0,5,0,22,10374,2
100111,Furniture,165.239013671875,2022-05-31,88,149,157.49561950683594,37582.31903320312,1,5,0,22,10462,2
100111,Furniture,165.239013671875,2022-06-01,54,0,153.30123901367188,8278.266906738281,2,6,0,22,10516,2
100111,Furniture,165.239013671875,2022-06-02,105,223,175.72249511718752,58475.66397460938,3,6,0,22,10621,2
100111,Furniture,165.239013671875,2022-06-03,65,0,168.614990234375,10959.974365234375,4,6,0,22,10686,2
100111,Furniture,165.239013671875,2022-06-04,63,199,163.0922375488281,42433.38193115234,5,6,1,22,10749,2
100111,Furniture,165.239013671875,2022-06-05,61,0,165.27447509765625,10081.742980957031,6,6,1,22,10810,2
100111,Furniture,165.239013671875,2022-06-06,57,0,165.27447509765625,9420.645080566406,0,6,0,23,10867,2
100111,Furniture,165.239013671875,2022-06-07,52,0,165.27447509765625,8594.272705078125,1,6,0,23,10919,2
100111,Furniture,165.239013671875,2022-06-08,67,0,165.27447509765625,11073.389831542969,2,6,0,23,10986,2
100111,Furniture,165.239013671875,2022-06-09,68,155,157.31008117675782,34845.241040039065,3,6,0,23,11054,2
100111,Furniture,165.239013671875,2022-06-10,80,183,164.19704193115234,43357.166708984376,4,6,0,23,11134,2
100111,Furniture,165.239013671875,2022-06-11,89,0,162.5140838623047,14463.753463745117,5,6,1,23,11223,2
100111,Furniture,165.239013671875,2022-06-12,145,388,162.18307189941407,86423.39085083007,6,6,1,23,11368,2
100111,Furniture,165.239013671875,2022-06-13,38,0,162.26614379882812,6166.113464355469,0,6,0,24,11406,2
100111,Furniture,165.239013671875,2022-06-14,60,0,162.26614379882812,9735.968627929688,1,6,0,24,11466,2
100111,Furniture,165.239013671875,2022-06-15,34,0,162.26614379882812,5517.048889160156,2,6,0,24,11500,2
100111,Furniture,165.239013671875,2022-06-16,50,0,162.26614379882812,8113.307189941406,3,6,0,24,11550,2
100111,Furniture,165.239013671875,2022-06-17,107,213,174.29218719482424,56321.288059692386,4,6,0,24,11657,2
100111,Furniture,165.239013671875,2022-06-18,85,0,169.12437438964844,14375.571823120117,5,6,1,24,11742,2
100111,Furniture,165.239013671875,2022-06-19,149,282,175.50240142822264,75961.74562561035,6,6,1,24,11891,2
100111,Furniture,165.239013671875,2022-06-20,79,0,173.0948028564453,13674.48942565918,0,6,0,25,11970,2
100111,Furniture,165.239013671875,2022-06-21,135,0,173.0948028564453,23367.798385620117,1,6,0,25,12105,2
100111,Furniture,165.239013671875,2022-06-22,104,245,170.90948028564452,59540.32189941406,2,6,0,25,12209,2
100111,Furniture,165.239013671875,2022-06-23,42,0,171.66896057128906,7210.096343994141,3,6,0,25,12251,2
100111,Furniture,165.239013671875,2022-06-24,57,0,171.66896057128906,9785.130752563477,4,6,0,25,12308,2
100111,Furniture,165.239013671875,2022-06-25,69,0,171.66896057128906,11845.158279418945,5,6,1,25,12377,2
100111,Furniture,165.239013671875,2022-06-26,128,236,161.58295166015625,58455.155625,6,6,1,25,12505,2
100111,Furniture,165.239013671875,2022-06-27,67,0,164.9259033203125,11050.035522460938,0,6,0,26,12572,2
100111,Furniture,165.239013671875,2022-06-28,35,0,164.9259033203125,5772.4066162109375,1,6,0,26,12607,2
100111,Furniture,165.239013671875,2022-06-29,21,0,164.9259033203125,3463.4439697265625,2,6,0,26,12628,2
100111,Furniture,165.239013671875,2022-06-30,22,0,164.9259033203125,3628.369873046875,3,6,0,26,12650,2
100111,Furniture,165.239013671875,2022-07-01,28,0,164.9259033203125,4617.92529296875,4,7,0,26,12678,2
100111,Furniture,165.239013671875,2022-07-02,43,111,152.94740844726562,23201.837126464845,5,7,1,26,12721,2
100111,Furniture,165.239013671875,2022-07-03,36,0,158.12481689453125,5692.493408203125,6,7,1,26,12757,2
100111,Furniture,165.239013671875,2022-07-04,56,123,157.83867309570314,28244.50138671875,0,7,0,27,12813,2
100111,Furniture,165.239013671875,2022-07-05,24,0,157.96734619140625,3791.21630859375,1,7,0,27,12837,2
100111,Furniture,165.239013671875,2022-07-06,35,0,157.96734619140625,5528.857116699219,2,7,0,27,12872,2
100111,Furniture,165.239013671875,2022-07-07,24,0,157.96734619140625,3791.21630859375,3,7,0,27,12896,2
100111,Furniture,165.239013671875,2022-07-08,60,133,138.26279815673828,26094.675778808596,4,7,0,27,12956,2
100111,Furniture,165.239013671875,2022-07-09,19,0,146.34559631347656,2780.5663299560547,5,7,1,27,12975,2
100111,Furniture,165.239013671875,2022-07-10,19,0,146.34559631347656,2780.5663299560547,6,7,1,27,12994,2
100111,Furniture,165.239013671875,2022-07-11,39,0,146.34559631347656,5707.478256225586,0,7,0,28,13033,2
100111,Furniture,165.239013671875,2022-07-12,69,103,150.55244995117187,25961.91809326172,1,7,0,28,13102,2
100111,Furniture,165.239013671875,2022-07-13,41,0,148.58489990234375,6091.980895996094,2,7,0,28,13143,2
100111,Furniture,165.239013671875,2022-07-14,40,92,126.96029052734374,16212.2232421875,3,7,0,28,13183,2
100111,Furniture,165.239013671875,2022-07-15,31,0,137.4705810546875,4261.5880126953125,4,7,0,28,13214,2
100111,Furniture,165.239013671875,2022-07-16,42,0,137.4705810546875,5773.764404296875,5,7,1,28,13256,2
100111,Furniture,165.239013671875,2022-07-17,28,82,132.2228305053711,14407.738508300781,6,7,1,28,13284,2
100111,Furniture,165.239013671875,2022-07-18,17,0,134.7556610107422,2290.846237182617,0,7,0,29,13301,2
100111,Furniture,165.239013671875,2022-07-19,43,0,134.7556610107422,5794.493423461914,1,7,0,29,13344,2
100111,Furniture,165.239013671875,2022-07-20,25,59,132.803115234375,11118.63576171875,2,7,0,29,13369,2
100111,Furniture,165.239013671875,2022-07-21,56,95,142.28330749511719,21644.550439453124,3,7,0,29,13425,2
100111,Furniture,165.239013671875,2022-07-22,79,130,142.5157928466797,29886.99526977539,4,7,0,29,13504,2
100111,Furniture,165.239013671875,2022-07-23,38,0,140.53158569335938,5340.200256347656,5,7,1,29,13542,2
100111,Furniture,165.239013671875,2022-07-24,23,0,140.53158569335938,3232.2264709472656,6,7,1,29,13565,2
100111,Furniture,165.239013671875,2022-07-25,82,179,151.53999298095704,39946.728848876955,0,7,0,30,13647,2
100111,Furniture,165.239013671875,2022-07-26,35,0,147.46998596191406,5161.449508666992,1,7,0,30,13682,2
100111,Furniture,165.239013671875,2022-07-27,42,0,147.46998596191406,6193.739410400391,2,7,0,30,13724,2
100111,Furniture,165.239013671875,2022-07-28,32,0,147.46998596191406,4719.03955078125,3,7,0,30,13756,2
100111,Furniture,165.239013671875,2022-07-29,20,0,147.46998596191406,2949.3997192382812,4,7,0,30,13776,2
100111,Furniture,165.239013671875,2022-07-30,82,229,163.33874572753905,51451.21429931641,5,7,1,30,13858,2
100111,Furniture,165.239013671875,2022-07-31,57,0,158.89749145507812,9057.157012939453,6,7,1,30,13915,2
100111,Furniture,165.239013671875,2022-08-01,58,0,158.89749145507812,9216.054504394531,0,8,0,31,13973,2
100111,Furniture,165.239013671875,2022-08-02,62,162,159.81082244873045,35833.54198364257,1,8,0,31,14035,2
100111,Furniture,165.239013671875,2022-08-03,118,0,159.45164489746094,18815.29409790039,2,8,0,31,14153,2
100111,Furniture,165.239013671875,2022-08-04,65,155,136.33240997314454,29197.31329650879,3,8,0,31,14218,2
100111,Furniture,165.239013671875,2022-08-05,79,0,145.17481994628906,11468.810775756836,4,8,0,31,14297,2
100111,Furniture,165.239013671875,2022-08-06,74,123,153.7245349121094,30473.141166992187,5,8,1,31,14371,2
100111,Furniture,165.239013671875,2022-08-07,52,0,149.85906982421875,7792.671630859375,6,8,1,31,14423,2
100111,Furniture,165.239013671875,2022-08-08,65,154,152.97374877929687,33610.3873413086,0,8,0,32,14488,2
100111,Furniture,165.239013671875,2022-08-09,74,0,151.74749755859375,11229.314819335938,1,8,0,32,14562,2
100111,Furniture,165.239013671875,2022-08-10,41,0,151.74749755859375,6221.647399902344,2,8,0,32,14603,2
100111,Furniture,165.239013671875,2022-08-11,63,152,146.34617370605469,31289.43788696289,3,8,0,32,14666,2
100111,Furniture,165.239013671875,2022-08-12,111,293,172.06270690917967,70852.36093383789,4,8,0,32,14777,2
100111,Furniture,165.239013671875,2022-08-13,61,0,164.70541381835938,10047.030242919922,5,8,1,32,14838,2
100111,Furniture,165.239013671875,2022-08-14,46,0,164.70541381835938,7576.449035644531,6,8,1,32,14884,2
100111,Furniture,165.239013671875,2022-08-15,100,0,164.70541381835938,16470.541381835938,0,8,0,33,14984,2
100111,Furniture,165.239013671875,2022-08-16,64,188,168.5570281982422,42661.499609375,1,8,0,33,15048,2
100111,Furniture,165.239013671875,2022-08-17,94,0,167.06405639648438,15704.021301269531,2,8,0,33,15142,2
100111,Furniture,165.239013671875,2022-08-18,98,0,167.06405639648438,16372.277526855469,3,8,0,33,15240,2
100111,Furniture,165.239013671875,2022-08-19,55,151,169.8033786010742,35074.21164611816,4,8,0,33,15295,2
100111,Furniture,165.239013671875,2022-08-20,68,0,168.81675720214844,11479.539489746094,5,8,1,33,15363,2
100111,Furniture,165.239013671875,2022-08-21,60,194,178.84247039794923,45879.9164477539,6,8,1,33,15423,2
100111,Furniture,165.239013671875,2022-08-22,127,319,173.29073944091797,77145.44781799318,0,8,0,34,15550,2
100111,Furniture,165.239013671875,2022-08-23,55,0,174.03147888183594,9571.731338500977,1,8,0,34,15605,2
100111,Furniture,165.239013671875,2022-08-24,82,0,174.03147888183594,14270.581268310547,2,8,0,34,15687,2
100111,Furniture,165.239013671875,2022-08-25,133,394,209.91224884033204,113708.18819152832,3,8,0,34,15820,2
100111,Furniture,165.239013671875,2022-08-26,190,0,198.09449768066406,37637.95455932617,4,8,0,34,16010,2
100111,Furniture,165.239013671875,2022-08-27,74,0,198.09449768066406,14658.99282836914,5,8,1,34,16084,2
100111,Furniture,165.239013671875,2022-08-28,92,0,198.09449768066406,18224.693786621094,6,8,1,34,16176,2
100111,Furniture,165.239013671875,2022-08-29,72,0,198.09449768066406,14262.803833007812,0,8,0,35,16248,2
100111,Furniture,165.239013671875,2022-08-30,98,215,192.8761898803711,60163.603216552736,1,8,0,35,16346,2
100111,Furniture,165.239013671875,2022-08-31,42,0,194.6423797607422,8174.979949951172,2,8,0,35,16388,2
100111,Furniture,165.239013671875,2022-09-01,68,0,194.6423797607422,13235.681823730469,3,9,0,35,16456,2
100111,Furniture,165.239013671875,2022-09-02,51,0,194.6423797607422,9926.761367797852,4,9,0,35,16507,2
100111,Furniture,165.239013671875,2022-09-03,84,179,166.5943115234375,42936.094335937494,5,9,1,35,16591,2
100111,Furniture,165.239013671875,2022-09-04,74,0,175.838623046875,13012.05810546875,6,9,1,35,16665,2
100111,Furniture,165.239013671875,2022-09-05,57,134,144.202734375,26510.71171875,0,9,0,36,16722,2
100111,Furniture,165.239013671875,2022-09-06,140,284,154.78712707519531,65497.67558105469,1,9,0,36,16862,2
100111,Furniture,165.239013671875,2022-09-07,86,0,155.70425415039062,13390.565856933594,2,9,0,36,16948,2
100111,Furniture,165.239013671875,2022-09-08,102,0,155.70425415039062,15881.833923339844,3,9,0,36,17050,2
100111,Furniture,165.239013671875,2022-09-09,80,252,143.13011810302734,46841.49889648437,4,9,0,36,17130,2
100111,Furniture,165.239013671875,2022-09-10,19,0,147.0702362060547,2794.334487915039,5,9,1,36,17149,2
100111,Furniture,165.239013671875,2022-09-11,63,0,147.0702362060547,9265.424880981445,6,9,1,36,17212,2
100111,Furniture,165.239013671875,2022-09-12,47,0,147.0702362060547,6912.30110168457,0,9,0,37,17259,2
100111,Furniture,165.239013671875,2022-09-13,46,0,147.0702362060547,6765.230865478516,1,9,0,37,17305,2
100111,Furniture,165.239013671875,2022-09-14,96,210,159.98785186767577,49472.947558593754,2,9,0,37,17401,2
100111,Furniture,165.239013671875,2022-09-15,86,0,155.45570373535156,13369.190521240234,3,9,0,37,17487,2
100111,Furniture,165.239013671875,2022-09-16,61,0,155.45570373535156,9482.797927856445,4,9,0,37,17548,2
100111,Furniture,165.239013671875,2022-09-17,128,250,176.59949005126953,67475.689453125,5,9,1,37,17676,2
100111,Furniture,165.239013671875,2022-09-18,66,0,170.68898010253906,11265.472686767578,6,9,1,37,17742,2
100111,Furniture,165.239013671875,2022-09-19,108,231,170.7859536743164,57900.62599365234,0,9,0,38,17850,2
100111,Furniture,165.239013671875,2022-09-20,21,0,170.7519073486328,3585.790054321289,1,9,0,38,17871,2
100111,Furniture,165.239013671875,2022-09-21,30,0,170.7519073486328,5122.557220458984,2,9,0,38,17901,2
100111,Furniture,165.239013671875,2022-09-22,36,0,170.7519073486328,6147.068664550781,3,9,0,38,17937,2
100111,Furniture,165.239013671875,2022-09-23,101,215,182.4194860839844,58175.85618896485,4,9,0,38,18038,2
100111,Furniture,165.239013671875,2022-09-24,110,0,177.75897216796875,19553.486938476562,5,9,1,38,18148,2
100111,Furniture,165.239013671875,2022-09-25,79,0,177.75897216796875,14042.958801269531,6,9,1,38,18227,2
100111,Furniture,165.239013671875,2022-09-26,82,202,165.27360260009766,46423.67082641602,0,9,0,39,18309,2
100111,Furniture,165.239013671875,2022-09-27,64,0,169.5572052001953,10851.6611328125,1,9,0,39,18373,2
100111,Furniture,165.239013671875,2022-09-28,59,0,169.5572052001953,10003.875106811523,2,9,0,39,18432,2
100111,Furniture,165.239013671875,2022-09-29,61,0,169.5572052001953,10342.989517211914,3,9,0,39,18493,2
100111,Furniture,165.239013671875,2022-09-30,27,76,150.4458755493164,15035.527279663087,4,9,0,39,18520,2
100111,Furniture,165.239013671875,2022-10-01,96,167,158.56292144775392,41668.47091796875,5,10,1,39,18616,2
100111,Furniture,165.239013671875,2022-10-02,70,0,159.0358428955078,11132.509002685547,6,10,1,39,18686,2
100111,Furniture,165.239013671875,2022-10-03,113,177,149.5510998535156,43152.78856689453,0,10,0,40,18799,2
100111,Furniture,165.239013671875,2022-10-04,56,0,152.94219970703125,8564.76318359375,1,10,0,40,18855,2
100111,Furniture,165.239013671875,2022-10-05,44,0,152.94219970703125,6729.456787109375,2,10,0,40,18899,2
100111,Furniture,165.239013671875,2022-10-06,44,162,164.33729797363281,34299.84222167969,3,10,0,40,18943,2
100111,Furniture,165.239013671875,2022-10-07,96,0,160.55459594726562,15413.2412109375,4,10,0,40,19039,2
100111,Furniture,165.239013671875,2022-10-08,72,162,156.66421783447265,36533.04736816406,5,10,1,40,19111,2
100111,Furniture,165.239013671875,2022-10-09,48,0,158.0684356689453,7587.284912109375,6,10,1,40,19159,2
100111,Furniture,165.239013671875,2022-10-10,73,194,160.52743133544922,42970.034974975584,0,10,0,41,19232,2
100111,Furniture,165.239013671875,2022-10-11,82,0,159.62486267089844,13089.238739013672,1,10,0,41,19314,2
100111,Furniture,165.239013671875,2022-10-12,88,218,157.85681030273437,48217.49861328125,2,10,0,41,19402,2
100111,Furniture,165.239013671875,2022-10-13,111,0,158.52362060546875,17596.12188720703,3,10,0,41,19513,2
100111,Furniture,165.239013671875,2022-10-14,76,0,158.52362060546875,12047.795166015625,4,10,0,41,19589,2
100111,Furniture,165.239013671875,2022-10-15,72,156,162.02392669677732,37058.725444335934,5,10,1,41,19661,2
100111,Furniture,165.239013671875,2022-10-16,28,0,160.6278533935547,4497.579895019531,6,10,1,41,19689,2
100111,Furniture,165.239013671875,2022-10-17,36,0,160.6278533935547,5782.602722167969,0,10,0,42,19725,2
100111,Furniture,165.239013671875,2022-10-18,67,214,162.78307403564452,45851.841920776365,1,10,0,42,19792,2
100111,Furniture,165.239013671875,2022-10-19,57,0,162.03614807128906,9236.060440063477,2,10,0,42,19849,2
100111,Furniture,165.239013671875,2022-10-20,58,0,162.03614807128906,9398.096588134766,3,10,0,42,19907,2
100111,Furniture,165.239013671875,2022-10-21,84,249,154.2231430053711,50915.23802490235,4,10,0,42,19991,2
100111,Furniture,165.239013671875,2022-10-22,65,0,156.8962860107422,10198.258590698242,5,10,1,42,20056,2
100111,Furniture,165.239013671875,2022-10-23,125,232,184.35309509277346,67095.58377319336,6,10,1,42,20181,2
100111,Furniture,165.239013671875,2022-10-24,101,0,172.37619018554688,17409.995208740234,0,10,0,43,20282,2
100111,Furniture,165.239013671875,2022-10-25,46,0,172.37619018554688,7929.304748535156,1,10,0,43,20328,2
100111,Furniture,165.239013671875,2022-10-26,81,0,172.37619018554688,13962.471405029297,2,10,0,43,20409,2
100111,Furniture,165.239013671875,2022-10-27,94,164,163.3045703125,41865.55921875,3,10,0,43,20503,2
100111,Furniture,165.239013671875,2022-10-28,110,273,180.5103778076172,69922.70311767579,4,10,0,43,20613,2
100111,Furniture,165.239013671875,2022-10-29,69,0,175.68075561523438,12121.972137451172,5,10,1,43,20682,2
100111,Furniture,165.239013671875,2022-10-30,64,0,175.68075561523438,11243.568359375,6,10,1,43,20746,2
100111,Furniture,165.239013671875,2022-10-31,68,0,175.68075561523438,11946.291381835938,0,10,0,44,20814,2
100111,Furniture,165.239013671875,2022-11-01,62,0,175.68075561523438,10892.206848144531,1,11,0,44,20876,2
100111,Furniture,165.239013671875,2022-11-02,30,0,175.68075561523438,5270.422668457031,2,11,0,44,20906,2
100111,Furniture,165.239013671875,2022-11-03,85,140,164.60467376708985,36799.29454040527,3,11,0,44,20991,2
100111,Furniture,165.239013671875,2022-11-04,93,180,169.19698455810547,46200.60912780762,4,11,0,44,21084,2
100111,Furniture,165.239013671875,2022-11-05,20,0,169.08396911621094,3381.6793823242188,5,11,1,44,21104,2
100111,Furniture,165.239013671875,2022-11-06,61,0,169.08396911621094,10314.122116088867,6,11,1,44,21165,2
100111,Furniture,165.239013671875,2022-11-07,47,0,169.08396911621094,7946.946548461914,0,11,0,45,21212,2
100111,Furniture,165.239013671875,2022-11-08,60,103,132.50576751708985,20839.672102050783,1,11,0,45,21272,2
100111,Furniture,165.239013671875,2022-11-09,88,190,152.2848327636719,42418.33056640625,2,11,0,45,21360,2
100111,Furniture,165.239013671875,2022-11-10,41,0,151.46966552734375,6210.256286621094,3,11,0,45,21401,2
100111,Furniture,165.239013671875,2022-11-11,106,223,163.77938720703125,54457.96008789063,4,11,0,45,21507,2
100111,Furniture,165.239013671875,2022-11-12,105,0,158.8687744140625,16681.221313476562,5,11,1,45,21612,2
100111,Furniture,165.239013671875,2022-11-13,72,0,158.8687744140625,11438.5517578125,6,11,1,45,21684,2
100111,Furniture,165.239013671875,2022-11-14,93,228,174.5739096069336,56761.29718688965,0,11,0,46,21777,2
100111,Furniture,165.239013671875,2022-11-15,35,0,169.2178192138672,5922.623672485352,1,11,0,46,21812,2
100111,Furniture,165.239013671875,2022-11-16,48,0,169.2178192138672,8122.455322265625,2,11,0,46,21860,2
100111,Furniture,165.239013671875,2022-11-17,44,0,169.2178192138672,7445.584045410156,3,11,0,46,21904,2
100111,Furniture,165.239013671875,2022-11-18,37,0,169.2178192138672,6261.059310913086,4,11,0,46,21941,2
100111,Furniture,165.239013671875,2022-11-19,84,138,156.7593469238281,34512.250283203124,5,11,1,46,22025,2
100111,Furniture,165.239013671875,2022-11-20,45,0,162.09869384765625,7294.441223144531,6,11,1,46,22070,2
100111,Furniture,165.239013671875,2022-11-21,95,199,168.5799481201172,49799.630142822265,0,11,0,47,22165,2
100111,Furniture,165.239013671875,2022-11-22,58,0,166.29989624023438,9645.393981933594,1,11,0,47,22223,2
100111,Furniture,165.239013671875,2022-11-23,58,0,166.29989624023438,9645.393981933594,2,11,0,47,22281,2
100111,Furniture,165.239013671875,2022-11-24,56,137,151.87586151123048,28813.416489257812,3,11,0,47,22337,2
100111,Furniture,165.239013671875,2022-11-25,64,0,158.03172302246094,10114.0302734375,4,11,0,47,22401,2
100111,Furniture,165.239013671875,2022-11-26,131,219,144.26632232666014,50086.97644958497,5,11,1,47,22532,2
100111,Furniture,165.239013671875,2022-11-27,39,0,148.8826446533203,5806.423141479492,6,11,1,47,22571,2
100111,Furniture,165.239013671875,2022-11-28,54,0,148.8826446533203,8039.662811279297,0,11,0,48,22625,2
100111,Furniture,165.239013671875,2022-11-29,58,0,148.8826446533203,8635.193389892578,1,11,0,48,22683,2
100111,Furniture,165.239013671875,2022-11-30,64,146,155.37904174804686,32816.63734375,2,11,0,48,22747,2
100111,Furniture,165.239013671875,2022-12-01,52,0,153.09808349609375,7961.100341796875,3,12,0,48,22799,2
100111,Furniture,165.239013671875,2022-12-02,47,109,148.3695639038086,23009.89900695801,4,12,0,48,22846,2
100111,Furniture,165.239013671875,2022-12-03,90,202,146.06712799072267,42459.283038330075,5,12,1,48,22936,2
100111,Furniture,165.239013671875,2022-12-04,81,0,147.7842559814453,11970.52473449707,6,12,1,48,23017,2
100111,Furniture,165.239013671875,2022-12-05,115,277,151.13304412841796,59426.72014953613,0,12,0,49,23132,2
100111,Furniture,165.239013671875,2022-12-06,142,0,150.00608825683594,21300.864532470703,1,12,0,49,23274,2
100111,Furniture,165.239013671875,2022-12-07,49,0,150.00608825683594,7350.298324584961,2,12,0,49,23323,2
100111,Furniture,165.239013671875,2022-12-08,127,257,175.05076171874998,68290.5934765625,3,12,0,49,23450,2
100111,Furniture,165.239013671875,2022-12-09,121,0,166.8115234375,20184.1943359375,4,12,0,49,23571,2
100111,Furniture,165.239013671875,2022-12-10,88,199,168.0138217163086,48272.822622070315,5,12,1,49,23659,2
100111,Furniture,165.239013671875,2022-12-11,84,0,167.5376434326172,14073.162048339844,6,12,1,49,23743,2
100111,Furniture,165.239013671875,2022-12-12,51,0,167.5376434326172,8544.419815063477,0,12,0,50,23794,2
100111,Furniture,165.239013671875,2022-12-13,70,131,168.97657592773436,34005.98062988281,1,12,0,50,23864,2
100111,Furniture,165.239013671875,2022-12-14,152,285,166.45951751708986,72659.08332519532,2,12,0,50,24016,2
100111,Furniture,165.239013671875,2022-12-15,119,0,167.0890350341797,19883.595169067383,3,12,0,50,24135,2
100111,Furniture,165.239013671875,2022-12-16,119,0,167.0890350341797,19883.595169067383,4,12,0,50,24254,2
100111,Furniture,165.239013671875,2022-12-17,58,173,163.5847692871094,37643.78323730469,5,12,1,50,24312,2
100111,Furniture,165.239013671875,2022-12-18,74,0,164.83953857421875,12198.125854492188,6,12,1,50,24386,2
100111,Furniture,165.239013671875,2022-12-19,50,0,164.83953857421875,8241.976928710938,0,12,0,51,24436,2
100111,Furniture,165.239013671875,2022-12-20,70,122,157.07711517333985,29985.27612426758,1,12,0,51,24506,2
100111,Furniture,165.239013671875,2022-12-21,65,141,161.0639797973633,33201.67737365723,2,12,0,51,24571,2
100111,Furniture,165.239013671875,2022-12-22,130,203,164.275732421875,54815.0904296875,3,12,0,51,24701,2
100111,Furniture,165.239013671875,2022-12-23,80,0,162.75146484375,13020.1171875,4,12,0,51,24781,2
100111,Furniture,165.239013671875,2022-12-24,68,0,162.75146484375,11067.099609375,5,12,1,51,24849,2
100111,Furniture,165.239013671875,2022-12-25,129,211,154.58643646240233,52318.600607299806,6,12,1,51,24978,2
100111,Furniture,165.239013671875,2022-12-26,85,0,157.5228729248047,13389.444198608398,0,12,0,52,25063,2
100111,Furniture,165.239013671875,2022-12-27,44,0,157.5228729248047,6931.006408691406,1,12,0,52,25107,2
100111,Furniture,165.239013671875,2022-12-28,87,230,152.75398223876954,48223.6729095459,2,12,0,52,25194,2
100111,Furniture,165.239013671875,2022-12-29,76,0,154.14796447753906,11715.245300292969,3,12,0,52,25270,2
100111,Furniture,165.239013671875,2022-12-30,95,161,171.55400146484374,44427.740278320314,4,12,0,52,25365,2
100111,Furniture,165.239013671875,2022-12-31,97,0,163.8280029296875,15891.316284179688,5,12,1,52,25462,2
100111,Furniture,165.239013671875,2023-01-01,89,163,174.63527801513672,44335.519486694335,6,1,1,52,25551,2
100111,Furniture,165.239013671875,2023-01-02,81,0,170.21055603027344,13787.055038452148,0,1,0,1,25632,2
100111,Furniture,165.239013671875,2023-01-03,68,0,170.21055603027344,11574.317810058594,1,1,0,1,25700,2
100111,Furniture,165.239013671875,2023-01-04,127,265,145.7366650390625,56379.89291992188,2,1,0,1,25827,2
100111,Furniture,165.239013671875,2023-01-05,24,0,151.163330078125,3627.919921875,3,1,0,1,25851,2
100111,Furniture,165.239013671875,2023-01-06,52,0,151.163330078125,7860.4931640625,4,1,0,1,25903,2
100111,Furniture,165.239013671875,2023-01-07,49,0,151.163330078125,7407.003173828125,5,1,1,1,25952,2
100111,Furniture,165.239013671875,2023-01-08,85,161,150.7122280883789,37063.63877502442,6,1,1,1,26037,2
100111,Furniture,165.239013671875,2023-01-09,60,132,160.02014678955078,31037.777614746094,0,1,0,2,26097,2
100111,Furniture,165.239013671875,2023-01-10,95,269,170.98494689941407,63217.279910888676,1,1,0,2,26192,2
100111,Furniture,165.239013671875,2023-01-11,51,0,165.35989379882812,8433.354583740234,2,1,0,2,26243,2
100111,Furniture,165.239013671875,2023-01-12,90,0,165.35989379882812,14882.390441894531,3,1,0,2,26333,2
100111,Furniture,165.239013671875,2023-01-13,96,0,165.35989379882812,15874.5498046875,4,1,0,2,26429,2
100111,Furniture,165.239013671875,2023-01-14,80,188,159.78931823730468,42583.85091796875,5,1,1,2,26509,2
100111,Furniture,165.239013671875,2023-01-15,98,0,162.00863647460938,15876.846374511719,6,1,1,2,26607,2
100111,Furniture,165.239013671875,2023-01-16,120,193,167.8317346191406,52702.02630859375,0,1,0,3,26727,2
100111,Furniture,165.239013671875,2023-01-17,118,358,175.42405334472656,84256.87658935547,1,1,0,3,26845,2
100111,Furniture,165.239013671875,2023-01-18,65,0,172.27810668945312,11198.076934814453,2,1,0,3,26910,2
100111,Furniture,165.239013671875,2023-01-19,54,0,172.27810668945312,9303.017761230469,3,1,0,3,26964,2
100111,Furniture,165.239013671875,2023-01-20,91,0,172.27810668945312,15677.307708740234,4,1,0,3,27055,2
100111,Furniture,165.239013671875,2023-01-21,76,0,172.27810668945312,13093.136108398438,5,1,1,3,27131,2
100111,Furniture,165.239013671875,2023-01-22,27,0,172.27810668945312,4651.508880615234,6,1,1,3,27158,2
100111,Furniture,165.239013671875,2023-01-23,48,0,172.27810668945312,8269.34912109375,0,1,0,4,27206,2
100111,Furniture,165.239013671875,2023-01-24,81,166,157.85468292236328,38513.70863342285,1,1,0,4,27287,2
100111,Furniture,165.239013671875,2023-01-25,53,0,163.45936584472656,8663.346389770508,2,1,0,4,27340,2
100111,Furniture,165.239013671875,2023-01-26,97,140,154.84327117919923,36525.714608764654,3,1,0,4,27437,2
100111,Furniture,165.239013671875,2023-01-27,78,181,156.40679840087893,40398.45055053711,4,1,0,4,27515,2
100111,Furniture,165.239013671875,2023-01-28,72,0,157.4835968017578,11338.818969726562,5,1,1,4,27587,2
100111,Furniture,165.239013671875,2023-01-29,15,0,157.4835968017578,2362.253952026367,6,1,1,4,27602,2
100111,Furniture,165.239013671875,2023-01-30,29,0,157.4835968017578,4567.024307250977,0,1,0,5,27631,2
100111,Furniture,165.239013671875,2023-01-31,21,0,157.4835968017578,3307.155532836914,1,1,0,5,27652,2
100111,Furniture,165.239013671875,2023-02-01,35,0,157.4835968017578,5511.925888061523,2,2,0,5,27687,2
100111,Furniture,165.239013671875,2023-02-02,24,0,157.4835968017578,3779.6063232421875,3,2,0,5,27711,2
100111,Furniture,165.239013671875,2023-02-03,20,0,157.4835968017578,3149.6719360351562,4,2,0,5,27731,2
100111,Furniture,165.239013671875,2023-02-04,39,73,148.6763488769531,16489.355212402344,5,2,1,5,27770,2
100111,Furniture,165.239013671875,2023-02-05,37,0,153.45269775390625,5677.749816894531,6,2,1,5,27807,2
100111,Furniture,165.239013671875,2023-02-06,20,0,153.45269775390625,3069.053955078125,0,2,0,6,27827,2
100111,Furniture,165.239013671875,2023-02-07,46,91,147.05191619873045,20015.9762902832,1,2,0,6,27873,2
100111,Furniture,165.239013671875,2023-02-08,19,0,149.94383239746094,2848.932815551758,2,2,0,6,27892,2
100111,Furniture,165.239013671875,2023-02-09,42,94,124.9668048095703,16367.491604003906,3,2,0,6,27934,2
100111,Furniture,165.239013671875,2023-02-10,39,0,137.04360961914062,5344.700775146484,4,2,0,6,27973,2
100111,Furniture,165.239013671875,2023-02-11,23,0,137.04360961914062,3152.0030212402344,5,2,1,6,27996,2
100111,Furniture,165.239013671875,2023-02-12,19,0,137.04360961914062,2603.828582763672,6,2,1,6,28015,2
100111,Furniture,165.239013671875,2023-02-13,29,0,137.04360961914062,3974.264678955078,0,2,0,7,28044,2
100111,Furniture,165.239013671875,2023-02-14,20,50,131.87674621582033,9147.469848632812,1,2,0,7,28064,2
100111,Furniture,165.239013671875,2023-02-15,34,60,140.14076049804686,13251.731713867188,2,2,0,7,28098,2
100111,Furniture,165.239013671875,2023-02-16,38,98,121.34107299804688,16057.121547851562,3,2,0,7,28136,2
100111,Furniture,165.239013671875,2023-02-17,13,0,128.76214599609375,1673.9078979492188,4,2,0,7,28149,2
100111,Furniture,165.239013671875,2023-02-18,24,0,128.76214599609375,3090.29150390625,5,2,1,7,28173,2
100111,Furniture,165.239013671875,2023-02-19,18,0,128.76214599609375,2317.7186279296875,6,2,1,7,28191,2
100111,Furniture,165.239013671875,2023-02-20,38,0,128.76214599609375,4892.9615478515625,0,2,0,8,28229,2
100111,Furniture,165.239013671875,2023-02-21,20,0,128.76214599609375,2575.242919921875,1,2,0,8,28249,2
100111,Furniture,165.239013671875,2023-02-22,27,78,128.02987335205077,13426.823161010741,2,2,0,8,28276,2
100111,Furniture,165.239013671875,2023-02-23,27,0,128.34974670410156,3465.443161010742,3,2,0,8,28303,2
100111,Furniture,165.239013671875,2023-02-24,34,72,133.95678497314452,14306.321378173829,4,2,0,8,28337,2
100111,Furniture,165.239013671875,2023-02-25,26,0,131.14356994628906,3409.7328186035156,5,2,1,8,28363,2
100111,Furniture,165.239013671875,2023-02-26,15,0,131.14356994628906,1967.153549194336,6,2,1,8,28378,2
100111,Furniture,165.239013671875,2023-02-27,30,69,131.9772216796875,13082.23330078125,0,2,0,9,28408,2
100111,Furniture,165.239013671875,2023-02-28,16,0,131.554443359375,2104.87109375,1,2,0,9,28424,2
100111,Furniture,165.239013671875,2023-03-01,66,163,153.93802307128908,35981.43904541015,2,3,0,9,28490,2
100111,Furniture,165.239013671875,2023-03-02,99,177,169.04524322509764,47407.21815856933,3,3,0,9,28589,2
100111,Furniture,165.239013671875,2023-03-03,81,0,159.4204864501953,12913.05940246582,4,3,0,9,28670,2
100111,Furniture,165.239013671875,2023-03-04,48,0,159.4204864501953,7652.183349609375,5,3,1,9,28718,2
100111,Furniture,165.239013671875,2023-03-05,96,177,160.44674591064455,43833.00521484375,6,3,1,9,28814,2
100111,Furniture,165.239013671875,2023-03-06,115,251,154.6067626953125,56313.15541992187,0,3,0,10,28929,2
100111,Furniture,165.239013671875,2023-03-07,90,0,156.613525390625,14095.21728515625,1,3,0,10,29019,2
100111,Furniture,165.239013671875,2023-03-08,105,0,156.613525390625,16444.420166015625,2,3,0,10,29124,2
100111,Furniture,165.239013671875,2023-03-09,86,191,156.63272888183593,43388.02936767578,3,3,0,10,29210,2
100111,Furniture,165.239013671875,2023-03-10,143,248,185.16401123046876,73613.55721191407,4,3,0,10,29353,2
100111,Furniture,165.239013671875,2023-03-11,62,0,173.5980224609375,10763.077392578125,5,3,1,10,29415,2
100111,Furniture,165.239013671875,2023-03-12,103,0,173.5980224609375,17880.596313476562,6,3,1,10,29518,2
100111,Furniture,165.239013671875,2023-03-13,68,0,173.5980224609375,11804.66552734375,0,3,0,11,29586,2
100111,Furniture,165.239013671875,2023-03-14,59,123,156.41378784179688,27960.82696533203,1,3,0,11,29645,2
100111,Furniture,165.239013671875,2023-03-15,47,0,164.32757568359375,7723.396057128906,2,3,0,11,29692,2
100111,Furniture,165.239013671875,2023-03-16,165,246,178.9602346801758,73926.857444458,3,3,0,11,29857,2
100111,Furniture,165.239013671875,2023-03-17,32,0,174.34046936035156,5578.89501953125,4,3,0,11,29889,2
100111,Furniture,165.239013671875,2023-03-18,100,270,162.7801156616211,59563.92313232422,5,3,1,11,29989,2
100111,Furniture,165.239013671875,2023-03-19,138,0,166.6902313232422,23003.251922607422,6,3,1,11,30127,2
100111,Furniture,165.239013671875,2023-03-20,96,277,148.60279876708984,54259.07736328125,0,3,0,12,30223,2
100111,Furniture,165.239013671875,2023-03-21,42,0,155.0655975341797,6512.755096435547,1,3,0,12,30265,2
100111,Furniture,165.239013671875,2023-03-22,102,0,155.0655975341797,15816.690948486328,2,3,0,12,30367,2
100111,Furniture,165.239013671875,2023-03-23,70,0,155.0655975341797,10854.591827392578,3,3,0,12,30437,2
100111,Furniture,165.239013671875,2023-03-24,91,0,155.0655975341797,14110.969375610352,4,3,0,12,30528,2
100111,Furniture,165.239013671875,2023-03-25,90,283,161.70189575195315,60629.03123535157,5,3,1,12,30618,2
100111,Furniture,165.239013671875,2023-03-26,94,0,160.07379150390625,15046.936401367188,6,3,1,12,30712,2
100111,Furniture,165.239013671875,2023-03-27,54,0,160.07379150390625,8643.984741210938,0,3,0,13,30766,2
100111,Furniture,165.239013671875,2023-03-28,50,0,160.07379150390625,8003.6895751953125,1,3,0,13,30816,2
100111,Furniture,165.239013671875,2023-03-29,58,83,152.249541015625,21365.6967578125,2,3,0,13,30874,2
100111,Furniture,165.239013671875,2023-03-30,73,139,144.91316406250002,30403.261953125002,3,3,0,13,30947,2
100111,Furniture,165.239013671875,2023-03-31,48,0,149.736328125,7187.34375,4,3,0,13,30995,2
100111,Furniture,165.239013671875,2023-04-01,27,0,149.736328125,4042.880859375,5,4,1,13,31022,2
100111,Furniture,165.239013671875,2023-04-02,94,268,147.2525653076172,53190.142277832034,6,4,1,13,31116,2
100111,Furniture,165.239013671875,2023-04-03,50,0,147.91513061523438,7395.756530761719,0,4,0,14,31166,2
100111,Furniture,165.239013671875,2023-04-04,76,0,147.91513061523438,11241.549926757812,1,4,0,14,31242,2
100111,Furniture,165.239013671875,2023-04-05,58,0,147.91513061523438,8579.077575683594,2,4,0,14,31300,2
100111,Furniture,165.239013671875,2023-04-06,42,0,147.91513061523438,6212.435485839844,3,4,0,14,31342,2
100111,Furniture,165.239013671875,2023-04-07,61,119,145.10479583740235,26057.685092163087,4,4,0,14,31403,2
100111,Furniture,165.239013671875,2023-04-08,43,0,146.1595916748047,6284.862442016602,5,4,1,14,31446,2
100111,Furniture,165.239013671875,2023-04-09,57,135,141.8141522216797,27103.193353271487,6,4,1,14,31503,2
100111,Furniture,165.239013671875,2023-04-10,88,132,128.2767919921875,27906.435390625,0,4,0,15,31591,2
100111,Furniture,165.239013671875,2023-04-11,79,0,135.423583984375,10698.463134765625,1,4,0,15,31670,2
100111,Furniture,165.239013671875,2023-04-12,49,0,135.423583984375,6635.755615234375,2,4,0,15,31719,2
100111,Furniture,165.239013671875,2023-04-13,42,75,139.73833282470702,16421.04995727539,3,4,0,15,31761,2
100111,Furniture,165.239013671875,2023-04-14,29,83,133.60045135498046,14850.366178588867,4,4,0,15,31790,2
100111,Furniture,165.239013671875,2023-04-15,18,0,135.69090270996094,2442.436248779297,5,4,1,15,31808,2
100111,Furniture,165.239013671875,2023-04-16,18,0,135.69090270996094,2442.436248779297,6,4,1,15,31826,2
100111,Furniture,165.239013671875,2023-04-17,35,0,135.69090270996094,4749.181594848633,0,4,0,16,31861,2
100111,Furniture,165.239013671875,2023-04-18,53,102,132.3767218017578,20445.05251098633,1,4,0,16,31914,2
100111,Furniture,165.239013671875,2023-04-19,13,0,133.87344360351562,1740.3547668457031,2,4,0,16,31927,2
100111,Furniture,165.239013671875,2023-04-20,37,0,133.87344360351562,4953.317413330078,3,4,0,16,31964,2
100111,Furniture,165.239013671875,2023-04-21,51,78,121.93994689941405,15563.664583740234,4,4,0,16,32015,2
100111,Furniture,165.239013671875,2023-04-22,40,0,128.10989379882812,5124.395751953125,5,4,1,16,32055,2
100111,Furniture,165.239013671875,2023-04-23,30,71,126.16294403076172,12700.926641845703,6,4,1,16,32085,2
100111,Furniture,165.239013671875,2023-04-24,51,0,127.17588806152344,6485.970291137695,0,4,0,17,32136,2
100111,Furniture,165.239013671875,2023-04-25,28,50,131.8257943725586,10342.784484863281,1,4,0,17,32164,2
100111,Furniture,165.239013671875,2023-04-26,46,95,139.46724822998047,19902.176837158204,2,4,0,17,32210,2
100111,Furniture,165.239013671875,2023-04-27,19,0,134.62449645996094,2557.865432739258,3,4,0,17,32229,2
100111,Furniture,165.239013671875,2023-04-28,22,0,134.62449645996094,2961.7389221191406,4,4,0,17,32251,2
100111,Furniture,165.239013671875,2023-04-29,30,0,134.62449645996094,4038.734893798828,5,4,1,17,32281,2
100111,Furniture,165.239013671875,2023-04-30,32,101,137.44581085205078,18361.311894531253,6,4,1,17,32313,2
100111,Furniture,165.239013671875,2023-05-01,45,0,136.27162170410156,6132.22297668457,0,5,0,18,32358,2
100111,Furniture,165.239013671875,2023-05-02,25,82,125.49382354736329,13116.971177368165,1,5,0,18,32383,2
100111,Furniture,165.239013671875,2023-05-03,21,0,130.94764709472656,2749.900588989258,2,5,0,18,32404,2
100111,Furniture,165.239013671875,2023-05-04,72,131,142.85662475585937,29307.48396484375,3,5,0,18,32476,2
100111,Furniture,165.239013671875,2023-05-05,38,0,137.64324951171875,5230.4434814453125,4,5,0,18,32514,2
100111,Furniture,165.239013671875,2023-05-06,65,0,137.64324951171875,8946.811218261719,5,5,1,18,32579,2
100111,Furniture,165.239013671875,2023-05-07,33,0,137.64324951171875,4542.227233886719,6,5,1,18,32612,2
100111,Furniture,165.239013671875,2023-05-08,36,92,120.54304244995117,15038.459056396485,0,5,0,19,32648,2
100111,Furniture,165.239013671875,2023-05-09,4,0,127.52608489990234,510.1043395996094,1,5,0,19,32652,2
100111,Furniture,165.239013671875,2023-05-10,16,0,127.52608489990234,2040.4173583984375,2,5,0,19,32668,2
100111,Furniture,165.239013671875,2023-05-11,12,0,127.52608489990234,1530.3130187988281,3,5,0,19,32680,2
100111,Furniture,165.239013671875,2023-05-12,46,81,142.7065283203125,18380.05060546875,4,5,0,19,32726,2
100111,Furniture,165.239013671875,2023-05-13,59,174,155.62087341308592,37070.31306274414,5,5,1,19,32785,2
100111,Furniture,165.239013671875,2023-05-14,51,0,148.57174682617188,7577.159088134766,6,5,1,19,32836,2
100111,Furniture,165.239013671875,2023-05-15,75,249,168.10987884521484,55603.84182678222,0,5,0,20,32911,2
100111,Furniture,165.239013671875,2023-05-16,141,0,161.5797576904297,22782.745834350586,1,5,0,20,33052,2
100111,Furniture,165.239013671875,2023-05-17,43,0,161.5797576904297,6947.929580688477,2,5,0,20,33095,2
100111,Furniture,165.239013671875,2023-05-18,11,0,161.5797576904297,1777.3773345947266,3,5,0,20,33106,2
100111,Furniture,165.239013671875,2023-05-19,20,0,161.5797576904297,3231.5951538085938,4,5,0,20,33126,2
100111,Furniture,165.239013671875,2023-05-20,96,238,153.51931884765625,50926.22921875,5,5,1,20,33222,2
100111,Furniture,165.239013671875,2023-05-21,67,0,155.9786376953125,10450.568725585938,6,5,1,20,33289,2
100111,Furniture,165.239013671875,2023-05-22,53,0,155.9786376953125,8266.867797851562,0,5,0,21,33342,2
100111,Furniture,165.239013671875,2023-05-23,62,164,160.45159759521485,36450.59810180664,1,5,0,21,33404,2
100111,Furniture,165.239013671875,2023-05-24,104,0,158.6031951904297,16494.732299804688,2,5,0,21,33508,2
100111,Furniture,165.239013671875,2023-05-25,41,0,158.6031951904297,6502.731002807617,3,5,0,21,33549,2
100111,Furniture,165.239013671875,2023-05-26,96,185,143.3418212890625,39821.4296875,4,5,0,21,33645,2
100111,Furniture,165.239013671875,2023-05-27,54,0,148.483642578125,8018.11669921875,5,5,1,21,33699,2
100111,Furniture,165.239013671875,2023-05-28,82,144,133.30426391601563,29716.059282226564,6,5,1,21,33781,2
100111,Furniture,165.239013671875,2023-05-29,66,0,139.92852783203125,9235.282836914062,0,5,0,22,33847,2
100111,Furniture,165.239013671875,2023-05-30,64,127,156.04707611083984,30275.1557421875,1,5,0,22,33911,2
100111,Furniture,165.239013671875,2023-05-31,46,0,148.5841522216797,6834.871002197266,2,5,0,22,33957,2
100111,Furniture,165.239013671875,2023-06-01,69,0,148.5841522216797,10252.306503295898,3,6,0,22,34026,2
100111,Furniture,165.239013671875,2023-06-02,67,109,142.129714050293,24897.24168273926,4,6,0,22,34093,2
100111,Furniture,165.239013671875,2023-06-03,100,235,149.73944793701173,50362.58958740234,5,6,1,22,34193,2
100111,Furniture,165.239013671875,2023-06-04,41,0,148.25889587402344,6078.614730834961,6,6,1,22,34234,2
100111,Furniture,165.239013671875,2023-06-05,40,0,148.25889587402344,5930.3558349609375,0,6,0,23,34274,2
100111,Furniture,165.239013671875,2023-06-06,98,227,153.3518670654297,50080.34594482422,1,6,0,23,34372,2
100111,Furniture,165.239013671875,2023-06-07,53,0,151.48373413085938,8028.637908935547,2,6,0,23,34425,2
100111,Furniture,165.239013671875,2023-06-08,64,0,151.48373413085938,9694.958984375,3,6,0,23,34489,2
100111,Furniture,165.239013671875,2023-06-09,99,245,179.4549740600586,63200.5448638916,4,6,0,23,34588,2
100111,Furniture,165.239013671875,2023-06-10,49,0,169.3999481201172,8300.597457885742,5,6,1,23,34637,2
100111,Furniture,165.239013671875,2023-06-11,86,0,169.3999481201172,14568.395538330078,6,6,1,23,34723,2
100111,Furniture,165.239013671875,2023-06-12,39,0,169.3999481201172,6606.59797668457,0,6,0,24,34762,2
100111,Furniture,165.239013671875,2023-06-13,50,0,169.3999481201172,8469.99740600586,1,6,0,24,34812,2
100111,Furniture,165.239013671875,2023-06-14,54,0,169.3999481201172,9147.597198486328,2,6,0,24,34866,2
100111,Furniture,165.239013671875,2023-06-15,43,93,152.38538848876954,20354.64341003418,3,6,0,24,34909,2
100111,Furniture,165.239013671875,2023-06-16,23,0,159.78077697753906,3674.9578704833984,4,6,0,24,34932,2
100111,Furniture,165.239013671875,2023-06-17,45,78,134.6730108642578,16132.710977783203,5,6,1,24,34977,2
100111,Furniture,165.239013671875,2023-06-18,25,0,147.76602172851562,3694.1505432128906,6,6,1,24,35002,2
100111,Furniture,165.239013671875,2023-06-19,98,166,137.73946105957032,36125.25436767578,0,6,0,25,35100,2
100111,Furniture,165.239013671875,2023-06-20,80,217,169.75418487548828,51830.25958007812,1,6,0,25,35180,2
100111,Furniture,165.239013671875,2023-06-21,93,0,159.43836975097656,14827.76838684082,2,6,0,25,35273,2
100111,Furniture,165.239013671875,2023-06-22,78,0,159.43836975097656,12436.192840576172,3,6,0,25,35351,2
100111,Furniture,165.239013671875,2023-06-23,72,115,145.96320343017578,27017.201293945312,4,6,0,25,35423,2
100111,Furniture,165.239013671875,2023-06-24,95,243,143.68735870361328,48121.23815368653,5,6,1,25,35518,2
100111,Furniture,165.239013671875,2023-06-25,85,0,146.69471740722656,12469.050979614258,6,6,1,25,35603,2
100111,Furniture,165.239013671875,2023-06-26,135,213,167.07084716796874,58819.96873535156,0,6,0,26,35738,2
100111,Furniture,165.239013671875,2023-06-27,47,0,158.3616943359375,7442.9996337890625,1,6,0,26,35785,2
100111,Furniture,165.239013671875,2023-06-28,50,0,158.3616943359375,7918.084716796875,2,6,0,26,35835,2
100111,Furniture,165.239013671875,2023-06-29,49,0,158.3616943359375,7759.7230224609375,3,6,0,26,35884,2
100111,Furniture,165.239013671875,2023-06-30,65,0,158.3616943359375,10293.510131835938,4,6,0,26,35949,2
100111,Furniture,165.239013671875,2023-07-01,75,164,159.02925659179687,38029.41848876953,5,7,1,26,36024,2
100111,Furniture,165.239013671875,2023-07-02,109,194,158.84614807128906,48132.410279541014,6,7,1,26,36133,2
100111,Furniture,165.239013671875,2023-07-03,165,296,193.60109161376954,90969.99023254393,0,7,0,27,36298,2
100111,Furniture,165.239013671875,2023-07-04,94,0,180.47218322753906,16964.385223388672,1,7,0,27,36392,2
100111,Furniture,165.239013671875,2023-07-05,81,0,180.47218322753906,14618.246841430664,2,7,0,27,36473,2
100111,Furniture,165.239013671875,2023-07-06,68,0,180.47218322753906,12272.108459472656,3,7,0,27,36541,2
100111,Furniture,165.239013671875,2023-07-07,51,0,180.47218322753906,9204.081344604492,4,7,0,27,36592,2
100111,Furniture,165.239013671875,2023-07-08,94,141,160.32229736328125,37287.411904296874,5,7,1,27,36686,2
100111,Furniture,165.239013671875,2023-07-09,102,249,185.4268356323242,65896.72446899413,6,7,1,27,36788,2
100111,Furniture,165.239013671875,2023-07-10,35,0,179.90367126464844,6296.628494262695,0,7,0,28,36823,2
100111,Furniture,165.239013671875,2023-07-11,69,0,179.90367126464844,12413.353317260742,1,7,0,28,36892,2
100111,Furniture,165.239013671875,2023-07-12,82,0,179.90367126464844,14752.101043701172,2,7,0,28,36974,2
100111,Furniture,165.239013671875,2023-07-13,66,191,141.08401123046875,34569.33948242187,3,7,0,28,37040,2
100111,Furniture,165.239013671875,2023-07-14,33,0,154.5980224609375,5101.7347412109375,4,7,0,28,37073,2
100111,Furniture,165.239013671875,2023-07-15,67,0,154.5980224609375,10358.067504882812,5,7,1,28,37140,2
100111,Furniture,165.239013671875,2023-07-16,107,154,155.8332440185547,40697.234219970705,6,7,1,28,37247,2
100111,Furniture,165.239013671875,2023-07-17,103,275,165.86273223876952,63302.802841186516,0,7,0,29,37350,2
100111,Furniture,165.239013671875,2023-07-18,71,0,162.33546447753906,11525.817977905273,1,7,0,29,37421,2
100111,Furniture,165.239013671875,2023-07-19,51,0,162.33546447753906,8279.108688354492,2,7,0,29,37472,2
100111,Furniture,165.239013671875,2023-07-20,118,0,162.33546447753906,19155.58480834961,3,7,0,29,37590,2
100111,Furniture,165.239013671875,2023-07-21,103,237,146.36941528320312,49113.099548339844,4,7,0,29,37693,2
100111,Furniture,165.239013671875,2023-07-22,54,0,151.23883056640625,8166.8968505859375,5,7,1,29,37747,2
100111,Furniture,165.239013671875,2023-07-23,101,265,160.5438882446289,59296.345425415035,6,7,1,29,37848,2
100111,Furniture,165.239013671875,2023-07-24,51,0,157.2677764892578,8020.656600952148,0,7,0,30,37899,2
100111,Furniture,165.239013671875,2023-07-25,33,0,157.2677764892578,5189.836624145508,1,7,0,30,37932,2
100111,Furniture,165.239013671875,2023-07-26,78,0,157.2677764892578,12266.88656616211,2,7,0,30,38010,2
100111,Furniture,165.239013671875,2023-07-27,137,270,179.44969329833984,74066.81596374512,3,7,0,30,38147,2
100111,Furniture,165.239013671875,2023-07-28,105,0,171.6993865966797,18028.435592651367,4,7,0,30,38252,2
100111,Furniture,165.239013671875,2023-07-29,80,0,171.6993865966797,13735.950927734375,5,7,1,30,38332,2
100111,Furniture,165.239013671875,2023-07-30,51,0,171.6993865966797,8756.668716430664,6,7,1,30,38383,2
100111,Furniture,165.239013671875,2023-07-31,46,160,163.85375640869142,33423.985589599615,0,7,0,31,38429,2
100111,Furniture,165.239013671875,2023-08-01,86,234,161.93406524658204,51540.059222412114,1,8,0,31,38515,2
100111,Furniture,165.239013671875,2023-08-02,69,0,163.81813049316406,11303.45100402832,2,8,0,31,38584,2
100111,Furniture,165.239013671875,2023-08-03,45,0,163.81813049316406,7371.815872192383,3,8,0,31,38629,2
100111,Furniture,165.239013671875,2023-08-04,75,0,163.81813049316406,12286.359786987305,4,8,0,31,38704,2
100111,Furniture,165.239013671875,2023-08-05,113,175,162.46622497558593,46754.54684448242,5,8,1,31,38817,2
100111,Furniture,165.239013671875,2023-08-06,86,0,163.04244995117188,14021.650695800781,6,8,1,31,38903,2
100111,Furniture,165.239013671875,2023-08-07,22,0,163.04244995117188,3586.9338989257812,0,8,0,32,38925,2
100111,Furniture,165.239013671875,2023-08-08,139,219,151.6795440673828,54002.913250732425,1,8,0,32,39064,2
100111,Furniture,165.239013671875,2023-08-09,64,0,155.40908813476562,9946.181640625,2,8,0,32,39128,2
100111,Furniture,165.239013671875,2023-08-10,103,212,150.57134490966797,47244.527051391604,3,8,0,32,39231,2
100111,Furniture,165.239013671875,2023-08-11,54,0,152.27268981933594,8222.72525024414,4,8,0,32,39285,2
100111,Furniture,165.239013671875,2023-08-12,143,230,183.1773910522461,69353.73384094238,5,8,1,32,39428,2
100111,Furniture,165.239013671875,2023-08-13,17,0,171.3547821044922,2913.031295776367,6,8,1,32,39445,2
100111,Furniture,165.239013671875,2023-08-14,139,0,171.3547821044922,23818.314712524414,0,8,0,33,39584,2
100111,Furniture,165.239013671875,2023-08-15,121,209,172.11947387695312,56822.352678222655,1,8,0,33,39705,2
100111,Furniture,165.239013671875,2023-08-16,73,0,171.85894775390625,12545.703186035156,2,8,0,33,39778,2
100111,Furniture,165.239013671875,2023-08-17,94,159,174.2034976196289,44137.60755249023,3,8,0,33,39872,2
100111,Furniture,165.239013671875,2023-08-18,90,0,173.2169952392578,15589.529571533203,4,8,0,33,39962,2
100111,Furniture,165.239013671875,2023-08-19,97,175,167.85619598388672,45501.96202087402,5,8,1,33,40059,2
100111,Furniture,165.239013671875,2023-08-20,109,310,166.46198577880858,69534.11289978027,6,8,1,33,40168,2
100111,Furniture,165.239013671875,2023-08-21,71,0,167.5239715576172,11894.20198059082,0,8,0,34,40239,2
100111,Furniture,165.239013671875,2023-08-22,136,0,167.5239715576172,22783.260131835938,1,8,0,34,40375,2
100111,Furniture,165.239013671875,2023-08-23,65,0,167.5239715576172,10889.058151245117,2,8,0,34,40440,2
100111,Furniture,165.239013671875,2023-08-24,124,220,165.05525970458984,56701.70440673828,3,8,0,34,40564,2
100111,Furniture,165.239013671875,2023-08-25,38,0,165.8605194091797,6302.699737548828,4,8,0,34,40602,2
100111,Furniture,165.239013671875,2023-08-26,67,0,165.8605194091797,11112.654800415039,5,8,1,34,40669,2
100111,Furniture,165.239013671875,2023-08-27,84,248,161.31476318359375,53339.240214843754,6,8,1,34,40753,2
100111,Furniture,165.239013671875,2023-08-28,80,0,162.6395263671875,13011.162109375,0,8,0,35,40833,2
100111,Furniture,165.239013671875,2023-08-29,61,0,162.6395263671875,9921.011108398438,1,8,0,35,40894,2
100111,Furniture,165.239013671875,2023-08-30,115,162,165.40902557373047,45871.92588195801,2,8,0,35,41009,2
100111,Furniture,165.239013671875,2023-08-31,89,0,164.26805114746094,14619.856552124023,3,8,0,35,41098,2
100111,Furniture,165.239013671875,2023-09-01,30,0,164.26805114746094,4928.041534423828,4,9,0,35,41128,2
100111,Furniture,165.239013671875,2023-09-02,71,261,157.8902166748047,52142.11076782227,5,9,1,35,41199,2
100111,Furniture,165.239013671875,2023-09-03,84,281,169.1880224609375,62490.7977734375,6,9,1,35,41283,2
100111,Furniture,165.239013671875,2023-09-04,68,0,165.446044921875,11250.3310546875,0,9,0,36,41351,2
100111,Furniture,165.239013671875,2023-09-05,114,0,165.446044921875,18860.84912109375,1,9,0,36,41465,2
100111,Furniture,165.239013671875,2023-09-06,106,0,165.446044921875,17537.28076171875,2,9,0,36,41571,2
100111,Furniture,165.239013671875,2023-09-07,110,216,166.90850219726562,54469.570483398435,3,9,0,36,41681,2
100111,Furniture,165.239013671875,2023-09-08,114,0,166.36700439453125,18965.838500976562,4,9,0,36,41795,2
100111,Furniture,165.239013671875,2023-09-09,46,0,166.36700439453125,7652.8822021484375,5,9,1,36,41841,2
100111,Furniture,165.239013671875,2023-09-10,63,150,149.01914123535158,31137.3717956543,6,9,1,36,41904,2
100111,Furniture,165.239013671875,2023-09-11,124,247,159.16251556396486,59194.123859863284,0,9,0,37,42028,2
100111,Furniture,165.239013671875,2023-09-12,113,0,157.9850311279297,17852.308517456055,1,9,0,37,42141,2
100111,Furniture,165.239013671875,2023-09-13,38,0,157.9850311279297,6003.431182861328,2,9,0,37,42179,2
100111,Furniture,165.239013671875,2023-09-14,90,0,157.9850311279297,14218.652801513672,3,9,0,37,42269,2
100111,Furniture,165.239013671875,2023-09-15,84,137,159.4435806274414,35266.521545410156,4,9,0,37,42353,2
100111,Furniture,165.239013671875,2023-09-16,77,245,159.29335113525389,51313.736074829096,5,9,1,37,42430,2
100111,Furniture,165.239013671875,2023-09-17,145,374,183.7985125732422,97324.52864624024,6,9,1,37,42575,2
100111,Furniture,165.239013671875,2023-09-18,37,0,175.35702514648438,6488.209930419922,0,9,0,38,42612,2
100111,Furniture,165.239013671875,2023-09-19,63,0,175.35702514648438,11047.492584228516,1,9,0,38,42675,2
100111,Furniture,165.239013671875,2023-09-20,77,0,175.35702514648438,13502.490936279297,2,9,0,38,42752,2
100111,Furniture,165.239013671875,2023-09-21,47,0,175.35702514648438,8241.780181884766,3,9,0,38,42799,2
100111,Furniture,165.239013671875,2023-09-22,76,0,175.35702514648438,13327.133911132812,4,9,0,38,42875,2
100111,Furniture,165.239013671875,2023-09-23,131,271,187.23077911376953,75882.66412780761,5,9,1,38,43006,2
100111,Furniture,165.239013671875,2023-09-24,83,0,182.83155822753906,15175.019332885742,6,9,1,38,43089,2
100111,Furniture,165.239013671875,2023-09-25,67,0,182.83155822753906,12249.714401245117,0,9,0,39,43156,2
100111,Furniture,165.239013671875,2023-09-26,101,0,182.83155822753906,18465.987380981445,1,9,0,39,43257,2
100111,Furniture,165.239013671875,2023-09-27,105,179,166.67674743652344,46896.87696166993,2,9,0,39,43362,2
100111,Furniture,165.239013671875,2023-09-28,103,0,172.61349487304688,17779.189971923828,3,9,0,39,43465,2
100111,Furniture,165.239013671875,2023-09-29,56,149,177.0973745727539,36461.44595214844,4,9,0,39,43521,2
100111,Furniture,165.239013671875,2023-09-30,103,157,180.88903411865235,47168.361028442385,5,9,1,39,43624,2
100111,Furniture,165.239013671875,2023-10-01,60,0,178.3480682373047,10700.884094238281,6,10,1,39,43684,2
100111,Furniture,165.239013671875,2023-10-02,50,0,178.3480682373047,8917.403411865234,0,10,0,40,43734,2
100111,Furniture,165.239013671875,2023-10-03,75,157,158.1227621459961,36008.57432189942,1,10,0,40,43809,2
100111,Furniture,165.239013671875,2023-10-04,118,215,168.8805142211914,56337.07135620117,2,10,0,40,43927,2
100111,Furniture,165.239013671875,2023-10-05,73,0,167.8510284423828,12253.125076293945,3,10,0,40,44000,2
100111,Furniture,165.239013671875,2023-10-06,77,0,167.8510284423828,12924.529190063477,4,10,0,40,44077,2
100111,Furniture,165.239013671875,2023-10-07,28,0,167.8510284423828,4699.828796386719,5,10,1,40,44105,2
100111,Furniture,165.239013671875,2023-10-08,19,0,167.8510284423828,3189.1695404052734,6,10,1,40,44124,2
100111,Furniture,165.239013671875,2023-10-09,22,0,167.8510284423828,3692.722625732422,0,10,0,41,44146,2
100111,Furniture,165.239013671875,2023-10-10,50,84,129.772197265625,16727.0797265625,1,10,0,41,44196,2
100111,Furniture,165.239013671875,2023-10-11,24,0,149.25439453125,3582.10546875,2,10,0,41,44220,2
100111,Furniture,165.239013671875,2023-10-12,39,0,149.25439453125,5820.92138671875,3,10,0,41,44259,2
100111,Furniture,165.239013671875,2023-10-13,15,0,149.25439453125,2238.81591796875,4,10,0,41,44274,2
100111,Furniture,165.239013671875,2023-10-14,21,0,149.25439453125,3134.34228515625,5,10,1,41,44295,2
100111,Furniture,165.239013671875,2023-10-15,42,68,143.71111236572267,15743.453438720702,6,10,1,41,44337,2
100111,Furniture,165.239013671875,2023-10-16,37,79,141.12698150634765,16271.736631469726,0,10,0,42,44374,2
100111,Furniture,165.239013671875,2023-10-17,77,181,134.85504150390625,34495.67639160156,1,10,0,42,44451,2
100111,Furniture,165.239013671875,2023-10-18,12,0,137.7100830078125,1652.52099609375,2,10,0,42,44463,2
100111,Furniture,165.239013671875,2023-10-19,17,0,137.7100830078125,2341.0714111328125,3,10,0,42,44480,2
100111,Furniture,165.239013671875,2023-10-20,30,0,137.7100830078125,4131.302490234375,4,10,0,42,44510,2
100111,Furniture,165.239013671875,2023-10-21,40,0,137.7100830078125,5508.4033203125,5,10,1,42,44550,2
100111,Furniture,165.239013671875,2023-10-22,64,130,152.04811584472657,29889.498828125,6,10,1,42,44614,2
100111,Furniture,165.239013671875,2023-10-23,44,0,146.10623168945312,6428.6741943359375,0,10,0,43,44658,2
100111,Furniture,165.239013671875,2023-10-24,24,0,146.10623168945312,3506.549560546875,1,10,0,43,44682,2
100111,Furniture,165.239013671875,2023-10-25,72,251,158.4622802734375,51771.818359375,2,10,0,43,44754,2
100111,Furniture,165.239013671875,2023-10-26,107,0,155.174560546875,16603.677978515625,3,10,0,43,44861,2
100111,Furniture,165.239013671875,2023-10-27,67,205,175.00446502685548,48648.01831359863,4,10,0,43,44928,2
100111,Furniture,165.239013671875,2023-10-28,136,0,167.41893005371094,22768.974487304688,5,10,1,43,45064,2
100111,Furniture,165.239013671875,2023-10-29,87,0,167.41893005371094,14565.446914672852,6,10,1,43,45151,2
100111,Furniture,165.239013671875,2023-10-30,85,191,162.04749603271483,44550.474325561525,0,10,0,44,45236,2
100111,Furniture,165.239013671875,2023-10-31,33,0,163.6949920654297,5401.93473815918,1,10,0,44,45269,2
100111,Furniture,165.239013671875,2023-11-01,45,0,163.6949920654297,7366.274642944336,2,11,0,44,45314,2
100111,Furniture,165.239013671875,2023-11-02,61,159,161.1670166015625,35361.97602539063,3,11,0,44,45375,2
100111,Furniture,165.239013671875,2023-11-03,55,0,162.134033203125,8917.371826171875,4,11,0,44,45430,2
100111,Furniture,165.239013671875,2023-11-04,24,0,162.134033203125,3891.216796875,5,11,1,44,45454,2
100111,Furniture,165.239013671875,2023-11-05,43,143,154.76201812744142,28468.53355895996,6,11,1,44,45497,2
100111,Furniture,165.239013671875,2023-11-06,69,0,157.9340362548828,10897.448501586914,0,11,0,45,45566,2
100111,Furniture,165.239013671875,2023-11-07,68,175,156.6296633911133,38003.264221191406,1,11,0,45,45634,2
100111,Furniture,165.239013671875,2023-11-08,61,0,157.16932678222656,9587.32893371582,2,11,0,45,45695,2
100111,Furniture,165.239013671875,2023-11-09,78,0,157.16932678222656,12259.207489013672,3,11,0,45,45773,2
100111,Furniture,165.239013671875,2023-11-10,29,0,157.16932678222656,4557.91047668457,4,11,0,45,45802,2
100111,Furniture,165.239013671875,2023-11-11,85,210,155.11923706054688,45681.52030029297,5,11,1,45,45887,2
100111,Furniture,165.239013671875,2023-11-12,58,0,155.74847412109375,9033.411499023438,6,11,1,45,45945,2
100111,Furniture,165.239013671875,2023-11-13,108,160,175.22875885009768,47408.5719116211,0,11,0,46,46053,2
100111,Furniture,165.239013671875,2023-11-14,33,0,166.6275177001953,5498.708084106445,1,11,0,46,46086,2
100111,Furniture,165.239013671875,2023-11-15,50,0,166.6275177001953,8331.375885009766,2,11,0,46,46136,2
100111,Furniture,165.239013671875,2023-11-16,55,136,161.82031829833983,30732.69501281738,3,11,0,46,46191,2
100111,Furniture,165.239013671875,2023-11-17,125,220,160.03077789306639,55057.594473266596,4,11,0,46,46316,2
100111,Furniture,165.239013671875,2023-11-18,87,0,161.6415557861328,14062.815353393555,5,11,1,46,46403,2
100111,Furniture,165.239013671875,2023-11-19,65,0,161.6415557861328,10506.701126098633,6,11,1,46,46468,2
100111,Furniture,165.239013671875,2023-11-20,37,0,161.6415557861328,5980.737564086914,0,11,0,47,46505,2
100111,Furniture,165.239013671875,2023-11-21,89,157,155.0529260253906,37963.98083251953,1,11,0,47,46594,2
100111,Furniture,165.239013671875,2023-11-22,45,0,157.68585205078125,7095.863342285156,2,11,0,47,46639,2
100111,Furniture,165.239013671875,2023-11-23,42,0,157.68585205078125,6622.8057861328125,3,11,0,47,46681,2
100111,Furniture,165.239013671875,2023-11-24,104,211,171.38652069091796,54441.87630371093,4,11,0,47,46785,2
100111,Furniture,165.239013671875,2023-11-25,62,0,167.13304138183594,10362.248565673828,5,11,1,47,46847,2
100111,Furniture,165.239013671875,2023-11-26,49,161,135.33548828125,26917.9178515625,6,11,1,47,46896,2
100111,Furniture,165.239013671875,2023-11-27,71,0,148.7509765625,10561.3193359375,0,11,0,48,46967,2
100111,Furniture,165.239013671875,2023-11-28,61,0,148.7509765625,9073.8095703125,1,11,0,48,47028,2
100111,Furniture,165.239013671875,2023-11-29,70,220,172.41305908203125,51164.82827148437,2,11,0,48,47098,2
100111,Furniture,165.239013671875,2023-11-30,120,0,164.6461181640625,19757.5341796875,3,11,0,48,47218,2
100111,Furniture,165.239013671875,2023-12-01,175,325,181.52855224609374,91457.49328613281,4,12,0,48,47393,2
100111,Furniture,165.239013671875,2023-12-02,69,0,176.9071044921875,12206.590209960938,5,12,1,48,47462,2
100111,Furniture,165.239013671875,2023-12-03,81,0,176.9071044921875,14329.475463867188,6,12,1,48,47543,2
100111,Furniture,165.239013671875,2023-12-04,120,214,157.73826110839843,52028.622666015624,0,12,0,49,47663,2
100111,Furniture,165.239013671875,2023-12-05,67,0,164.71652221679688,11036.00698852539,1,12,0,49,47730,2
100111,Furniture,165.239013671875,2023-12-06,91,311,159.77381683349608,63898.23466369629,2,12,0,49,47821,2
100111,Furniture,165.239013671875,2023-12-07,83,0,161.2776336669922,13386.043594360352,3,12,0,49,47904,2
100111,Furniture,165.239013671875,2023-12-08,51,0,161.2776336669922,8225.159317016602,4,12,0,49,47955,2
100111,Furniture,165.239013671875,2023-12-09,80,0,161.2776336669922,12902.210693359375,5,12,1,49,48035,2
100111,Furniture,165.239013671875,2023-12-10,61,0,161.2776336669922,9837.935653686523,6,12,1,49,48096,2
100111,Furniture,165.239013671875,2023-12-11,97,202,143.85729766845702,42374.165747680665,0,12,0,50,48193,2
100111,Furniture,165.239013671875,2023-12-12,77,0,149.94459533691406,11545.733840942383,1,12,0,50,48270,2
100111,Furniture,165.239013671875,2023-12-13,82,0,149.94459533691406,12295.456817626953,2,12,0,50,48352,2
100111,Furniture,165.239013671875,2023-12-14,40,75,146.28552001953125,16756.1416015625,3,12,0,50,48392,2
100111,Furniture,165.239013671875,2023-12-15,30,0,148.1910400390625,4445.731201171875,4,12,0,50,48422,2
100111,Furniture,165.239013671875,2023-12-16,41,130,142.99109802246093,24269.820037841797,5,12,1,50,48463,2
100111,Furniture,165.239013671875,2023-12-17,74,197,171.44343811035156,47743.63884033203,6,12,1,50,48537,2
100111,Furniture,165.239013671875,2023-12-18,64,0,161.01687622070312,10305.080078125,0,12,0,51,48601,2
100111,Furniture,165.239013671875,2023-12-19,84,0,161.01687622070312,13525.417602539062,1,12,0,51,48685,2
100111,Furniture,165.239013671875,2023-12-20,70,168,160.46529113769532,38168.66075927734,2,12,0,51,48755,2
100111,Furniture,165.239013671875,2023-12-21,84,0,160.69058227539062,13498.008911132812,3,12,0,51,48839,2
100111,Furniture,165.239013671875,2023-12-22,104,205,157.96288177490234,48707.219409179685,4,12,0,51,48943,2
100111,Furniture,165.239013671875,2023-12-23,43,0,158.9857635498047,6836.387832641602,5,12,1,51,48986,2
100111,Furniture,165.239013671875,2023-12-24,50,0,158.9857635498047,7949.288177490234,6,12,1,51,49036,2
100111,Furniture,165.239013671875,2023-12-25,52,0,158.9857635498047,8267.259704589844,0,12,0,52,49088,2
100111,Furniture,165.239013671875,2023-12-26,76,148,141.91449462890625,31290.28318359375,1,12,0,52,49164,2
100111,Furniture,165.239013671875,2023-12-27,15,0,148.8389892578125,2232.5848388671875,2,12,0,52,49179,2
100111,Furniture,165.239013671875,2023-12-28,51,0,148.8389892578125,7590.7884521484375,3,12,0,52,49230,2
100111,Furniture,165.239013671875,2023-12-29,53,113,146.31814544677735,24216.3234173584,4,12,0,52,49283,2
100111,Furniture,165.239013671875,2023-12-30,21,0,147.5262908935547,3098.0521087646484,5,12,1,52,49304,2
100111,Furniture,165.239013671875,2023-12-31,20,0,147.5262908935547,2950.5258178710938,6,12,1,52,49324,2
100111,Furniture,165.239013671875,2024-01-01,34,0,147.5262908935547,5015.893890380859,0,1,0,1,49358,2
100111,Furniture,165.239013671875,2024-01-02,33,0,147.5262908935547,4868.367599487305,1,1,0,1,49391,2
100111,Furniture,165.239013671875,2024-01-03,23,0,147.5262908935547,3393.104690551758,2,1,0,1,49414,2
100111,Furniture,165.239013671875,2024-01-04,34,90,131.11330963134765,15860.82505493164,3,1,0,1,49448,2
100111,Furniture,165.239013671875,2024-01-05,63,122,128.7545004272461,23573.28705383301,4,1,0,1,49511,2
100111,Furniture,165.239013671875,2024-01-06,30,0,132.9290008544922,3987.8700256347656,5,1,1,1,49541,2
100111,Furniture,165.239013671875,2024-01-07,18,0,132.9290008544922,2392.7220153808594,6,1,1,1,49559,2
100111,Furniture,165.239013671875,2024-01-08,50,142,141.3498178100586,27463.02178100586,0,1,0,2,49609,2
100111,Furniture,165.239013671875,2024-01-09,50,0,137.8296356201172,6891.481781005859,1,1,0,2,49659,2
100111,Furniture,165.239013671875,2024-01-10,36,0,137.8296356201172,4961.866882324219,2,1,0,2,49695,2
100111,Furniture,165.239013671875,2024-01-11,77,238,149.0692852783203,47510.779932861326,3,1,0,2,49772,2
100111,Furniture,165.239013671875,2024-01-12,34,0,145.62857055664062,4951.371398925781,4,1,0,2,49806,2
100111,Furniture,165.239013671875,2024-01-13,147,295,179.42404602050783,81123.74953002931,5,1,1,2,49953,2
100111,Furniture,165.239013671875,2024-01-14,94,0,167.13809204101562,15710.980651855469,6,1,1,2,50047,2
100111,Furniture,165.239013671875,2024-01-15,78,0,167.13809204101562,13036.771179199219,0,1,0,3,50125,2
100111,Furniture,165.239013671875,2024-01-16,36,0,167.13809204101562,6016.9713134765625,1,1,0,3,50161,2
100111,Furniture,165.239013671875,2024-01-17,58,185,141.2874368286133,32927.28267211914,2,1,0,3,50219,2
100111,Furniture,165.239013671875,2024-01-18,65,0,152.35487365722656,9903.066787719727,3,1,0,3,50284,2
100111,Furniture,165.239013671875,2024-01-19,44,0,152.35487365722656,6703.614440917969,4,1,0,3,50328,2
100111,Furniture,165.239013671875,2024-01-20,94,271,147.78918060302735,53658.22595336914,5,1,1,3,50422,2
100111,Furniture,165.239013671875,2024-01-21,70,0,149.3983612060547,10457.885284423828,6,1,1,3,50492,2
100111,Furniture,165.239013671875,2024-01-22,78,0,149.3983612060547,11653.072174072266,0,1,0,4,50570,2
100111,Furniture,165.239013671875,2024-01-23,162,296,181.24534881591796,84519.83301635741,1,1,0,4,50732,2
100111,Furniture,165.239013671875,2024-01-24,28,0,169.98069763183594,4759.459533691406,2,1,0,4,50760,2
100111,Furniture,165.239013671875,2024-01-25,74,0,169.98069763183594,12578.57162475586,3,1,0,4,50834,2
100111,Furniture,165.239013671875,2024-01-26,113,0,169.98069763183594,19207.81883239746,4,1,0,4,50947,2
100111,Furniture,165.239013671875,2024-01-27,51,132,160.8745068359375,29086.509697265625,5,1,1,4,50998,2
100111,Furniture,165.239013671875,2024-01-28,75,0,165.239013671875,12392.926025390625,6,1,1,4,51073,2
100111,Furniture,165.239013671875,2024-01-29,45,0,165.239013671875,7435.755615234375,0,1,0,5,51118,2
100111,Furniture,165.239013671875,2024-01-30,44,0,165.239013671875,7270.5166015625,1,1,0,5,51162,2
100112,Groceries,91.27110290527344,2022-01-01,121,504,84.4800016784668,52800.00040618897,5,1,1,52,121,3
100112,Groceries,91.27110290527344,2022-01-02,168,397,93.37540603637694,53419.96642822265,6,1,1,52,289,3
100112,Groceries,91.27110290527344,2022-01-03,165,0,90.4808120727539,14929.333992004395,0,1,0,1,454,3
100112,Groceries,91.27110290527344,2022-01-04,65,0,90.4808120727539,5881.252784729004,1,1,0,1,519,3
100112,Groceries,91.27110290527344,2022-01-05,111,0,90.4808120727539,10043.370140075684,2,1,0,1,630,3
100112,Groceries,91.27110290527344,2022-01-06,100,0,90.4808120727539,9048.08120727539,3,1,0,1,730,3
100112,Groceries,91.27110290527344,2022-01-07,56,131,69.57579437255859,12391.488969726563,4,1,0,1,786,3
100112,Groceries,91.27110290527344,2022-01-08,105,162,76.85952255249023,20497.579736022948,5,1,1,1,891,3
100112,Groceries,91.27110290527344,2022-01-09,84,253,84.27118713378906,28841.969438476564,6,1,1,1,975,3
100112,Groceries,91.27110290527344,2022-01-10,108,0,81.65237426757812,8818.456420898438,0,1,0,2,1083,3
100112,Groceries,91.27110290527344,2022-01-11,136,0,81.65237426757812,11104.722900390625,1,1,0,2,1219,3
100112,Groceries,91.27110290527344,2022-01-12,109,219,77.32235137939453,25198.672600708007,2,1,0,2,1328,3
100112,Groceries,91.27110290527344,2022-01-13,60,0,78.80470275878906,4728.282165527344,3,1,0,2,1388,3
100112,Groceries,91.27110290527344,2022-01-14,132,369,89.76187789916992,45681.25576538086,4,1,0,2,1520,3
100112,Groceries,91.27110290527344,2022-01-15,47,0,86.76375579833984,4077.8965225219727,5,1,1,2,1567,3
100112,Groceries,91.27110290527344,2022-01-16,109,0,86.76375579833984,9457.249382019043,6,1,1,2,1676,3
100112,Groceries,91.27110290527344,2022-01-17,66,0,86.76375579833984,5726.40788269043,0,1,0,3,1742,3
100112,Groceries,91.27110290527344,2022-01-18,51,0,86.76375579833984,4424.951545715332,1,1,0,3,1793,3
100112,Groceries,91.27110290527344,2022-01-19,73,231,74.24375030517578,21890.107544555663,2,1,0,3,1866,3
100112,Groceries,91.27110290527344,2022-01-20,40,0,78.54750061035156,3141.9000244140625,3,1,0,3,1906,3
100112,Groceries,91.27110290527344,2022-01-21,132,290,83.97238388061524,35764.60934448242,4,1,0,3,2038,3
100112,Groceries,91.27110290527344,2022-01-22,109,0,81.89476776123047,8926.529685974121,5,1,1,3,2147,3
100112,Groceries,91.27110290527344,2022-01-23,125,0,81.89476776123047,10236.845970153809,6,1,1,3,2272,3
100112,Groceries,91.27110290527344,2022-01-24,97,269,91.57536407470704,34091.86063049316,0,1,0,4,2369,3
100112,Groceries,91.27110290527344,2022-01-25,143,0,88.23072814941406,12616.994125366211,1,1,0,4,2512,3
100112,Groceries,91.27110290527344,2022-01-26,101,293,91.15268035888673,36109.481432495115,2,1,0,4,2613,3
100112,Groceries,91.27110290527344,2022-01-27,60,0,90.13536071777344,5408.121643066406,3,1,0,4,2673,3
100112,Groceries,91.27110290527344,2022-01-28,76,0,90.13536071777344,6850.287414550781,4,1,0,4,2749,3
100112,Groceries,91.27110290527344,2022-01-29,36,0,90.13536071777344,3244.8729858398438,5,1,1,4,2785,3
100112,Groceries,91.27110290527344,2022-01-30,107,361,100.00480895996094,47593.50911743164,6,1,1,4,2892,3
100112,Groceries,91.27110290527344,2022-01-31,111,0,96.88961791992188,10754.747589111328,0,1,0,5,3003,3
100112,Groceries,91.27110290527344,2022-02-01,87,0,96.88961791992188,8429.396759033203,1,2,0,5,3090,3
100112,Groceries,91.27110290527344,2022-02-02,35,0,96.88961791992188,3391.1366271972656,2,2,0,5,3125,3
100112,Groceries,91.27110290527344,2022-02-03,80,0,96.88961791992188,7751.16943359375,3,2,0,5,3205,3
100112,Groceries,91.27110290527344,2022-02-04,130,277,89.61673019409179,36120.219850463865,4,2,0,5,3335,3
100112,Groceries,91.27110290527344,2022-02-05,144,424,100.47585357666016,57855.445830078126,5,2,1,5,3479,3
100112,Groceries,91.27110290527344,2022-02-06,122,0,97.67170715332031,11915.948272705078,6,2,1,5,3601,3
100112,Groceries,91.27110290527344,2022-02-07,46,0,97.67170715332031,4492.898529052734,0,2,0,6,3647,3
100112,Groceries,91.27110290527344,2022-02-08,162,0,97.67170715332031,15822.81655883789,1,2,0,6,3809,3
100112,Groceries,91.27110290527344,2022-02-09,64,0,97.67170715332031,6250.9892578125,2,2,0,6,3873,3
100112,Groceries,91.27110290527344,2022-02-10,212,329,83.85543487548827,44851.52438720703,3,2,0,6,4085,3
100112,Groceries,91.27110290527344,2022-02-11,95,0,88.25086975097656,8383.832626342773,4,2,0,6,4180,3
100112,Groceries,91.27110290527344,2022-02-12,138,371,89.85670547485351,45852.00071105957,5,2,1,6,4318,3
100112,Groceries,91.27110290527344,2022-02-13,191,0,89.36341094970703,17068.411491394043,6,2,1,6,4509,3
100112,Groceries,91.27110290527344,2022-02-14,102,0,89.36341094970703,9115.067916870117,0,2,0,7,4611,3
100112,Groceries,91.27110290527344,2022-02-15,215,346,93.75946914672852,52760.26173309326,1,2,0,7,4826,3
100112,Groceries,91.27110290527344,2022-02-16,54,0,92.52893829345703,4996.56266784668,2,2,0,7,4880,3
100112,Groceries,91.27110290527344,2022-02-17,118,0,92.52893829345703,10918.41471862793,3,2,0,7,4998,3
100112,Groceries,91.27110290527344,2022-02-18,172,300,90.67147644042969,42731.46789550781,4,2,0,7,5170,3
100112,Groceries,91.27110290527344,2022-02-19,56,308,99.28322982788086,36886.721740722656,5,2,1,7,5226,3
100112,Groceries,91.27110290527344,2022-02-20,78,0,96.31645965576172,7512.683853149414,6,2,1,7,5304,3
100112,Groceries,91.27110290527344,2022-02-21,92,0,96.31645965576172,8861.114288330078,0,2,0,8,5396,3
100112,Groceries,91.27110290527344,2022-02-22,53,0,96.31645965576172,5104.772361755371,1,2,0,8,5449,3
100112,Groceries,91.27110290527344,2022-02-23,114,0,96.31645965576172,10980.076400756836,2,2,0,8,5563,3
100112,Groceries,91.27110290527344,2022-02-24,117,274,90.78899047851561,35211.34377197265,3,2,0,8,5680,3
100112,Groceries,91.27110290527344,2022-02-25,138,0,92.61798095703125,12781.281372070312,4,2,0,8,5818,3
100112,Groceries,91.27110290527344,2022-02-26,118,229,88.57677734375,30562.229453125,5,2,1,8,5936,3
100112,Groceries,91.27110290527344,2022-02-27,152,457,95.52037628173828,58671.99438964843,6,2,1,8,6088,3
100112,Groceries,91.27110290527344,2022-02-28,69,0,93.88075256347656,6477.771926879883,0,2,0,9,6157,3
100112,Groceries,91.27110290527344,2022-03-01,73,0,93.88075256347656,6853.294937133789,1,3,0,9,6230,3
100112,Groceries,91.27110290527344,2022-03-02,64,0,93.88075256347656,6008.3681640625,2,3,0,9,6294,3
100112,Groceries,91.27110290527344,2022-03-03,130,423,96.6290771484375,53735.010058593754,3,3,0,9,6424,3
100112,Groceries,91.27110290527344,2022-03-04,134,0,95.608154296875,12811.49267578125,4,3,0,9,6558,3
100112,Groceries,91.27110290527344,2022-03-05,170,0,95.608154296875,16253.38623046875,5,3,1,9,6728,3
100112,Groceries,91.27110290527344,2022-03-06,122,0,95.608154296875,11664.19482421875,6,3,1,9,6850,3
100112,Groceries,91.27110290527344,2022-03-07,109,267,92.3550650024414,34516.14417053223,0,3,0,10,6959,3
100112,Groceries,91.27110290527344,2022-03-08,104,0,93.68013000488281,9742.733520507812,1,3,0,10,7063,3
100112,Groceries,91.27110290527344,2022-03-09,109,0,93.68013000488281,10211.134170532227,2,3,0,10,7172,3
100112,Groceries,91.27110290527344,2022-03-10,101,0,93.68013000488281,9461.693130493164,3,3,0,10,7273,3
100112,Groceries,91.27110290527344,2022-03-11,121,203,81.24316131591797,25974.02503845215,4,3,0,10,7394,3
100112,Groceries,91.27110290527344,2022-03-12,54,0,85.49632263183594,4616.801422119141,5,3,1,10,7448,3
100112,Groceries,91.27110290527344,2022-03-13,78,242,88.34749557495118,28425.769309692383,6,3,1,10,7526,3
100112,Groceries,91.27110290527344,2022-03-14,68,0,87.40499114990234,5943.539398193359,0,3,0,11,7594,3
100112,Groceries,91.27110290527344,2022-03-15,189,302,87.93935913085937,43199.76775146484,1,3,0,11,7783,3
100112,Groceries,91.27110290527344,2022-03-16,128,0,87.74871826171875,11231.8359375,2,3,0,11,7911,3
100112,Groceries,91.27110290527344,2022-03-17,91,283,94.10446853637696,35635.8132736206,3,3,0,11,8002,3
100112,Groceries,91.27110290527344,2022-03-18,87,0,91.8089370727539,7987.37752532959,4,3,0,11,8089,3
100112,Groceries,91.27110290527344,2022-03-19,47,0,91.8089370727539,4315.020042419434,5,3,1,11,8136,3
100112,Groceries,91.27110290527344,2022-03-20,106,0,91.8089370727539,9731.747329711914,6,3,1,11,8242,3
100112,Groceries,91.27110290527344,2022-03-21,44,0,91.8089370727539,4039.593231201172,0,3,0,12,8286,3
100112,Groceries,91.27110290527344,2022-03-22,33,0,91.8089370727539,3029.694923400879,1,3,0,12,8319,3
100112,Groceries,91.27110290527344,2022-03-23,91,239,90.35986587524414,29756.615589294433,2,3,0,12,8410,3
100112,Groceries,91.27110290527344,2022-03-24,76,0,90.77973175048828,6899.259613037109,3,3,0,12,8486,3
100112,Groceries,91.27110290527344,2022-03-25,194,360,92.4170719909668,51272.583932495116,4,3,0,12,8680,3
100112,Groceries,91.27110290527344,2022-03-26,73,0,91.9741439819336,6714.112510681152,5,3,1,12,8753,3
100112,Groceries,91.27110290527344,2022-03-27,146,0,91.9741439819336,13428.225021362305,6,3,1,12,8899,3
100112,Groceries,91.27110290527344,2022-03-28,175,367,80.59802688598633,43191.06941009522,0,3,0,13,9074,3
100112,Groceries,91.27110290527344,2022-03-29,39,0,83.16605377197266,3243.4760971069336,1,3,0,13,9113,3
100112,Groceries,91.27110290527344,2022-03-30,152,0,83.16605377197266,12641.240173339844,2,3,0,13,9265,3
100112,Groceries,91.27110290527344,2022-03-31,75,161,78.19876525878905,18283.874788818357,3,3,0,13,9340,3
100112,Groceries,91.27110290527344,2022-04-01,140,423,96.09539962768554,55283.12189575195,4,4,0,13,9480,3
100112,Groceries,91.27110290527344,2022-04-02,111,0,91.9207992553711,10203.208717346191,5,4,1,13,9591,3
100112,Groceries,91.27110290527344,2022-04-03,86,0,91.9207992553711,7905.188735961914,6,4,1,13,9677,3
100112,Groceries,91.27110290527344,2022-04-04,234,399,89.64367218017578,56621.73858032227,0,4,0,14,9911,3
100112,Groceries,91.27110290527344,2022-04-05,122,0,90.38734436035156,11027.25601196289,1,4,0,14,10033,3
100112,Groceries,91.27110290527344,2022-04-06,107,0,90.38734436035156,9671.445846557617,2,4,0,14,10140,3
100112,Groceries,91.27110290527344,2022-04-07,215,409,85.98596298217774,53413.52408233642,3,4,0,14,10355,3
100112,Groceries,91.27110290527344,2022-04-08,61,0,87.23192596435547,5321.147483825684,4,4,0,14,10416,3
100112,Groceries,91.27110290527344,2022-04-09,110,0,87.23192596435547,9595.511856079102,5,4,1,14,10526,3
100112,Groceries,91.27110290527344,2022-04-10,86,0,87.23192596435547,7501.94563293457,6,4,1,14,10612,3
100112,Groceries,91.27110290527344,2022-04-11,180,413,83.64802505493165,49403.359019775395,0,4,0,15,10792,3
100112,Groceries,91.27110290527344,2022-04-12,80,0,84.50605010986328,6760.4840087890625,1,4,0,15,10872,3
100112,Groceries,91.27110290527344,2022-04-13,75,0,84.50605010986328,6337.953758239746,2,4,0,15,10947,3
100112,Groceries,91.27110290527344,2022-04-14,100,314,85.35348434448242,35399.79686889649,3,4,0,15,11047,3
100112,Groceries,91.27110290527344,2022-04-15,124,0,85.05696868896484,10547.06411743164,4,4,0,15,11171,3
100112,Groceries,91.27110290527344,2022-04-16,48,0,85.05696868896484,4082.7344970703125,5,4,1,15,11219,3
100112,Groceries,91.27110290527344,2022-04-17,69,0,85.05696868896484,5868.930839538574,6,4,1,15,11288,3
100112,Groceries,91.27110290527344,2022-04-18,147,283,88.88316070556641,38404.28924743652,0,4,0,16,11435,3
100112,Groceries,91.27110290527344,2022-04-19,164,433,96.97371170043945,58758.48743774414,1,4,0,16,11599,3
100112,Groceries,91.27110290527344,2022-04-20,102,0,93.7574234008789,9563.257186889648,2,4,0,16,11701,3
100112,Groceries,91.27110290527344,2022-04-21,129,0,93.7574234008789,12094.707618713379,3,4,0,16,11830,3
100112,Groceries,91.27110290527344,2022-04-22,71,0,93.7574234008789,6656.777061462402,4,4,0,16,11901,3
100112,Groceries,91.27110290527344,2022-04-23,39,0,93.7574234008789,3656.5395126342773,5,4,1,16,11940,3
100112,Groceries,91.27110290527344,2022-04-24,125,0,93.7574234008789,11719.677925109863,6,4,1,16,12065,3
100112,Groceries,91.27110290527344,2022-04-25,110,219,87.50276779174806,28540.678914184573,0,4,0,17,12175,3
100112,Groceries,91.27110290527344,2022-04-26,92,0,89.7755355834961,8259.34927368164,1,4,0,17,12267,3
100112,Groceries,91.27110290527344,2022-04-27,75,0,89.7755355834961,6733.165168762207,2,4,0,17,12342,3
100112,Groceries,91.27110290527344,2022-04-28,47,0,89.7755355834961,4219.450172424316,3,4,0,17,12389,3
100112,Groceries,91.27110290527344,2022-04-29,45,128,73.35690780639649,12197.981702575684,4,4,0,17,12434,3
100112,Groceries,91.27110290527344,2022-04-30,68,0,79.29381561279297,5391.979461669922,5,4,1,17,12502,3
100112,Groceries,91.27110290527344,2022-05-01,44,93,67.89235168457031,9042.906948242187,6,5,1,17,12546,3
100112,Groceries,91.27110290527344,2022-05-02,83,176,66.61142059326173,17025.305818481444,0,5,0,18,12629,3
100112,Groceries,91.27110290527344,2022-05-03,116,249,76.52809219360351,28308.067388916013,1,5,0,18,12745,3
100112,Groceries,91.27110290527344,2022-05-04,91,0,73.70618438720703,6707.26277923584,2,5,0,18,12836,3
100112,Groceries,91.27110290527344,2022-05-05,69,0,73.70618438720703,5085.726722717285,3,5,0,18,12905,3
100112,Groceries,91.27110290527344,2022-05-06,34,0,73.70618438720703,2506.010269165039,4,5,0,18,12939,3
100112,Groceries,91.27110290527344,2022-05-07,66,0,73.70618438720703,4864.608169555664,5,5,1,18,13005,3
100112,Groceries,91.27110290527344,2022-05-08,56,166,75.3222021484375,16782.886640625,6,5,1,18,13061,3
100112,Groceries,91.27110290527344,2022-05-09,90,0,74.764404296875,6728.79638671875,0,5,0,19,13151,3
100112,Groceries,91.27110290527344,2022-05-10,88,180,76.07094635009766,20429.24655761719,1,5,0,19,13239,3
100112,Groceries,91.27110290527344,2022-05-11,87,0,75.61189270019531,6578.234664916992,2,5,0,19,13326,3
100112,Groceries,91.27110290527344,2022-05-12,84,146,75.98736984252929,17486.558133544924,3,5,0,19,13410,3
100112,Groceries,91.27110290527344,2022-05-13,78,0,75.8347396850586,5915.10969543457,4,5,0,19,13488,3
100112,Groceries,91.27110290527344,2022-05-14,57,123,73.16317916870116,13093.922425231933,5,5,1,19,13545,3
100112,Groceries,91.27110290527344,2022-05-15,45,0,74.30635833740234,3343.7861251831055,6,5,1,19,13590,3
100112,Groceries,91.27110290527344,2022-05-16,74,143,71.90330810546875,15533.789599609376,0,5,0,20,13664,3
100112,Groceries,91.27110290527344,2022-05-17,63,0,72.9066162109375,4593.1168212890625,1,5,0,20,13727,3
100112,Groceries,91.27110290527344,2022-05-18,42,0,72.9066162109375,3062.077880859375,2,5,0,20,13769,3
100112,Groceries,91.27110290527344,2022-05-19,26,0,72.9066162109375,1895.572021484375,3,5,0,20,13795,3
100112,Groceries,91.27110290527344,2022-05-20,99,177,70.10585250854493,19286.358796691893,4,5,0,20,13894,3
100112,Groceries,91.27110290527344,2022-05-21,44,0,70.91170501708984,3120.115020751953,5,5,1,20,13938,3
100112,Groceries,91.27110290527344,2022-05-22,25,0,70.91170501708984,1772.792625427246,6,5,1,20,13963,3
100112,Groceries,91.27110290527344,2022-05-23,101,148,81.22189651489258,20388.6630960083,0,5,0,21,14064,3
100112,Groceries,91.27110290527344,2022-05-24,44,0,77.72379302978516,3419.846893310547,1,5,0,21,14108,3
100112,Groceries,91.27110290527344,2022-05-25,68,200,75.87604110717774,20266.661590576172,2,5,0,21,14176,3
100112,Groceries,91.27110290527344,2022-05-26,87,213,79.12138687133789,23874.841315612794,3,5,0,21,14263,3
100112,Groceries,91.27110290527344,2022-05-27,151,0,78.02277374267578,11781.438835144043,4,5,0,21,14414,3
100112,Groceries,91.27110290527344,2022-05-28,177,337,80.48170944213868,41477.72514251709,5,5,1,21,14591,3
100112,Groceries,91.27110290527344,2022-05-29,85,394,93.4775276184082,46250.429695129395,6,5,1,21,14676,3
100112,Groceries,91.27110290527344,2022-05-30,117,0,88.7050552368164,10378.49146270752,0,5,0,22,14793,3
100112,Groceries,91.27110290527344,2022-05-31,169,0,88.7050552368164,14991.154335021973,1,5,0,22,14962,3
100112,Groceries,91.27110290527344,2022-06-01,53,0,88.7050552368164,4701.3679275512695,2,6,0,22,15015,3
100112,Groceries,91.27110290527344,2022-06-02,129,306,102.52439971923829,45553.13512756348,3,6,0,22,15144,3
100112,Groceries,91.27110290527344,2022-06-03,126,0,97.12879943847656,12238.228729248047,4,6,0,22,15270,3
100112,Groceries,91.27110290527344,2022-06-04,40,0,97.12879943847656,3885.1519775390625,5,6,1,22,15310,3
100112,Groceries,91.27110290527344,2022-06-05,126,0,97.12879943847656,12238.228729248047,6,6,1,22,15436,3
100112,Groceries,91.27110290527344,2022-06-06,130,283,93.8781330871582,38608.24460266113,0,6,0,23,15566,3
100112,Groceries,91.27110290527344,2022-06-07,132,0,94.9462661743164,12532.907135009766,1,6,0,23,15698,3
100112,Groceries,91.27110290527344,2022-06-08,214,490,120.517400970459,86489.92761535646,2,6,0,23,15912,3
100112,Groceries,91.27110290527344,2022-06-09,84,0,114.55480194091797,9622.60336303711,3,6,0,23,15996,3
100112,Groceries,91.27110290527344,2022-06-10,109,0,114.55480194091797,12486.473411560059,4,6,0,23,16105,3
100112,Groceries,91.27110290527344,2022-06-11,68,0,114.55480194091797,7789.726531982422,5,6,1,23,16173,3
100112,Groceries,91.27110290527344,2022-06-12,137,233,83.15596343994142,29556.573982543945,6,6,1,23,16310,3
100112,Groceries,91.27110290527344,2022-06-13,108,0,95.77192687988281,10343.368103027344,0,6,0,24,16418,3
100112,Groceries,91.27110290527344,2022-06-14,122,205,94.40758804321288,30823.341482543947,1,6,0,24,16540,3
100112,Groceries,91.27110290527344,2022-06-15,153,345,98.57609527587891,49337.40515441894,2,6,0,24,16693,3
100112,Groceries,91.27110290527344,2022-06-16,49,0,97.29219055175781,4767.317337036133,3,6,0,24,16742,3
100112,Groceries,91.27110290527344,2022-06-17,283,452,111.7759930419922,83056.80206176758,4,6,0,24,17025,3
100112,Groceries,91.27110290527344,2022-06-18,60,0,106.44198608398438,6386.5191650390625,5,6,1,24,17085,3
100112,Groceries,91.27110290527344,2022-06-19,147,0,106.44198608398438,15646.971954345703,6,6,1,24,17232,3
100112,Groceries,91.27110290527344,2022-06-20,121,0,106.44198608398438,12879.48031616211,0,6,0,25,17353,3
100112,Groceries,91.27110290527344,2022-06-21,152,427,105.50282608032227,61008.35912841797,1,6,0,25,17505,3
100112,Groceries,91.27110290527344,2022-06-22,199,0,105.78565216064453,21051.34477996826,2,6,0,25,17704,3
100112,Groceries,91.27110290527344,2022-06-23,151,0,105.78565216064453,15973.633476257324,3,6,0,25,17855,3
100112,Groceries,91.27110290527344,2022-06-24,175,311,98.44167892456055,47522.8276235962,4,6,0,25,18030,3
100112,Groceries,91.27110290527344,2022-06-25,118,396,101.04247421264648,51960.163914184566,5,6,1,25,18148,3
100112,Groceries,91.27110290527344,2022-06-26,213,0,100.95494842529297,21503.404014587402,6,6,1,25,18361,3
100112,Groceries,91.27110290527344,2022-06-27,89,0,100.95494842529297,8984.990409851074,0,6,0,26,18450,3
100112,Groceries,91.27110290527344,2022-06-28,198,597,104.68518966674804,83601.70510803223,1,6,0,26,18648,3
100112,Groceries,91.27110290527344,2022-06-29,44,0,103.7403793334961,4564.576690673828,2,6,0,26,18692,3
100112,Groceries,91.27110290527344,2022-06-30,92,0,103.7403793334961,9544.11489868164,3,6,0,26,18784,3
100112,Groceries,91.27110290527344,2022-07-01,10,0,103.7403793334961,1037.403793334961,4,7,0,26,18794,3
100112,Groceries,91.27110290527344,2022-07-02,106,0,103.7403793334961,10996.480209350586,5,7,1,26,18900,3
100112,Groceries,91.27110290527344,2022-07-03,97,0,103.7403793334961,10062.816795349121,6,7,1,26,18997,3
100112,Groceries,91.27110290527344,2022-07-04,165,0,103.7403793334961,17117.162590026855,0,7,0,27,19162,3
100112,Groceries,91.27110290527344,2022-07-05,61,0,103.7403793334961,6328.163139343262,1,7,0,27,19223,3
100112,Groceries,91.27110290527344,2022-07-06,103,256,93.72512954711914,33173.76668670654,2,7,0,27,19326,3
100112,Groceries,91.27110290527344,2022-07-07,63,0,96.82025909423828,6099.676322937012,3,7,0,27,19389,3
100112,Groceries,91.27110290527344,2022-07-08,110,203,90.84785781860352,28190.988720092773,4,7,0,27,19499,3
100112,Groceries,91.27110290527344,2022-07-09,147,357,94.81863143920899,47891.77764312744,5,7,1,27,19646,3
100112,Groceries,91.27110290527344,2022-07-10,156,0,94.32726287841797,14715.053009033203,6,7,1,27,19802,3
100112,Groceries,91.27110290527344,2022-07-11,113,0,94.32726287841797,10658.98070526123,0,7,0,28,19915,3
100112,Groceries,91.27110290527344,2022-07-12,67,0,94.32726287841797,6319.926612854004,1,7,0,28,19982,3
100112,Groceries,91.27110290527344,2022-07-13,107,0,94.32726287841797,10093.017127990723,2,7,0,28,20089,3
100112,Groceries,91.27110290527344,2022-07-14,27,0,94.32726287841797,2546.836097717285,3,7,0,28,20116,3
100112,Groceries,91.27110290527344,2022-07-15,57,171,68.66582656860352,14755.6842288208,4,7,0,28,20173,3
100112,Groceries,91.27110290527344,2022-07-16,95,323,89.83004913330078,38431.309335327154,5,7,1,28,20268,3
100112,Groceries,91.27110290527344,2022-07-17,64,0,85.96009826660156,5501.4462890625,6,7,1,28,20332,3
100112,Groceries,91.27110290527344,2022-07-18,92,0,85.96009826660156,7908.329040527344,0,7,0,29,20424,3
100112,Groceries,91.27110290527344,2022-07-19,45,0,85.96009826660156,3868.2044219970703,1,7,0,29,20469,3
100112,Groceries,91.27110290527344,2022-07-20,148,232,82.16060897827148,31097.500257568357,2,7,0,29,20617,3
100112,Groceries,91.27110290527344,2022-07-21,81,0,83.63121795654297,6774.1286544799805,3,7,0,29,20698,3
100112,Groceries,91.27110290527344,2022-07-22,94,274,86.35480621337891,31950.503568115237,4,7,0,29,20792,3
100112,Groceries,91.27110290527344,2022-07-23,152,0,85.39961242675781,12980.741088867188,5,7,1,29,20944,3
100112,Groceries,91.27110290527344,2022-07-24,49,0,85.39961242675781,4184.581008911133,6,7,1,29,20993,3
100112,Groceries,91.27110290527344,2022-07-25,104,0,85.39961242675781,8881.559692382812,0,7,0,30,21097,3
100112,Groceries,91.27110290527344,2022-07-26,171,566,116.41029571533204,87401.92113464356,1,7,0,30,21268,3
100112,Groceries,91.27110290527344,2022-07-28,170,561,109.74149566650391,79880.27852661134,3,7,0,30,21438,3
100112,Groceries,91.27110290527344,2022-07-29,117,0,110.61299133300781,12941.719985961914,4,7,0,30,21555,3
100112,Groceries,91.27110290527344,2022-07-30,60,0,110.61299133300781,6636.779479980469,5,7,1,30,21615,3
100112,Groceries,91.27110290527344,2022-07-31,136,0,110.61299133300781,15043.366821289062,6,7,1,30,21751,3
100112,Groceries,91.27110290527344,2022-08-01,80,0,110.61299133300781,8849.039306640625,0,8,0,31,21831,3
100112,Groceries,91.27110290527344,2022-08-02,51,0,110.61299133300781,5641.262557983398,1,8,0,31,21882,3
100112,Groceries,91.27110290527344,2022-08-03,117,0,110.61299133300781,12941.719985961914,2,8,0,31,21999,3
100112,Groceries,91.27110290527344,2022-08-04,114,0,110.61299133300781,12609.88101196289,3,8,0,31,22113,3
100112,Groceries,91.27110290527344,2022-08-05,57,0,110.61299133300781,6304.940505981445,4,8,0,31,22170,3
100112,Groceries,91.27110290527344,2022-08-06,93,171,84.50880355834961,21502.33746185303,5,8,1,31,22263,3
100112,Groceries,91.27110290527344,2022-08-07,132,290,89.62797073364257,37538.92427368164,6,8,1,31,22395,3
100112,Groceries,91.27110290527344,2022-08-08,115,0,91.42594146728516,10513.983268737793,0,8,0,32,22510,3
100112,Groceries,91.27110290527344,2022-08-09,169,361,98.68748046875001,52756.0483984375,1,8,0,32,22679,3
100112,Groceries,91.27110290527344,2022-08-10,177,610,117.65533432006836,95419.9283493042,2,8,0,32,22856,3
100112,Groceries,91.27110290527344,2022-08-11,230,0,111.13066864013672,25560.053787231445,3,8,0,32,23086,3
100112,Groceries,91.27110290527344,2022-08-12,95,0,111.13066864013672,10557.413520812988,4,8,0,32,23181,3
100112,Groceries,91.27110290527344,2022-08-13,95,0,111.13066864013672,10557.413520812988,5,8,1,32,23276,3
100112,Groceries,91.27110290527344,2022-08-14,106,0,111.13066864013672,11779.850875854492,6,8,1,32,23382,3
100112,Groceries,91.27110290527344,2022-08-15,161,0,111.13066864013672,17892.03765106201,0,8,0,33,23543,3
100112,Groceries,91.27110290527344,2022-08-16,115,250,92.69737030029296,32933.09516906738,1,8,0,33,23658,3
100112,Groceries,91.27110290527344,2022-08-17,148,387,88.87697860717773,46667.99566772461,2,8,0,33,23806,3
100112,Groceries,91.27110290527344,2022-08-18,47,0,92.56395721435547,4350.505989074707,3,8,0,33,23853,3
100112,Groceries,91.27110290527344,2022-08-19,98,0,92.56395721435547,9071.267807006836,4,8,0,33,23951,3
100112,Groceries,91.27110290527344,2022-08-20,171,566,99.88644882202149,74518.31549713135,5,8,1,33,24122,3
100112,Groceries,91.27110290527344,2022-08-21,37,0,97.60289764404297,3611.30721282959,6,8,1,33,24159,3
100112,Groceries,91.27110290527344,2022-08-22,88,0,97.60289764404297,8589.054992675781,0,8,0,34,24247,3
100112,Groceries,91.27110290527344,2022-08-23,107,0,97.60289764404297,10443.510047912598,1,8,0,34,24354,3
100112,Groceries,91.27110290527344,2022-08-24,124,0,97.60289764404297,12102.759307861328,2,8,0,34,24478,3
100112,Groceries,91.27110290527344,2022-08-25,118,0,97.60289764404297,11517.14192199707,3,8,0,34,24596,3
100112,Groceries,91.27110290527344,2022-08-26,110,0,97.60289764404297,10736.318740844727,4,8,0,34,24706,3
100112,Groceries,91.27110290527344,2022-08-27,133,323,95.65172958374023,43493.3600692749,5,8,1,34,24839,3
100112,Groceries,91.27110290527344,2022-08-28,160,0,96.30345916748047,15408.553466796875,6,8,1,34,24999,3
100112,Groceries,91.27110290527344,2022-08-29,113,0,96.30345916748047,10882.290885925293,0,8,0,35,25112,3
100112,Groceries,91.27110290527344,2022-08-30,63,210,86.57645858764648,23114.043782043456,1,8,0,35,25175,3
100112,Groceries,91.27110290527344,2022-08-31,174,348,100.23172073364258,52950.53881530761,2,8,0,35,25349,3
100112,Groceries,91.27110290527344,2022-09-01,87,0,96.61344146728516,8405.369407653809,3,9,0,35,25436,3
100112,Groceries,91.27110290527344,2022-09-02,94,0,96.61344146728516,9081.663497924805,4,9,0,35,25530,3
100112,Groceries,91.27110290527344,2022-09-03,150,0,96.61344146728516,14492.016220092773,5,9,1,35,25680,3
100112,Groceries,91.27110290527344,2022-09-04,200,405,92.63322067260742,55862.03826904297,6,9,1,35,25880,3
100112,Groceries,91.27110290527344,2022-09-05,31,449,96.33785522460937,46627.62702392579,0,9,0,36,25911,3
100112,Groceries,91.27110290527344,2022-09-06,66,0,95.41571044921875,6297.4368896484375,1,9,0,36,25977,3
100112,Groceries,91.27110290527344,2022-09-07,81,0,95.41571044921875,7728.672546386719,2,9,0,36,26058,3
100112,Groceries,91.27110290527344,2022-09-08,79,0,95.41571044921875,7537.841125488281,3,9,0,36,26137,3
100112,Groceries,91.27110290527344,2022-09-09,128,0,95.41571044921875,12213.2109375,4,9,0,36,26265,3
100112,Groceries,91.27110290527344,2022-09-10,91,0,95.41571044921875,8682.829650878906,5,9,1,36,26356,3
100112,Groceries,91.27110290527344,2022-09-11,80,0,95.41571044921875,7633.2568359375,6,9,1,36,26436,3
100112,Groceries,91.27110290527344,2022-09-12,157,269,87.06053573608398,36732.688221130375,0,9,0,37,26593,3
100112,Groceries,91.27110290527344,2022-09-13,108,0,90.23107147216797,9744.95571899414,1,9,0,37,26701,3
100112,Groceries,91.27110290527344,2022-09-14,105,0,90.23107147216797,9474.262504577637,2,9,0,37,26806,3
100112,Groceries,91.27110290527344,2022-09-15,59,0,90.23107147216797,5323.63321685791,3,9,0,37,26865,3
100112,Groceries,91.27110290527344,2022-09-16,73,232,91.19314346313476,27854.748945617677,4,9,0,37,26938,3
100112,Groceries,91.27110290527344,2022-09-17,61,0,90.93628692626953,5547.113502502441,5,9,1,37,26999,3
100112,Groceries,91.27110290527344,2022-09-18,141,281,81.87001571655273,34140.34443206787,6,9,1,37,27140,3
100112,Groceries,91.27110290527344,2022-09-19,68,0,84.79003143310547,5765.722137451172,0,9,0,38,27208,3
100112,Groceries,91.27110290527344,2022-09-20,46,0,84.79003143310547,3900.3414459228516,1,9,0,38,27254,3
100112,Groceries,91.27110290527344,2022-09-21,63,0,84.79003143310547,5341.7719802856445,2,9,0,38,27317,3
100112,Groceries,91.27110290527344,2022-09-22,42,0,84.79003143310547,3561.1813201904297,3,9,0,38,27359,3
100112,Groceries,91.27110290527344,2022-09-23,126,270,75.7456379699707,29658.940768432618,4,9,0,38,27485,3
100112,Groceries,91.27110290527344,2022-09-24,62,0,78.0812759399414,4841.039108276367,5,9,1,38,27547,3
100112,Groceries,91.27110290527344,2022-09-25,121,280,87.14240447998047,35412.77188415527,6,9,1,38,27668,3
100112,Groceries,91.27110290527344,2022-09-26,108,0,84.19480895996094,9093.039367675781,0,9,0,39,27776,3
100112,Groceries,91.27110290527344,2022-09-27,182,276,97.35940704345703,45045.62416381836,1,9,0,39,27958,3
100112,Groceries,91.27110290527344,2022-09-28,132,0,92.51881408691406,12212.483459472656,2,9,0,39,28090,3
100112,Groceries,91.27110290527344,2022-09-29,81,0,92.51881408691406,7494.023941040039,3,9,0,39,28171,3
100112,Groceries,91.27110290527344,2022-09-30,142,274,89.64422470092774,37189.79981506348,4,9,0,39,28313,3
100112,Groceries,91.27110290527344,2022-10-01,60,0,90.41844940185547,5425.106964111328,5,10,1,39,28373,3
100112,Groceries,91.27110290527344,2022-10-02,151,309,95.03263626098632,43938.956150817874,6,10,1,39,28524,3
100112,Groceries,91.27110290527344,2022-10-03,110,0,93.61527252197266,10297.679977416992,0,10,0,40,28634,3
100112,Groceries,91.27110290527344,2022-10-04,19,0,93.61527252197266,1778.6901779174805,1,10,0,40,28653,3
100112,Groceries,91.27110290527344,2022-10-05,83,266,85.0412825012207,29110.042895202638,2,10,0,40,28736,3
100112,Groceries,91.27110290527344,2022-10-06,109,0,88.1525650024414,9608.629585266113,3,10,0,40,28845,3
100112,Groceries,91.27110290527344,2022-10-07,121,0,88.1525650024414,10666.46036529541,4,10,0,40,28966,3
100112,Groceries,91.27110290527344,2022-10-08,145,248,90.54541366577149,35668.24996307373,5,10,1,40,29111,3
100112,Groceries,91.27110290527344,2022-10-09,111,419,96.33830657958984,51669.66406066894,6,10,1,40,29222,3
100112,Groceries,91.27110290527344,2022-10-10,99,0,94.35661315917969,9341.304702758789,0,10,0,41,29321,3
100112,Groceries,91.27110290527344,2022-10-11,102,0,94.35661315917969,9624.374542236328,1,10,0,41,29423,3
100112,Groceries,91.27110290527344,2022-10-12,134,0,94.35661315917969,12643.786163330078,2,10,0,41,29557,3
100112,Groceries,91.27110290527344,2022-10-13,52,0,94.35661315917969,4906.543884277344,3,10,0,41,29609,3
100112,Groceries,91.27110290527344,2022-10-14,151,311,94.6720750427246,43754.16666290283,4,10,0,41,29760,3
100112,Groceries,91.27110290527344,2022-10-15,119,0,94.57415008544922,11254.323860168457,5,10,1,41,29879,3
100112,Groceries,91.27110290527344,2022-10-16,140,263,79.92993301391601,31529.121243896483,6,10,1,41,30019,3
100112,Groceries,91.27110290527344,2022-10-17,77,0,85.47986602783203,6581.949684143066,0,10,0,42,30096,3
100112,Groceries,91.27110290527344,2022-10-18,91,0,85.47986602783203,7778.667808532715,1,10,0,42,30187,3
100112,Groceries,91.27110290527344,2022-10-19,118,216,91.83325698852539,30915.02864929199,2,10,0,42,30305,3
100112,Groceries,91.27110290527344,2022-10-20,129,0,89.35651397705078,11526.99030303955,3,10,0,42,30434,3
100112,Groceries,91.27110290527344,2022-10-21,50,0,89.35651397705078,4467.825698852539,4,10,0,42,30484,3
100112,Groceries,91.27110290527344,2022-10-22,133,264,84.10608932495117,33204.609760437015,5,10,1,42,30617,3
100112,Groceries,91.27110290527344,2022-10-23,62,278,85.95866638183594,29260.794631347657,6,10,1,42,30679,3
100112,Groceries,91.27110290527344,2022-10-24,51,0,85.79733276367188,4375.663970947266,0,10,0,43,30730,3
100112,Groceries,91.27110290527344,2022-10-25,96,0,85.79733276367188,8236.5439453125,1,10,0,43,30826,3
100112,Groceries,91.27110290527344,2022-10-26,120,0,85.79733276367188,10295.679931640625,2,10,0,43,30946,3
100112,Groceries,91.27110290527344,2022-10-27,99,0,85.79733276367188,8493.935943603516,3,10,0,43,31045,3
100112,Groceries,91.27110290527344,2022-10-28,172,294,95.2763523864746,44665.18522094726,4,10,0,43,31217,3
100112,Groceries,91.27110290527344,2022-10-29,4,288,93.04594482421875,27164.88755859375,5,10,1,43,31221,3
100112,Groceries,91.27110290527344,2022-10-30,93,0,93.0618896484375,8654.755737304688,6,10,1,43,31314,3
100112,Groceries,91.27110290527344,2022-10-31,59,0,93.0618896484375,5490.6514892578125,0,10,0,44,31373,3
100112,Groceries,91.27110290527344,2022-11-01,97,0,93.0618896484375,9027.003295898438,1,11,0,44,31470,3
100112,Groceries,91.27110290527344,2022-11-02,95,0,93.0618896484375,8840.879516601562,2,11,0,44,31565,3
100112,Groceries,91.27110290527344,2022-11-03,110,231,79.76197158813477,26651.673749389647,3,11,0,44,31675,3
100112,Groceries,91.27110290527344,2022-11-04,128,335,88.67725036621093,41374.84609375,4,11,0,44,31803,3
100112,Groceries,91.27110290527344,2022-11-05,109,0,87.14450073242188,9498.750579833984,5,11,1,44,31912,3
100112,Groceries,91.27110290527344,2022-11-06,120,0,87.14450073242188,10457.340087890625,6,11,1,44,32032,3
100112,Groceries,91.27110290527344,2022-11-07,75,0,87.14450073242188,6535.837554931641,0,11,0,45,32107,3
100112,Groceries,91.27110290527344,2022-11-08,117,230,95.2710336303711,33392.281869506834,1,11,0,45,32224,3
100112,Groceries,91.27110290527344,2022-11-09,145,669,115.34906036376952,96535.58750549317,2,11,0,45,32369,3
100112,Groceries,91.27110290527344,2022-11-10,68,0,110.30812072753906,7500.952209472656,3,11,0,45,32437,3
100112,Groceries,91.27110290527344,2022-11-11,88,0,110.30812072753906,9707.114624023438,4,11,0,45,32525,3
100112,Groceries,91.27110290527344,2022-11-12,148,0,110.30812072753906,16325.601867675781,5,11,1,45,32673,3
100112,Groceries,91.27110290527344,2022-11-13,81,0,110.30812072753906,8934.957778930664,6,11,1,45,32754,3
100112,Groceries,91.27110290527344,2022-11-14,116,0,110.30812072753906,12795.742004394531,0,11,0,46,32870,3
100112,Groceries,91.27110290527344,2022-11-15,143,489,101.07160873413086,62952.88009796143,1,11,0,46,33013,3
100112,Groceries,91.27110290527344,2022-11-16,110,0,103.74321746826172,11411.753921508789,2,11,0,46,33123,3
100112,Groceries,91.27110290527344,2022-11-17,57,0,103.74321746826172,5913.363395690918,3,11,0,46,33180,3
100112,Groceries,91.27110290527344,2022-11-18,144,0,103.74321746826172,14939.023315429688,4,11,0,46,33324,3
100112,Groceries,91.27110290527344,2022-11-19,69,0,103.74321746826172,7158.282005310059,5,11,1,46,33393,3
100112,Groceries,91.27110290527344,2022-11-20,47,0,103.74321746826172,4875.931221008301,6,11,1,46,33440,3
100112,Groceries,91.27110290527344,2022-11-21,64,0,103.74321746826172,6639.56591796875,0,11,0,47,33504,3
100112,Groceries,91.27110290527344,2022-11-22,99,192,85.11045501708983,24078.90009338379,1,11,0,47,33603,3
100112,Groceries,91.27110290527344,2022-11-23,101,0,92.51091003417969,9343.601913452148,2,11,0,47,33704,3
100112,Groceries,91.27110290527344,2022-11-24,102,297,88.04430877685547,34875.338990478514,3,11,0,47,33806,3
100112,Groceries,91.27110290527344,2022-11-25,81,0,89.34861755371094,7237.238021850586,4,11,0,47,33887,3
100112,Groceries,91.27110290527344,2022-11-26,154,0,89.34861755371094,13759.687103271484,5,11,1,47,34041,3
100112,Groceries,91.27110290527344,2022-11-27,105,179,83.60233963012695,23588.23132232666,6,11,1,47,34146,3
100112,Groceries,91.27110290527344,2022-11-28,73,0,85.6946792602539,6255.711585998535,0,11,0,48,34219,3
100112,Groceries,91.27110290527344,2022-11-29,117,379,92.80959228515624,46431.90459472656,1,11,0,48,34336,3
100112,Groceries,91.27110290527344,2022-11-30,74,0,91.2891845703125,6755.399658203125,2,11,0,48,34410,3
100112,Groceries,91.27110290527344,2022-12-01,110,0,91.2891845703125,10041.810302734375,3,12,0,48,34520,3
100112,Groceries,91.27110290527344,2022-12-02,94,0,91.2891845703125,8581.183349609375,4,12,0,48,34614,3
100112,Groceries,91.27110290527344,2022-12-03,75,152,81.93699447631836,18322.729171447754,5,12,1,48,34689,3
100112,Groceries,91.27110290527344,2022-12-04,78,0,85.53398895263672,6671.651138305664,6,12,1,48,34767,3
100112,Groceries,91.27110290527344,2022-12-05,82,298,88.96414138793946,33984.75918762207,0,12,0,49,34849,3
100112,Groceries,91.27110290527344,2022-12-06,92,0,88.1382827758789,8108.722015380859,1,12,0,49,34941,3
100112,Groceries,91.27110290527344,2022-12-07,78,0,88.1382827758789,6874.786056518555,2,12,0,49,35019,3
100112,Groceries,91.27110290527344,2022-12-08,113,432,98.19052307128906,54199.51821411133,3,12,0,49,35132,3
100112,Groceries,91.27110290527344,2022-12-09,122,0,96.04104614257812,11717.007629394531,4,12,0,49,35254,3
100112,Groceries,91.27110290527344,2022-12-10,101,0,96.04104614257812,9700.14566040039,5,12,1,49,35355,3
100112,Groceries,91.27110290527344,2022-12-11,45,0,96.04104614257812,4321.847076416016,6,12,1,49,35400,3
100112,Groceries,91.27110290527344,2022-12-12,49,0,96.04104614257812,4706.011260986328,0,12,0,50,35449,3
100112,Groceries,91.27110290527344,2022-12-13,115,265,86.25412200927735,32322.94806213379,1,12,0,50,35564,3
100112,Groceries,91.27110290527344,2022-12-14,105,0,89.27824401855469,9374.215621948242,2,12,0,50,35669,3
100112,Groceries,91.27110290527344,2022-12-15,63,0,89.27824401855469,5624.529373168945,3,12,0,50,35732,3
100112,Groceries,91.27110290527344,2022-12-16,219,467,103.59977737426757,71744.0624899292,4,12,0,50,35951,3
100112,Groceries,91.27110290527344,2022-12-18,109,0,100.87955474853516,10995.871467590332,6,12,1,50,36060,3
100112,Groceries,91.27110290527344,2022-12-19,172,308,93.75768692016601,44647.684300537105,0,12,0,51,36232,3
100112,Groceries,91.27110290527344,2022-12-20,157,478,99.39965805053711,63449.52262786865,1,12,0,51,36389,3
100112,Groceries,91.27110290527344,2022-12-21,134,0,98.36931610107422,13181.488357543945,2,12,0,51,36523,3
100112,Groceries,91.27110290527344,2022-12-22,101,0,98.36931610107422,9935.300926208496,3,12,0,51,36624,3
100112,Groceries,91.27110290527344,2022-12-23,103,0,98.36931610107422,10132.039558410645,4,12,0,51,36727,3
100112,Groceries,91.27110290527344,2022-12-24,205,0,98.36931610107422,20165.709800720215,5,12,1,51,36932,3
100112,Groceries,91.27110290527344,2022-12-25,82,194,84.22087509155273,22591.90351501465,6,12,1,51,37014,3
100112,Groceries,91.27110290527344,2022-12-26,95,0,90.05175018310547,8554.91626739502,0,12,0,52,37109,3
100112,Groceries,91.27110290527344,2022-12-27,92,289,77.64543807983398,28768.230606689456,1,12,0,52,37201,3
100112,Groceries,91.27110290527344,2022-12-28,197,0,81.78087615966797,16110.83260345459,2,12,0,52,37398,3
100112,Groceries,91.27110290527344,2022-12-29,63,197,86.516290435791,22762.732594909667,3,12,0,52,37461,3
100112,Groceries,91.27110290527344,2022-12-30,105,0,84.51258087158203,8873.820991516113,4,12,0,52,37566,3
100112,Groceries,91.27110290527344,2022-12-31,34,0,84.51258087158203,2873.427749633789,5,12,1,52,37600,3
100112,Groceries,91.27110290527344,2023-01-01,65,0,84.51258087158203,5493.317756652832,6,1,1,52,37665,3
100112,Groceries,91.27110290527344,2023-01-02,153,361,78.93749649047851,40303.99392608643,0,1,0,1,37818,3
100112,Groceries,91.27110290527344,2023-01-03,66,0,80.23499298095703,5295.509536743164,1,1,0,1,37884,3
100112,Groceries,91.27110290527344,2023-01-04,136,0,80.23499298095703,10911.959045410156,2,1,0,1,38020,3
100112,Groceries,91.27110290527344,2023-01-05,79,250,84.2148681640625,27917.899169921875,3,1,0,1,38099,3
100112,Groceries,91.27110290527344,2023-01-06,63,0,82.979736328125,5227.723388671875,4,1,0,1,38162,3
100112,Groceries,91.27110290527344,2023-01-07,234,459,101.80022933959961,71674.75733093263,5,1,1,1,38396,3
100112,Groceries,91.27110290527344,2023-01-08,75,0,96.79045867919922,7259.284400939941,6,1,1,1,38471,3
100112,Groceries,91.27110290527344,2023-01-09,99,0,96.79045867919922,9582.255409240723,0,1,0,2,38570,3
100112,Groceries,91.27110290527344,2023-01-10,181,348,87.24421768188476,45585.35680084229,1,1,0,2,38751,3
100112,Groceries,91.27110290527344,2023-01-11,86,0,90.63843536376953,7794.90544128418,2,1,0,2,38837,3
100112,Groceries,91.27110290527344,2023-01-12,49,0,90.63843536376953,4441.283332824707,3,1,0,2,38886,3
100112,Groceries,91.27110290527344,2023-01-13,130,376,98.63271926879884,50608.5870098877,4,1,0,2,39016,3
100112,Groceries,91.27110290527344,2023-01-14,65,0,95.78543853759766,6226.053504943848,5,1,1,2,39081,3
100112,Groceries,91.27110290527344,2023-01-15,49,0,95.78543853759766,4693.486488342285,6,1,1,2,39130,3
100112,Groceries,91.27110290527344,2023-01-16,136,0,95.78543853759766,13026.819641113281,0,1,0,3,39266,3
100112,Groceries,91.27110290527344,2023-01-17,74,0,95.78543853759766,7088.122451782227,1,1,0,3,39340,3
100112,Groceries,91.27110290527344,2023-01-18,84,0,95.78543853759766,8045.976837158203,2,1,0,3,39424,3
100112,Groceries,91.27110290527344,2023-01-19,128,278,93.01024658203124,37631.623125,3,1,0,3,39552,3
100112,Groceries,91.27110290527344,2023-01-20,56,0,93.8804931640625,5257.3076171875,4,1,0,3,39608,3
100112,Groceries,91.27110290527344,2023-01-21,108,0,93.8804931640625,10139.09326171875,5,1,1,3,39716,3
100112,Groceries,91.27110290527344,2023-01-22,168,401,79.82690994262695,44667.31174072265,6,1,1,3,39884,3
100112,Groceries,91.27110290527344,2023-01-23,72,0,83.0638198852539,5980.595031738281,0,1,0,4,39956,3
100112,Groceries,91.27110290527344,2023-01-24,74,0,83.0638198852539,6146.722671508789,1,1,0,4,40030,3
100112,Groceries,91.27110290527344,2023-01-25,150,261,94.51823028564453,39336.69908569336,2,1,0,4,40180,3
100112,Groceries,91.27110290527344,2023-01-26,87,0,90.10646057128906,7839.262069702148,3,1,0,4,40267,3
100112,Groceries,91.27110290527344,2023-01-27,129,253,82.2767869567871,31032.091034851073,4,1,0,4,40396,3
100112,Groceries,91.27110290527344,2023-01-28,140,0,85.48357391357422,11967.70034790039,5,1,1,4,40536,3
100112,Groceries,91.27110290527344,2023-01-29,77,0,85.48357391357422,6582.235191345215,6,1,1,4,40613,3
100112,Groceries,91.27110290527344,2023-01-30,91,0,85.48357391357422,7779.005226135254,0,1,0,5,40704,3
100112,Groceries,91.27110290527344,2023-01-31,47,117,75.32897262573242,12057.923426818847,1,1,0,5,40751,3
100112,Groceries,91.27110290527344,2023-02-01,33,0,79.55794525146484,2625.41219329834,2,2,0,5,40784,3
100112,Groceries,91.27110290527344,2023-02-02,55,155,71.69192138671875,14743.111352539061,3,2,0,5,40839,3
100112,Groceries,91.27110290527344,2023-02-03,63,0,74.8138427734375,4713.2720947265625,4,2,0,5,40902,3
100112,Groceries,91.27110290527344,2023-02-04,74,0,74.8138427734375,5536.224365234375,5,2,1,5,40976,3
100112,Groceries,91.27110290527344,2023-02-05,66,158,78.35546401977538,17664.28125061035,6,2,1,5,41042,3
100112,Groceries,91.27110290527344,2023-02-06,89,211,78.32562698364258,23553.12160308838,0,2,0,6,41131,3
100112,Groceries,91.27110290527344,2023-02-07,93,0,77.87125396728516,7242.0266189575195,1,2,0,6,41224,3
100112,Groceries,91.27110290527344,2023-02-08,70,0,77.87125396728516,5450.987777709961,2,2,0,6,41294,3
100112,Groceries,91.27110290527344,2023-02-09,82,123,65.93702987670898,13287.202899780274,3,2,0,6,41376,3
100112,Groceries,91.27110290527344,2023-02-10,18,0,71.54405975341797,1287.7930755615234,4,2,0,6,41394,3
100112,Groceries,91.27110290527344,2023-02-11,96,303,91.01878479003906,37463.5266796875,5,2,1,6,41490,3
100112,Groceries,91.27110290527344,2023-02-12,55,0,85.47756958007812,4701.266326904297,6,2,1,6,41545,3
100112,Groceries,91.27110290527344,2023-02-13,61,0,85.47756958007812,5214.131744384766,0,2,0,7,41606,3
100112,Groceries,91.27110290527344,2023-02-14,39,0,85.47756958007812,3333.625213623047,1,2,0,7,41645,3
100112,Groceries,91.27110290527344,2023-02-15,59,0,85.47756958007812,5043.176605224609,2,2,0,7,41704,3
100112,Groceries,91.27110290527344,2023-02-16,39,0,85.47756958007812,3333.625213623047,3,2,0,7,41743,3
100112,Groceries,91.27110290527344,2023-02-17,109,235,75.69776443481445,25678.69264678955,4,2,0,7,41852,3
100112,Groceries,91.27110290527344,2023-02-18,86,221,72.69132553100586,21982.607991333007,5,2,1,7,41938,3
100112,Groceries,91.27110290527344,2023-02-19,35,0,75.16265106201172,2630.69278717041,6,2,1,7,41973,3
100112,Groceries,91.27110290527344,2023-02-20,101,0,75.16265106201172,7591.427757263184,0,2,0,8,42074,3
100112,Groceries,91.27110290527344,2023-02-21,27,0,75.16265106201172,2029.3915786743164,1,2,0,8,42101,3
100112,Groceries,91.27110290527344,2023-02-22,104,0,75.16265106201172,7816.915710449219,2,2,0,8,42205,3
100112,Groceries,91.27110290527344,2023-02-23,68,153,78.59823425292969,17481.709858398437,3,2,0,8,42273,3
100112,Groceries,91.27110290527344,2023-02-24,39,0,77.28646850585938,3014.1722717285156,4,2,0,8,42312,3
100112,Groceries,91.27110290527344,2023-02-25,68,0,77.28646850585938,5255.4798583984375,5,2,1,8,42380,3
100112,Groceries,91.27110290527344,2023-02-26,58,149,75.68511169433594,15614.482956542968,6,2,1,8,42438,3
100112,Groceries,91.27110290527344,2023-02-27,71,0,76.26022338867188,5414.475860595703,0,2,0,9,42509,3
100112,Groceries,91.27110290527344,2023-02-28,104,182,74.05754974365234,21122.150346679686,1,2,0,9,42613,3
100112,Groceries,91.27110290527344,2023-03-01,83,235,85.26775314331056,27688.527021789552,2,3,0,9,42696,3
100112,Groceries,91.27110290527344,2023-03-02,101,0,81.4955062866211,8231.04613494873,3,3,0,9,42797,3
100112,Groceries,91.27110290527344,2023-03-03,99,0,81.4955062866211,8068.055122375488,4,3,0,9,42896,3
100112,Groceries,91.27110290527344,2023-03-04,83,176,80.70968826293945,20875.93825164795,5,3,1,9,42979,3
100112,Groceries,91.27110290527344,2023-03-05,116,0,81.0093765258789,9397.087677001953,6,3,1,9,43095,3
100112,Groceries,91.27110290527344,2023-03-06,118,186,72.83263076782227,21950.540861206056,0,3,0,10,43213,3
100112,Groceries,91.27110290527344,2023-03-07,76,285,85.0235807800293,31311.404278564456,1,3,0,10,43289,3
100112,Groceries,91.27110290527344,2023-03-08,136,0,82.0671615600586,11161.133972167969,2,3,0,10,43425,3
100112,Groceries,91.27110290527344,2023-03-09,230,409,88.8261866760254,57111.45587097168,3,3,0,10,43655,3
100112,Groceries,91.27110290527344,2023-03-10,105,0,86.86237335205078,9120.549201965332,4,3,0,10,43760,3
100112,Groceries,91.27110290527344,2023-03-11,43,0,86.86237335205078,3735.0820541381836,5,3,1,10,43803,3
100112,Groceries,91.27110290527344,2023-03-12,59,0,86.86237335205078,5124.880027770996,6,3,1,10,43862,3
100112,Groceries,91.27110290527344,2023-03-13,119,0,86.86237335205078,10336.622428894043,0,3,0,11,43981,3
100112,Groceries,91.27110290527344,2023-03-14,118,187,83.29376678466797,25322.228961181638,1,3,0,11,44099,3
100112,Groceries,91.27110290527344,2023-03-15,70,262,90.83219238281251,30557.14693359375,2,3,0,11,44169,3
100112,Groceries,91.27110290527344,2023-03-16,165,0,88.744384765625,14642.823486328125,3,3,0,11,44334,3
100112,Groceries,91.27110290527344,2023-03-17,59,0,88.744384765625,5235.918701171875,4,3,0,11,44393,3
100112,Groceries,91.27110290527344,2023-03-18,81,216,80.90479217529297,23666.27633239746,5,3,1,11,44474,3
100112,Groceries,91.27110290527344,2023-03-19,120,0,83.58958435058594,10030.750122070312,6,3,1,11,44594,3
100112,Groceries,91.27110290527344,2023-03-20,79,210,82.81255783081055,23895.814137268066,0,3,0,12,44673,3
100112,Groceries,91.27110290527344,2023-03-21,161,442,96.62911361694336,59391.60458465576,1,3,0,12,44834,3
100112,Groceries,91.27110290527344,2023-03-22,87,0,92.62822723388672,8058.6557693481445,2,3,0,12,44921,3
100112,Groceries,91.27110290527344,2023-03-23,121,0,92.62822723388672,11208.015495300293,3,3,0,12,45042,3
100112,Groceries,91.27110290527344,2023-03-24,120,0,92.62822723388672,11115.387268066406,4,3,0,12,45162,3
100112,Groceries,91.27110290527344,2023-03-25,114,0,92.62822723388672,10559.617904663086,5,3,1,12,45276,3
100112,Groceries,91.27110290527344,2023-03-26,151,340,90.3642073059082,44267.860606384274,6,3,1,12,45427,3
100112,Groceries,91.27110290527344,2023-03-27,46,0,90.8984146118164,4181.327072143555,0,3,0,13,45473,3
100112,Groceries,91.27110290527344,2023-03-28,64,0,90.8984146118164,5817.49853515625,1,3,0,13,45537,3
100112,Groceries,91.27110290527344,2023-03-29,99,307,95.8085417175293,39225.131260070804,2,3,0,13,45636,3
100112,Groceries,91.27110290527344,2023-03-30,149,0,94.2370834350586,14041.32543182373,3,3,0,13,45785,3
100112,Groceries,91.27110290527344,2023-03-31,115,0,94.2370834350586,10837.264595031738,4,3,0,13,45900,3
100112,Groceries,91.27110290527344,2023-04-01,77,235,81.71145370483399,24838.043870544436,5,4,1,13,45977,3
100112,Groceries,91.27110290527344,2023-04-02,156,0,85.86290740966797,13394.613555908203,6,4,1,13,46133,3
100112,Groceries,91.27110290527344,2023-04-03,143,279,84.59556900024414,35648.25273406983,0,4,0,14,46276,3
100112,Groceries,91.27110290527344,2023-04-04,92,0,84.97113800048828,7817.344696044922,1,4,0,14,46368,3
100112,Groceries,91.27110290527344,2023-04-05,179,450,104.28058700561523,66830.80014801025,2,4,0,14,46547,3
100112,Groceries,91.27110290527344,2023-04-06,100,0,99.71117401123047,9971.117401123047,3,4,0,14,46647,3
100112,Groceries,91.27110290527344,2023-04-07,93,0,99.71117401123047,9273.139183044434,4,4,0,14,46740,3
100112,Groceries,91.27110290527344,2023-04-08,101,0,99.71117401123047,10070.828575134277,5,4,1,14,46841,3
100112,Groceries,91.27110290527344,2023-04-09,60,0,99.71117401123047,5982.670440673828,6,4,1,14,46901,3
100112,Groceries,91.27110290527344,2023-04-10,75,110,84.98723831176758,15479.835746765137,0,4,0,15,46976,3
100112,Groceries,91.27110290527344,2023-04-11,115,329,87.968046875,38837.810781249995,1,4,0,15,47091,3
100112,Groceries,91.27110290527344,2023-04-12,93,0,88.99609375,8276.63671875,2,4,0,15,47184,3
100112,Groceries,91.27110290527344,2023-04-13,121,0,88.99609375,10768.52734375,3,4,0,15,47305,3
100112,Groceries,91.27110290527344,2023-04-14,61,174,80.77851486206055,18612.478813171387,4,4,0,15,47366,3
100112,Groceries,91.27110290527344,2023-04-15,67,0,84.0570297241211,5631.820991516113,5,4,1,15,47433,3
100112,Groceries,91.27110290527344,2023-04-16,39,0,84.0570297241211,3278.2241592407227,6,4,1,15,47472,3
100112,Groceries,91.27110290527344,2023-04-17,127,248,88.71851181030274,33452.331999816895,0,4,0,16,47599,3
100112,Groceries,91.27110290527344,2023-04-18,111,0,87.20702362060547,9679.979621887207,1,4,0,16,47710,3
100112,Groceries,91.27110290527344,2023-04-19,43,0,87.20702362060547,3749.902015686035,2,4,0,16,47753,3
100112,Groceries,91.27110290527344,2023-04-20,41,149,75.23802154541016,13768.397766723632,3,4,0,16,47794,3
100112,Groceries,91.27110290527344,2023-04-21,68,0,80.11604309082031,5447.890930175781,4,4,0,16,47862,3
100112,Groceries,91.27110290527344,2023-04-22,42,0,80.11604309082031,3364.873809814453,5,4,1,16,47904,3
100112,Groceries,91.27110290527344,2023-04-23,102,188,69.21274597167968,19742.940178222656,6,4,1,16,48006,3
100112,Groceries,91.27110290527344,2023-04-24,48,0,73.03549194335938,3505.70361328125,0,4,0,17,48054,3
100112,Groceries,91.27110290527344,2023-04-25,54,150,70.94932723999023,14384.447341918945,1,4,0,17,48108,3
100112,Groceries,91.27110290527344,2023-04-26,76,0,71.87865447998047,5462.777740478516,2,4,0,17,48184,3
100112,Groceries,91.27110290527344,2023-04-27,91,148,66.95645446777344,15871.124713134766,3,4,0,17,48275,3
100112,Groceries,91.27110290527344,2023-04-28,107,0,69.26290893554688,7411.131256103516,4,4,0,17,48382,3
100112,Groceries,91.27110290527344,2023-04-29,52,0,69.26290893554688,3601.6712646484375,5,4,1,17,48434,3
100112,Groceries,91.27110290527344,2023-04-30,110,211,83.52653106689453,27206.2668347168,6,4,1,17,48544,3
100112,Groceries,91.27110290527344,2023-05-01,43,0,79.62306213378906,3423.7916717529297,0,5,0,18,48587,3
100112,Groceries,91.27110290527344,2023-05-02,47,0,79.62306213378906,3742.283920288086,1,5,0,18,48634,3
100112,Groceries,91.27110290527344,2023-05-03,85,171,74.59835800170899,18953.700860290526,2,5,0,18,48719,3
100112,Groceries,91.27110290527344,2023-05-04,62,168,77.46278213500977,17871.26498474121,3,5,0,18,48781,3
100112,Groceries,91.27110290527344,2023-05-05,61,0,76.94556427001953,4693.679420471191,4,5,0,18,48842,3
100112,Groceries,91.27110290527344,2023-05-06,32,0,76.94556427001953,2462.258056640625,5,5,1,18,48874,3
100112,Groceries,91.27110290527344,2023-05-07,61,0,76.94556427001953,4693.679420471191,6,5,1,18,48935,3
100112,Groceries,91.27110290527344,2023-05-08,10,0,76.94556427001953,769.4556427001953,0,5,0,19,48945,3
100112,Groceries,91.27110290527344,2023-05-09,79,128,73.0423030090332,15036.343875427247,1,5,0,19,49024,3
100112,Groceries,91.27110290527344,2023-05-10,79,223,79.78389266967773,24353.375041809082,2,5,0,19,49103,3
100112,Groceries,91.27110290527344,2023-05-11,68,0,77.98778533935547,5303.169403076172,3,5,0,19,49171,3
100112,Groceries,91.27110290527344,2023-05-12,80,211,80.38197799682618,23527.136479492186,4,5,0,19,49251,3
100112,Groceries,91.27110290527344,2023-05-13,70,0,79.34395599365234,5554.076919555664,5,5,1,19,49321,3
100112,Groceries,91.27110290527344,2023-05-14,34,0,79.34395599365234,2697.6945037841797,6,5,1,19,49355,3
100112,Groceries,91.27110290527344,2023-05-15,168,327,88.61726837158203,44379.55217285156,0,5,0,20,49523,3
100112,Groceries,91.27110290527344,2023-05-16,182,388,90.00843612670899,51682.11075012207,1,5,0,20,49705,3
100112,Groceries,91.27110290527344,2023-05-17,111,0,88.17687225341797,9787.632820129395,2,5,0,20,49816,3
100112,Groceries,91.27110290527344,2023-05-18,146,0,88.17687225341797,12873.823348999023,3,5,0,20,49962,3
100112,Groceries,91.27110290527344,2023-05-19,156,0,88.17687225341797,13755.592071533203,4,5,0,20,50118,3
100112,Groceries,91.27110290527344,2023-05-20,73,0,88.17687225341797,6436.911674499512,5,5,1,20,50191,3
100112,Groceries,91.27110290527344,2023-05-21,151,325,91.93969818115235,43933.86885070801,6,5,1,20,50342,3
100112,Groceries,91.27110290527344,2023-05-22,78,0,90.95939636230469,7094.832916259766,0,5,0,21,50420,3
100112,Groceries,91.27110290527344,2023-05-23,147,359,104.21083633422852,53606.06588226318,1,5,0,21,50567,3
100112,Groceries,91.27110290527344,2023-05-24,178,0,100.08167266845703,17814.53773498535,2,5,0,21,50745,3
100112,Groceries,91.27110290527344,2023-05-25,102,0,100.08167266845703,10208.330612182617,3,5,0,21,50847,3
100112,Groceries,91.27110290527344,2023-05-26,257,594,116.76312469482423,100365.25609313964,4,5,0,21,51104,3
100112,Groceries,91.27110290527344,2023-05-28,166,0,113.79624938964844,18890.17739868164,6,5,1,21,51270,3
100112,Groceries,91.27110290527344,2023-05-29,80,0,113.79624938964844,9103.699951171875,0,5,0,22,51350,3
100112,Groceries,91.27110290527344,2023-05-30,51,0,113.79624938964844,5803.60871887207,1,5,0,22,51401,3
100112,Groceries,91.27110290527344,2023-05-31,143,255,101.75977996826171,40004.257070922846,2,5,0,22,51544,3
100112,Groceries,91.27110290527344,2023-06-01,112,0,106.18955993652344,11893.230712890625,3,6,0,22,51656,3
100112,Groceries,91.27110290527344,2023-06-02,117,256,92.5114909362793,33808.79887908936,4,6,0,22,51773,3
100112,Groceries,91.27110290527344,2023-06-03,136,0,97.5329818725586,13264.485534667969,5,6,1,22,51909,3
100112,Groceries,91.27110290527344,2023-06-04,62,0,97.5329818725586,6047.044876098633,6,6,1,22,51971,3
100112,Groceries,91.27110290527344,2023-06-05,161,285,88.41557525634767,39100.33523254395,0,6,0,23,52132,3
100112,Groceries,91.27110290527344,2023-06-06,77,0,91.10115051269531,7014.788589477539,1,6,0,23,52209,3
100112,Groceries,91.27110290527344,2023-06-07,130,388,98.36801544189453,51458.244014892574,2,6,0,23,52339,3
100112,Groceries,91.27110290527344,2023-06-08,143,0,96.41603088378906,13787.492416381836,3,6,0,23,52482,3
100112,Groceries,91.27110290527344,2023-06-09,251,581,104.03812133789063,87203.8369116211,4,6,0,23,52733,3
100112,Groceries,91.27110290527344,2023-06-10,124,0,102.08624267578125,12658.694091796875,5,6,1,23,52857,3
100112,Groceries,91.27110290527344,2023-06-11,150,0,102.08624267578125,15312.936401367188,6,6,1,23,53007,3
100112,Groceries,91.27110290527344,2023-06-12,144,0,102.08624267578125,14700.4189453125,0,6,0,24,53151,3
100112,Groceries,91.27110290527344,2023-06-13,167,455,112.42923751831054,70691.52533111573,1,6,0,24,53318,3
100112,Groceries,91.27110290527344,2023-06-14,145,0,109.7884750366211,15919.328880310059,2,6,0,24,53463,3
100112,Groceries,91.27110290527344,2023-06-15,197,0,109.7884750366211,21628.329582214355,3,6,0,24,53660,3
100112,Groceries,91.27110290527344,2023-06-16,132,352,91.53533203125,43226.12765625,4,6,0,24,53792,3
100112,Groceries,91.27110290527344,2023-06-17,126,0,96.4306640625,12150.263671875,5,6,1,24,53918,3
100112,Groceries,91.27110290527344,2023-06-18,130,315,90.2098600769043,39730.863619995114,6,6,1,24,54048,3
100112,Groceries,91.27110290527344,2023-06-19,34,0,92.4397201538086,3142.950485229492,0,6,0,25,54082,3
100112,Groceries,91.27110290527344,2023-06-20,170,0,92.4397201538086,15714.752426147461,1,6,0,25,54252,3
100112,Groceries,91.27110290527344,2023-06-21,154,310,92.1064501953125,42719.226660156244,2,6,0,25,54406,3
100112,Groceries,91.27110290527344,2023-06-22,78,0,92.222900390625,7193.38623046875,3,6,0,25,54484,3
100112,Groceries,91.27110290527344,2023-06-23,144,394,96.58480361938476,52336.42344238281,4,6,0,25,54628,3
100112,Groceries,91.27110290527344,2023-06-24,51,0,95.08960723876953,4849.569969177246,5,6,1,25,54679,3
100112,Groceries,91.27110290527344,2023-06-25,132,0,95.08960723876953,12551.828155517578,6,6,1,25,54811,3
100112,Groceries,91.27110290527344,2023-06-26,146,0,95.08960723876953,13883.082656860352,0,6,0,26,54957,3
100112,Groceries,91.27110290527344,2023-06-27,67,0,95.08960723876953,6371.003684997559,1,6,0,26,55024,3
100112,Groceries,91.27110290527344,2023-06-28,152,306,100.58843612670898,46325.38458251953,2,6,0,26,55176,3
100112,Groceries,91.27110290527344,2023-06-29,105,0,98.92687225341797,10387.321586608887,3,6,0,26,55281,3
100112,Groceries,91.27110290527344,2023-06-30,88,244,94.66040908813477,31166.671999511716,4,6,0,26,55369,3
100112,Groceries,91.27110290527344,2023-07-01,164,0,96.33081817626953,15798.254180908203,5,7,1,26,55533,3
100112,Groceries,91.27110290527344,2023-07-02,240,562,111.75865676879883,90693.47524902344,6,7,1,26,55773,3
100112,Groceries,91.27110290527344,2023-07-03,66,0,108.45731353759766,7158.182693481445,0,7,0,27,55839,3
100112,Groceries,91.27110290527344,2023-07-04,110,0,108.45731353759766,11930.304489135742,1,7,0,27,55949,3
100112,Groceries,91.27110290527344,2023-07-05,159,0,108.45731353759766,17244.712852478027,2,7,0,27,56108,3
100112,Groceries,91.27110290527344,2023-07-06,81,278,83.2866828918457,28188.642628479003,3,7,0,27,56189,3
100112,Groceries,91.27110290527344,2023-07-07,68,0,91.9733657836914,6254.188873291016,4,7,0,27,56257,3
100112,Groceries,91.27110290527344,2023-07-08,193,330,99.6183250427246,52508.8734664917,5,7,1,27,56450,3
100112,Groceries,91.27110290527344,2023-07-09,50,0,96.63665008544922,4831.832504272461,6,7,1,27,56500,3
100112,Groceries,91.27110290527344,2023-07-10,151,0,96.63665008544922,14592.134162902832,0,7,0,28,56651,3
100112,Groceries,91.27110290527344,2023-07-11,176,262,101.48291931152343,44618.68759765625,1,7,0,28,56827,3
100112,Groceries,91.27110290527344,2023-07-12,77,0,99.51583862304688,7662.719573974609,2,7,0,28,56904,3
100112,Groceries,91.27110290527344,2023-07-13,108,265,82.62907730102539,29735.920697021484,3,7,0,28,57012,3
100112,Groceries,91.27110290527344,2023-07-14,160,385,115.57605606079102,65361.33793945313,4,7,0,28,57172,3
100112,Groceries,91.27110290527344,2023-07-15,79,0,105.03211212158203,8297.53685760498,5,7,1,28,57251,3
100112,Groceries,91.27110290527344,2023-07-16,155,0,105.03211212158203,16279.977378845215,6,7,1,28,57406,3
100112,Groceries,91.27110290527344,2023-07-17,219,0,105.03211212158203,23002.032554626465,0,7,0,29,57625,3
100112,Groceries,91.27110290527344,2023-07-18,133,215,86.83088500976562,29608.635412597654,1,7,0,29,57758,3
100112,Groceries,91.27110290527344,2023-07-19,138,364,100.48101776123048,50922.62090209961,2,7,0,29,57896,3
100112,Groceries,91.27110290527344,2023-07-20,113,0,98.35203552246094,11113.780014038086,3,7,0,29,58009,3
100112,Groceries,91.27110290527344,2023-07-21,110,0,98.35203552246094,10818.723907470703,4,7,0,29,58119,3
100112,Groceries,91.27110290527344,2023-07-22,49,0,98.35203552246094,4819.249740600586,5,7,1,29,58168,3
100112,Groceries,91.27110290527344,2023-07-23,120,0,98.35203552246094,11802.244262695312,6,7,1,29,58288,3
100112,Groceries,91.27110290527344,2023-07-24,84,154,74.41069717407227,17026.49712524414,0,7,0,30,58372,3
100112,Groceries,91.27110290527344,2023-07-25,62,0,84.17139434814453,5218.626449584961,1,7,0,30,58434,3
100112,Groceries,91.27110290527344,2023-07-26,104,205,84.50388961791992,26123.429040527346,2,7,0,30,58538,3
100112,Groceries,91.27110290527344,2023-07-27,47,0,84.38777923583984,3966.2256240844727,3,7,0,30,58585,3
100112,Groceries,91.27110290527344,2023-07-28,110,369,87.48218551635742,42120.960813598635,4,7,0,30,58695,3
100112,Groceries,91.27110290527344,2023-07-29,42,0,86.64437103271484,3639.0635833740234,5,7,1,30,58737,3
100112,Groceries,91.27110290527344,2023-07-30,86,0,86.64437103271484,7451.415908813477,6,7,1,30,58823,3
100112,Groceries,91.27110290527344,2023-07-31,61,0,86.64437103271484,5285.3066329956055,0,7,0,31,58884,3
100112,Groceries,91.27110290527344,2023-08-01,148,408,87.92903259277344,48987.59364746094,1,8,0,31,59032,3
100112,Groceries,91.27110290527344,2023-08-02,188,0,87.54806518554688,16459.036254882812,2,8,0,31,59220,3
100112,Groceries,91.27110290527344,2023-08-03,51,0,87.54806518554688,4464.951324462891,3,8,0,31,59271,3
100112,Groceries,91.27110290527344,2023-08-04,101,0,87.54806518554688,8842.354583740234,4,8,0,31,59372,3
100112,Groceries,91.27110290527344,2023-08-05,61,0,87.54806518554688,5340.431976318359,5,8,1,31,59433,3
100112,Groceries,91.27110290527344,2023-08-06,81,295,89.9859310913086,33968.26083679199,6,8,1,31,59514,3
100112,Groceries,91.27110290527344,2023-08-07,122,0,89.36186218261719,10902.147186279297,0,8,0,32,59636,3
100112,Groceries,91.27110290527344,2023-08-08,241,391,108.20005004882813,69156.42412353517,1,8,0,32,59877,3
100112,Groceries,91.27110290527344,2023-08-09,54,400,96.06360641479492,42750.08949279785,2,8,0,32,59931,3
100112,Groceries,91.27110290527344,2023-08-10,95,0,98.55721282958984,9362.935218811035,3,8,0,32,60026,3
100112,Groceries,91.27110290527344,2023-08-11,150,0,98.55721282958984,14783.581924438477,4,8,0,32,60176,3
100112,Groceries,91.27110290527344,2023-08-12,129,0,98.55721282958984,12713.88045501709,5,8,1,32,60305,3
100112,Groceries,91.27110290527344,2023-08-13,90,0,98.55721282958984,8870.149154663086,6,8,1,32,60395,3
100112,Groceries,91.27110290527344,2023-08-14,118,302,95.24379257202148,39788.255046997074,0,8,0,33,60513,3
100112,Groceries,91.27110290527344,2023-08-15,209,553,105.45185592651367,81337.51577728271,1,8,0,33,60722,3
100112,Groceries,91.27110290527344,2023-08-16,196,0,102.59371185302734,20108.36752319336,2,8,0,33,60918,3
100112,Groceries,91.27110290527344,2023-08-17,129,0,102.59371185302734,13234.588829040527,3,8,0,33,61047,3
100112,Groceries,91.27110290527344,2023-08-18,126,0,102.59371185302734,12926.807693481445,4,8,0,33,61173,3
100112,Groceries,91.27110290527344,2023-08-19,148,0,102.59371185302734,15183.869354248047,5,8,1,33,61321,3
100112,Groceries,91.27110290527344,2023-08-20,112,361,104.75441757202148,49689.66953613281,6,8,1,33,61433,3
100112,Groceries,91.27110290527344,2023-08-21,144,0,104.18883514404297,15003.192260742188,0,8,0,34,61577,3
100112,Groceries,91.27110290527344,2023-08-22,218,350,101.33201950073243,57428.280502319336,1,8,0,34,61795,3
100112,Groceries,91.27110290527344,2023-08-23,143,0,102.30403900146484,14629.477577209473,2,8,0,34,61938,3
100112,Groceries,91.27110290527344,2023-08-24,58,0,102.30403900146484,5933.634262084961,3,8,0,34,61996,3
100112,Groceries,91.27110290527344,2023-08-25,53,0,102.30403900146484,5422.114067077637,4,8,0,34,62049,3
100112,Groceries,91.27110290527344,2023-08-26,60,172,90.56315612792969,20471.578735351562,5,8,1,34,62109,3
100112,Groceries,91.27110290527344,2023-08-27,179,413,96.16484756469727,56984.615428161625,6,8,1,34,62288,3
100112,Groceries,91.27110290527344,2023-08-28,112,0,95.92969512939453,10744.125854492188,0,8,0,35,62400,3
100112,Groceries,91.27110290527344,2023-08-29,112,0,95.92969512939453,10744.125854492188,1,8,0,35,62512,3
100112,Groceries,91.27110290527344,2023-08-30,103,0,95.92969512939453,9880.758598327637,2,8,0,35,62615,3
100112,Groceries,91.27110290527344,2023-08-31,111,253,85.64358230590821,30681.015271911623,3,8,0,35,62726,3
100112,Groceries,91.27110290527344,2023-09-01,78,0,89.1171646118164,6951.13883972168,4,9,0,35,62804,3
100112,Groceries,91.27110290527344,2023-09-02,113,229,91.78051513671875,31516.476420898438,5,9,1,35,62917,3
100112,Groceries,91.27110290527344,2023-09-03,200,0,90.6810302734375,18136.2060546875,6,9,1,35,63117,3
100112,Groceries,91.27110290527344,2023-09-04,102,254,80.21047454833985,28047.176807861328,0,9,0,36,63219,3
100112,Groceries,91.27110290527344,2023-09-05,136,400,102.82371551513671,56781.01062011719,1,9,0,36,63355,3
100112,Groceries,91.27110290527344,2023-09-06,67,0,96.50743103027344,6465.99787902832,2,9,0,36,63422,3
100112,Groceries,91.27110290527344,2023-09-07,88,0,96.50743103027344,8492.653930664062,3,9,0,36,63510,3
100112,Groceries,91.27110290527344,2023-09-08,132,0,96.50743103027344,12738.980895996094,4,9,0,36,63642,3
100112,Groceries,91.27110290527344,2023-09-09,108,0,96.50743103027344,10422.802551269531,5,9,1,36,63750,3
100112,Groceries,91.27110290527344,2023-09-10,120,272,76.54023056030273,29024.855334472653,6,9,1,36,63870,3
100112,Groceries,91.27110290527344,2023-09-11,100,0,82.98046112060547,8298.046112060547,0,9,0,37,63970,3
100112,Groceries,91.27110290527344,2023-09-12,45,0,82.98046112060547,3734.120750427246,1,9,0,37,64015,3
100112,Groceries,91.27110290527344,2023-09-13,107,262,77.5189436340332,28319.45393768311,2,9,0,37,64122,3
100112,Groceries,91.27110290527344,2023-09-14,159,351,107.49261047363282,56846.330130615235,3,9,0,37,64281,3
100112,Groceries,91.27110290527344,2023-09-15,105,0,96.94522094726562,10179.24819946289,4,9,0,37,64386,3
100112,Groceries,91.27110290527344,2023-09-16,77,0,96.94522094726562,7464.782012939453,5,9,1,37,64463,3
100112,Groceries,91.27110290527344,2023-09-17,130,0,96.94522094726562,12602.878723144531,6,9,1,37,64593,3
100112,Groceries,91.27110290527344,2023-09-18,47,0,96.94522094726562,4556.425384521484,0,9,0,38,64640,3
100112,Groceries,91.27110290527344,2023-09-19,152,218,97.35803497314453,36032.50263183594,1,9,0,38,64792,3
100112,Groceries,91.27110290527344,2023-09-20,102,357,100.92047134399414,46615.6261541748,2,9,0,38,64894,3
100112,Groceries,91.27110290527344,2023-09-21,146,0,99.77094268798828,14566.557632446289,3,9,0,38,65040,3
100112,Groceries,91.27110290527344,2023-09-22,158,428,103.31635665893555,60862.96870422363,4,9,0,38,65198,3
100112,Groceries,91.27110290527344,2023-09-23,125,0,102.1327133178711,12766.589164733887,5,9,1,38,65323,3
100112,Groceries,91.27110290527344,2023-09-24,84,0,102.1327133178711,8579.147918701172,6,9,1,38,65407,3
100112,Groceries,91.27110290527344,2023-09-25,94,0,102.1327133178711,9600.475051879883,0,9,0,39,65501,3
100112,Groceries,91.27110290527344,2023-09-26,69,0,102.1327133178711,7047.1572189331055,1,9,0,39,65570,3
100112,Groceries,91.27110290527344,2023-09-27,91,0,102.1327133178711,9294.07691192627,2,9,0,39,65661,3
100112,Groceries,91.27110290527344,2023-09-28,78,230,80.28733963012695,23602.584982299803,3,9,0,39,65739,3
100112,Groceries,91.27110290527344,2023-09-29,147,321,94.74438400268555,44802.44889678955,4,9,0,39,65886,3
100112,Groceries,91.27110290527344,2023-09-30,112,0,92.0887680053711,10313.942016601562,5,9,1,39,65998,3
100112,Groceries,91.27110290527344,2023-10-01,95,0,92.0887680053711,8748.432960510254,6,10,1,39,66093,3
100112,Groceries,91.27110290527344,2023-10-02,158,358,88.19924362182617,45252.96098449707,0,10,0,40,66251,3
100112,Groceries,91.27110290527344,2023-10-03,197,0,89.48848724365234,17629.23198699951,1,10,0,40,66448,3
100112,Groceries,91.27110290527344,2023-10-04,80,0,89.48848724365234,7159.0789794921875,2,10,0,40,66528,3
100112,Groceries,91.27110290527344,2023-10-05,108,218,82.14804412841798,26465.877531738282,3,10,0,40,66636,3
100112,Groceries,91.27110290527344,2023-10-06,116,0,85.00608825683594,9860.706237792969,4,10,0,40,66752,3
100112,Groceries,91.27110290527344,2023-10-07,50,0,85.00608825683594,4250.304412841797,5,10,1,40,66802,3
100112,Groceries,91.27110290527344,2023-10-08,31,0,85.00608825683594,2635.188735961914,6,10,1,40,66833,3
100112,Groceries,91.27110290527344,2023-10-09,40,119,77.09305206298828,11979.474165039062,0,10,0,41,66873,3
100112,Groceries,91.27110290527344,2023-10-10,105,214,75.10269485473633,23725.29591949463,1,10,0,41,66978,3
100112,Groceries,91.27110290527344,2023-10-11,26,0,77.23538970947266,2008.120132446289,2,10,0,41,67004,3
100112,Groceries,91.27110290527344,2023-10-12,71,0,77.23538970947266,5483.712669372559,3,10,0,41,67075,3
100112,Groceries,91.27110290527344,2023-10-13,53,0,77.23538970947266,4093.475654602051,4,10,0,41,67128,3
100112,Groceries,91.27110290527344,2023-10-14,72,185,68.61544052124023,17261.78343505859,5,10,1,41,67200,3
100112,Groceries,91.27110290527344,2023-10-15,36,0,71.91088104248047,2588.791717529297,6,10,1,41,67236,3
100112,Groceries,91.27110290527344,2023-10-16,113,0,71.91088104248047,8125.929557800293,0,10,0,42,67349,3
100112,Groceries,91.27110290527344,2023-10-17,66,139,72.52737869262695,14886.553987426758,1,10,0,42,67415,3
100112,Groceries,91.27110290527344,2023-10-18,72,0,72.2747573852539,5203.782531738281,2,10,0,42,67487,3
100112,Groceries,91.27110290527344,2023-10-19,82,171,70.39159439086913,17748.411480102535,3,10,0,42,67569,3
100112,Groceries,91.27110290527344,2023-10-20,52,0,71.07318878173828,3695.8058166503906,4,10,0,42,67621,3
100112,Groceries,91.27110290527344,2023-10-21,149,284,78.2849870300293,34178.87613494873,5,10,1,42,67770,3
100112,Groceries,91.27110290527344,2023-10-22,49,0,76.1999740600586,3733.798728942871,6,10,1,42,67819,3
100112,Groceries,91.27110290527344,2023-10-23,70,0,76.1999740600586,5333.998184204102,0,10,0,43,67889,3
100112,Groceries,91.27110290527344,2023-10-24,69,174,80.82148849487305,19841.06541229248,1,10,0,43,67958,3
100112,Groceries,91.27110290527344,2023-10-25,110,0,78.9029769897461,8679.32746887207,2,10,0,43,68068,3
100112,Groceries,91.27110290527344,2023-10-26,86,244,86.32090438842773,28874.43555480957,3,10,0,43,68154,3
100112,Groceries,91.27110290527344,2023-10-27,102,0,83.86180877685547,8553.904495239258,4,10,0,43,68256,3
100112,Groceries,91.27110290527344,2023-10-28,97,0,83.86180877685547,8134.5954513549805,5,10,1,43,68353,3
100112,Groceries,91.27110290527344,2023-10-29,137,353,104.62800811767579,52261.75422424317,6,10,1,43,68490,3
100112,Groceries,91.27110290527344,2023-10-30,64,0,100.02601623535156,6401.6650390625,0,10,0,44,68554,3
100112,Groceries,91.27110290527344,2023-10-31,60,0,100.02601623535156,6001.560974121094,1,10,0,44,68614,3
100112,Groceries,91.27110290527344,2023-11-01,172,357,92.45336532592773,48500.20767211914,2,11,0,44,68786,3
100112,Groceries,91.27110290527344,2023-11-02,72,0,94.65673065185547,6815.284606933594,3,11,0,44,68858,3
100112,Groceries,91.27110290527344,2023-11-03,74,0,94.65673065185547,7004.598068237305,4,11,0,44,68932,3
100112,Groceries,91.27110290527344,2023-11-04,173,368,101.61648239135742,55396.40290740967,5,11,1,44,69105,3
100112,Groceries,91.27110290527344,2023-11-05,120,0,99.45296478271484,11934.355773925781,6,11,1,44,69225,3
100112,Groceries,91.27110290527344,2023-11-06,117,0,99.45296478271484,11635.996879577637,0,11,0,45,69342,3
100112,Groceries,91.27110290527344,2023-11-07,157,251,94.1585954284668,38234.478964538575,1,11,0,45,69499,3
100112,Groceries,91.27110290527344,2023-11-08,93,0,96.0971908569336,8937.038749694824,2,11,0,45,69592,3
100112,Groceries,91.27110290527344,2023-11-09,127,323,92.42153228759766,41365.94920104981,3,11,0,45,69719,3
100112,Groceries,91.27110290527344,2023-11-10,136,0,93.56306457519531,12724.576782226562,4,11,0,45,69855,3
100112,Groceries,91.27110290527344,2023-11-11,84,0,93.56306457519531,7859.297424316406,5,11,1,45,69939,3
100112,Groceries,91.27110290527344,2023-11-12,119,234,88.63147537231445,31080.89113861084,6,11,1,45,70058,3
100112,Groceries,91.27110290527344,2023-11-13,55,0,90.4229507446289,4973.26229095459,0,11,0,46,70113,3
100112,Groceries,91.27110290527344,2023-11-14,68,0,90.4229507446289,6148.760650634766,1,11,0,46,70181,3
100112,Groceries,91.27110290527344,2023-11-15,110,232,91.0907698059082,31182.229357299806,2,11,0,46,70291,3
100112,Groceries,91.27110290527344,2023-11-16,149,295,99.70577987670899,44776.60240325928,3,11,0,46,70440,3
100112,Groceries,91.27110290527344,2023-11-17,109,0,96.23155975341797,10489.240013122559,4,11,0,46,70549,3
100112,Groceries,91.27110290527344,2023-11-18,110,0,96.23155975341797,10585.471572875977,5,11,1,46,70659,3
100112,Groceries,91.27110290527344,2023-11-19,183,450,93.20234664916993,58790.86887359619,6,11,1,46,70842,3
100112,Groceries,91.27110290527344,2023-11-20,125,0,93.97469329833984,11746.83666229248,0,11,0,47,70967,3
100112,Groceries,91.27110290527344,2023-11-21,78,0,93.97469329833984,7330.026077270508,1,11,0,47,71045,3
100112,Groceries,91.27110290527344,2023-11-22,59,0,93.97469329833984,5544.506904602051,2,11,0,47,71104,3
100112,Groceries,91.27110290527344,2023-11-23,107,308,83.94067504882813,34155.864460449215,3,11,0,47,71211,3
100112,Groceries,91.27110290527344,2023-11-24,104,0,87.32135009765625,9081.42041015625,4,11,0,47,71315,3
100112,Groceries,91.27110290527344,2023-11-25,116,365,94.21919403076171,45937.15301513672,5,11,1,47,71431,3
100112,Groceries,91.27110290527344,2023-11-26,104,0,91.73838806152344,9540.792358398438,6,11,1,47,71535,3
100112,Groceries,91.27110290527344,2023-11-27,72,0,91.73838806152344,6605.1639404296875,0,11,0,48,71607,3
100112,Groceries,91.27110290527344,2023-11-28,104,0,91.73838806152344,9540.792358398438,1,11,0,48,71711,3
100112,Groceries,91.27110290527344,2023-11-29,129,0,91.73838806152344,11834.252059936523,2,11,0,48,71840,3
100112,Groceries,91.27110290527344,2023-11-30,110,239,88.99283828735352,30936.874423217774,3,11,0,48,71950,3
100112,Groceries,91.27110290527344,2023-12-01,45,0,89.93567657470703,4047.1054458618164,4,12,0,48,71995,3
100112,Groceries,91.27110290527344,2023-12-02,122,302,85.64707427978516,36039.48612426758,5,12,1,48,72117,3
100112,Groceries,91.27110290527344,2023-12-03,118,0,87.17414855957031,10286.549530029297,6,12,1,48,72235,3
100112,Groceries,91.27110290527344,2023-12-04,171,0,87.17414855957031,14906.779403686523,0,12,0,49,72406,3
100112,Groceries,91.27110290527344,2023-12-05,22,0,87.17414855957031,1917.8312683105469,1,12,0,49,72428,3
100112,Groceries,91.27110290527344,2023-12-06,125,220,87.93104263305665,30358.91065826416,2,12,0,49,72553,3
100112,Groceries,91.27110290527344,2023-12-07,78,398,100.60310607910156,49012.484548339846,3,12,0,49,72631,3
100112,Groceries,91.27110290527344,2023-12-08,96,0,97.08621215820312,9320.2763671875,4,12,0,49,72727,3
100112,Groceries,91.27110290527344,2023-12-09,176,0,97.08621215820312,17087.17333984375,5,12,1,49,72903,3
100112,Groceries,91.27110290527344,2023-12-10,180,281,93.43957748413087,42935.29789428711,6,12,1,49,73083,3
100112,Groceries,91.27110290527344,2023-12-11,103,0,94.82915496826172,9767.402961730957,0,12,0,50,73186,3
100112,Groceries,91.27110290527344,2023-12-12,78,0,94.82915496826172,7396.674087524414,1,12,0,50,73264,3
100112,Groceries,91.27110290527344,2023-12-13,93,225,91.11852752685547,28793.726119995117,2,12,0,50,73357,3
100112,Groceries,91.27110290527344,2023-12-14,93,0,92.49705505371094,8602.226119995117,3,12,0,50,73450,3
100112,Groceries,91.27110290527344,2023-12-15,97,234,83.7867820739746,27262.585722351072,4,12,0,50,73547,3
100112,Groceries,91.27110290527344,2023-12-16,87,0,87.22356414794922,7588.450080871582,5,12,1,50,73634,3
100112,Groceries,91.27110290527344,2023-12-17,103,363,94.53795501708984,44679.21873352051,6,12,1,50,73737,3
100112,Groceries,91.27110290527344,2023-12-18,175,0,92.13591003417969,16123.784255981445,0,12,0,51,73912,3
100112,Groceries,91.27110290527344,2023-12-19,208,573,104.94610214233398,83260.07849121094,1,12,0,51,74120,3
100112,Groceries,91.27110290527344,2023-12-20,92,0,101.39220428466797,9328.082794189453,2,12,0,51,74212,3
100112,Groceries,91.27110290527344,2023-12-21,44,0,101.39220428466797,4461.256988525391,3,12,0,51,74256,3
100112,Groceries,91.27110290527344,2023-12-22,119,0,101.39220428466797,12065.672309875488,4,12,0,51,74375,3
100112,Groceries,91.27110290527344,2023-12-23,64,0,101.39220428466797,6489.10107421875,5,12,1,51,74439,3
100112,Groceries,91.27110290527344,2023-12-24,158,0,101.39220428466797,16019.968276977539,6,12,1,51,74597,3
100112,Groceries,91.27110290527344,2023-12-25,129,0,101.39220428466797,13079.594352722168,0,12,0,52,74726,3
100112,Groceries,91.27110290527344,2023-12-26,79,186,86.66322006225586,22416.498769836428,1,12,0,52,74805,3
100112,Groceries,91.27110290527344,2023-12-27,51,0,91.79644012451172,4681.618446350098,2,12,0,52,74856,3
100112,Groceries,91.27110290527344,2023-12-28,69,185,87.83589874267578,22122.874026489255,3,12,0,52,74925,3
100112,Groceries,91.27110290527344,2023-12-29,89,0,89.45179748535156,7961.209976196289,4,12,0,52,75014,3
100112,Groceries,91.27110290527344,2023-12-30,31,0,89.45179748535156,2773.0057220458984,5,12,1,52,75045,3
100112,Groceries,91.27110290527344,2023-12-31,39,0,89.45179748535156,3488.620101928711,6,12,1,52,75084,3
100112,Groceries,91.27110290527344,2024-01-01,16,0,89.45179748535156,1431.228759765625,0,1,0,1,75100,3
100112,Groceries,91.27110290527344,2024-01-02,52,0,89.45179748535156,4651.493469238281,1,1,0,1,75152,3
100112,Groceries,91.27110290527344,2024-01-03,131,260,83.78823974609375,32602.758813476565,2,1,0,1,75283,3
100112,Groceries,91.27110290527344,2024-01-04,13,0,85.0164794921875,1105.2142333984375,3,1,0,1,75296,3
100112,Groceries,91.27110290527344,2024-01-05,43,0,85.0164794921875,3655.7086181640625,4,1,0,1,75339,3
100112,Groceries,91.27110290527344,2024-01-06,90,249,84.86574569702148,28762.214225463864,5,1,1,1,75429,3
100112,Groceries,91.27110290527344,2024-01-07,109,0,84.91149139404297,9255.352561950684,6,1,1,1,75538,3
100112,Groceries,91.27110290527344,2024-01-08,28,0,84.91149139404297,2377.521759033203,0,1,0,2,75566,3
100112,Groceries,91.27110290527344,2024-01-09,201,304,81.08868682861328,40838.68210510254,1,1,0,2,75767,3
100112,Groceries,91.27110290527344,2024-01-10,38,0,82.16737365722656,3122.3601989746094,2,1,0,2,75805,3
100112,Groceries,91.27110290527344,2024-01-11,138,298,75.21003311157227,32415.569138793944,3,1,0,2,75943,3
100112,Groceries,91.27110290527344,2024-01-12,105,0,77.56006622314453,8143.806953430176,4,1,0,2,76048,3
100112,Groceries,91.27110290527344,2024-01-13,82,0,77.56006622314453,6359.925430297852,5,1,1,2,76130,3
100112,Groceries,91.27110290527344,2024-01-14,128,190,84.91082275390625,27193.790625,6,1,1,2,76258,3
100112,Groceries,91.27110290527344,2024-01-15,50,0,81.8116455078125,4090.582275390625,0,1,0,3,76308,3
100112,Groceries,91.27110290527344,2024-01-16,92,0,81.8116455078125,7526.67138671875,1,1,0,3,76400,3
100112,Groceries,91.27110290527344,2024-01-17,143,286,81.36454010009766,34889.00846862793,2,1,0,3,76543,3
100112,Groceries,91.27110290527344,2024-01-18,54,0,81.47908020019531,4399.870330810547,3,1,0,3,76597,3
100112,Groceries,91.27110290527344,2024-01-19,102,0,81.47908020019531,8310.866180419922,4,1,0,3,76699,3
100112,Groceries,91.27110290527344,2024-01-20,104,255,95.17801025390625,34717.3361328125,5,1,1,3,76803,3
100112,Groceries,91.27110290527344,2024-01-21,80,337,100.40027801513672,42622.42448242188,6,1,1,3,76883,3
100112,Groceries,91.27110290527344,2024-01-22,48,0,97.46055603027344,4678.106689453125,0,1,0,4,76931,3
100112,Groceries,91.27110290527344,2024-01-23,129,0,97.46055603027344,12572.411727905273,1,1,0,4,77060,3
100112,Groceries,91.27110290527344,2024-01-24,117,0,97.46055603027344,11402.885055541992,2,1,0,4,77177,3
100112,Groceries,91.27110290527344,2024-01-25,70,268,83.02723175048828,27042.07244506836,3,1,0,4,77247,3
100112,Groceries,91.27110290527344,2024-01-26,123,0,88.18446350097656,10846.689010620117,4,1,0,4,77370,3
100112,Groceries,91.27110290527344,2024-01-27,174,349,92.92055145263672,48886.10190551758,5,1,1,4,77544,3
100112,Groceries,91.27110290527344,2024-01-28,43,0,91.27110290527344,3924.657424926758,6,1,1,4,77587,3
100112,Groceries,91.27110290527344,2024-01-29,109,0,91.27110290527344,9948.550216674805,0,1,0,5,77696,3
100112,Groceries,91.27110290527344,2024-01-30,85,0,91.27110290527344,7758.043746948242,1,1,0,5,77781,3
100113,Toys,32.842525482177734,2022-01-01,113,279,33.10000114440918,12975.200258636474,5,1,1,52,113,4
100113,Toys,32.842525482177734,2022-01-02,73,90,32.84320388793945,5351.347767639159,6,1,1,52,186,4
100113,Toys,32.842525482177734,2022-01-03,47,0,32.966407775878906,1549.4211654663086,0,1,0,1,233,4
100113,Toys,32.842525482177734,2022-01-04,79,147,29.945461387634275,6702.702899246216,1,1,0,1,312,4
100113,Toys,32.842525482177734,2022-01-05,44,0,30.900922775268555,1359.6406021118164,2,1,0,1,356,4
100113,Toys,32.842525482177734,2022-01-06,142,181,33.10455764770508,10719.114371948242,3,1,0,1,498,4
100113,Toys,32.842525482177734,2022-01-07,44,0,32.429115295410156,1426.8810729980469,4,1,0,1,542,4
100113,Toys,32.842525482177734,2022-01-08,55,0,32.429115295410156,1783.6013412475586,5,1,1,1,597,4
100113,Toys,32.842525482177734,2022-01-09,100,98,31.301089248657227,6198.377849731445,6,1,1,1,697,4
100113,Toys,32.842525482177734,2022-01-10,98,114,32.84149429321289,6967.972881469726,0,1,0,2,795,4
100113,Toys,32.842525482177734,2022-01-11,84,80,31.79881561279297,5216.161022949219,1,1,0,2,879,4
100113,Toys,32.842525482177734,2022-01-12,100,127,31.605652313232422,7170.550462646484,2,1,0,2,979,4
100113,Toys,32.842525482177734,2022-01-13,137,142,30.06782890319824,8386.185119476319,3,1,0,2,1116,4
100113,Toys,32.842525482177734,2022-01-14,61,88,30.383616104125977,4524.3611647033695,4,1,0,2,1177,4
100113,Toys,32.842525482177734,2022-01-15,106,168,38.19917167663574,10626.584395446778,5,1,1,2,1283,4
100113,Toys,32.842525482177734,2022-01-16,97,0,35.618343353271484,3454.979305267334,6,1,1,2,1380,4
100113,Toys,32.842525482177734,2022-01-17,92,135,36.05512580871582,8190.743148803711,0,1,0,3,1472,4
100113,Toys,32.842525482177734,2022-01-18,61,0,35.91025161743164,2190.52534866333,1,1,0,3,1533,4
100113,Toys,32.842525482177734,2022-01-19,78,76,33.66278335571289,5186.0142034912105,2,1,0,3,1611,4
100113,Toys,32.842525482177734,2022-01-20,104,109,35.02595146179199,7461.197904052734,3,1,0,3,1715,4
100113,Toys,32.842525482177734,2022-01-21,94,160,31.51529769897461,7944.475967407227,4,1,0,3,1809,4
100113,Toys,32.842525482177734,2022-01-22,51,0,32.43059539794922,1653.9603652954102,5,1,1,3,1860,4
100113,Toys,32.842525482177734,2022-01-23,35,0,32.43059539794922,1135.0708389282227,6,1,1,3,1895,4
100113,Toys,32.842525482177734,2022-01-24,62,64,31.671194000244142,3989.9080560302737,0,1,0,4,1957,4
100113,Toys,32.842525482177734,2022-01-25,101,159,34.39359794616699,8975.766785125732,1,1,0,4,2058,4
100113,Toys,32.842525482177734,2022-01-26,73,0,33.817195892333984,2468.655300140381,2,1,0,4,2131,4
100113,Toys,32.842525482177734,2022-01-27,82,130,30.55166351318359,6437.992816162109,3,1,0,4,2213,4
100113,Toys,32.842525482177734,2022-01-28,64,97,33.07906021118164,5348.85970703125,4,1,0,4,2277,4
100113,Toys,32.842525482177734,2022-01-29,29,0,32.37812042236328,938.9654922485352,5,1,1,4,2306,4
100113,Toys,32.842525482177734,2022-01-30,102,126,32.78575881958008,7478.614799194336,6,1,1,4,2408,4
100113,Toys,32.842525482177734,2022-01-31,52,0,32.641517639160156,1697.3589172363281,0,1,0,5,2460,4
100113,Toys,32.842525482177734,2022-02-01,89,84,32.69774948120117,5656.599407653808,1,2,0,5,2549,4
100113,Toys,32.842525482177734,2022-02-02,39,57,31.887707595825198,3054.4211924743654,2,2,0,5,2588,4
100113,Toys,32.842525482177734,2022-02-03,98,108,28.93748115539551,5949.04630645752,3,2,0,5,2686,4
100113,Toys,32.842525482177734,2022-02-04,83,84,31.521682205200197,5264.7292460632325,4,2,0,5,2769,4
100113,Toys,32.842525482177734,2022-02-05,40,0,30.91336441040039,1236.5345764160156,5,2,1,5,2809,4
100113,Toys,32.842525482177734,2022-02-06,48,50,27.583459243774413,2699.9520874023438,6,2,1,5,2857,4
100113,Toys,32.842525482177734,2022-02-07,63,83,31.731352882385252,4651.350463180542,0,2,0,6,2920,4
100113,Toys,32.842525482177734,2022-02-08,46,55,28.362497024536133,2853.3397262573244,1,2,0,6,2966,4
100113,Toys,32.842525482177734,2022-02-09,70,73,30.679151496887208,4388.591209564209,2,2,0,6,3036,4
100113,Toys,32.842525482177734,2022-02-10,102,110,33.7499649810791,7165.472856140137,3,2,0,6,3138,4
100113,Toys,32.842525482177734,2022-02-11,92,106,31.627500801086427,6257.800147399902,4,2,0,6,3230,4
100113,Toys,32.842525482177734,2022-02-12,98,120,30.96638957977295,6742.392357635498,5,2,1,6,3328,4
100113,Toys,32.842525482177734,2022-02-13,155,131,34.291414718627934,9779.298562774658,6,2,1,6,3483,4
100113,Toys,32.842525482177734,2022-02-14,69,0,33.12282943725586,2285.4752311706543,0,2,0,7,3552,4
100113,Toys,32.842525482177734,2022-02-15,79,134,30.92122932434082,6558.65423324585,1,2,0,7,3631,4
100113,Toys,32.842525482177734,2022-02-16,108,113,37.148602142333985,8220.49806274414,2,2,0,7,3739,4
100113,Toys,32.842525482177734,2022-02-17,110,162,36.03457061767578,9817.285535888674,3,2,0,7,3849,4
100113,Toys,32.842525482177734,2022-02-18,156,198,37.18597229003906,13183.743354492188,4,2,0,7,4005,4
100113,Toys,32.842525482177734,2022-02-19,95,0,36.711944580078125,3487.634735107422,5,2,1,7,4100,4
100113,Toys,32.842525482177734,2022-02-20,92,165,36.83400779724121,9468.967434692382,6,2,1,7,4192,4
100113,Toys,32.842525482177734,2022-02-21,116,0,36.79801559448242,4268.569808959961,0,2,0,8,4308,4
100113,Toys,32.842525482177734,2022-02-22,95,155,39.45642189025879,9901.52015914917,1,2,0,8,4403,4
100113,Toys,32.842525482177734,2022-02-23,155,203,41.1341626739502,14756.550428924562,2,2,0,8,4558,4
100113,Toys,32.842525482177734,2022-02-24,143,167,34.38209548950195,10602.959309997557,3,2,0,8,4701,4
100113,Toys,32.842525482177734,2022-02-25,103,0,36.694190979003906,3779.5016708374023,4,2,0,8,4804,4
100113,Toys,32.842525482177734,2022-02-26,113,148,33.06999969482422,8593.819931030273,5,2,1,8,4917,4
100113,Toys,32.842525482177734,2022-02-27,159,249,38.9306258392334,15988.039016876222,6,2,1,8,5076,4
100113,Toys,32.842525482177734,2022-02-28,77,0,37.7712516784668,2908.3863792419434,0,2,0,9,5153,4
100113,Toys,32.842525482177734,2022-03-01,172,216,42.27692726135254,16459.902977905273,1,3,0,9,5325,4
100113,Toys,32.842525482177734,2022-03-02,69,0,40.99385452270508,2828.5759620666504,2,3,0,9,5394,4
100113,Toys,32.842525482177734,2022-03-03,104,83,33.8126456451416,6393.790294189454,3,3,0,9,5498,4
100113,Toys,32.842525482177734,2022-03-04,113,143,33.63558807373047,8578.142904663086,4,3,0,9,5611,4
100113,Toys,32.842525482177734,2022-03-05,130,140,35.15483596801758,9493.357351684572,5,3,1,9,5741,4
100113,Toys,32.842525482177734,2022-03-06,92,0,34.999671936035156,3219.9698181152344,6,3,1,9,5833,4
100113,Toys,32.842525482177734,2022-03-07,74,90,32.25858352661133,5277.630361938476,0,3,0,10,5907,4
100113,Toys,32.842525482177734,2022-03-08,90,113,35.495529861450194,7221.5653750610345,1,3,0,10,5997,4
100113,Toys,32.842525482177734,2022-03-09,94,88,31.047612228393554,5659.471098937988,2,3,0,10,6091,4
100113,Toys,32.842525482177734,2022-03-10,107,187,33.09175048828125,9739.234604492187,3,3,0,10,6198,4
100113,Toys,32.842525482177734,2022-03-11,93,133,35.643632888793945,8099.715717315674,4,3,0,10,6291,4
100113,Toys,32.842525482177734,2022-03-12,138,0,34.53726577758789,4766.142677307129,5,3,1,10,6429,4
100113,Toys,32.842525482177734,2022-03-13,89,109,35.51620330810547,7037.884188842773,6,3,1,10,6518,4
100113,Toys,32.842525482177734,2022-03-14,109,151,35.45971656799317,9222.05821182251,0,3,0,11,6627,4
100113,Toys,32.842525482177734,2022-03-15,84,109,31.383412475585935,6015.913295898437,1,3,0,11,6711,4
100113,Toys,32.842525482177734,2022-03-16,118,209,36.87870384216309,12163.194106750489,2,3,0,11,6829,4
100113,Toys,32.842525482177734,2022-03-17,22,0,35.73740768432617,786.2229690551758,3,3,0,11,6851,4
100113,Toys,32.842525482177734,2022-03-18,71,0,35.73740768432617,2537.355945587158,4,3,0,11,6922,4
100113,Toys,32.842525482177734,2022-03-19,69,0,35.73740768432617,2465.881130218506,5,3,1,11,6991,4
100113,Toys,32.842525482177734,2022-03-20,48,67,31.376068572998047,3571.8425830078127,6,3,1,11,7039,4
100113,Toys,32.842525482177734,2022-03-21,110,197,40.22128623962402,12492.242972717286,0,3,0,12,7149,4
100113,Toys,32.842525482177734,2022-03-22,97,0,38.56257247924805,3740.5695304870605,1,3,0,12,7246,4
100113,Toys,32.842525482177734,2022-03-23,76,108,34.205255126953126,6245.598779296875,2,3,0,12,7322,4
100113,Toys,32.842525482177734,2022-03-24,146,217,41.605970306396486,15208.333329467774,3,3,0,12,7468,4
100113,Toys,32.842525482177734,2022-03-25,119,0,40.12194061279297,4774.510932922363,4,3,0,12,7587,4
100113,Toys,32.842525482177734,2022-03-26,87,142,35.257855300903316,8005.416822357178,5,3,1,12,7674,4
100113,Toys,32.842525482177734,2022-03-27,109,177,36.83932373046875,10542.892573242187,6,3,1,12,7783,4
100113,Toys,32.842525482177734,2022-03-28,49,0,36.7386474609375,1800.1937255859375,0,3,0,13,7832,4
100113,Toys,32.842525482177734,2022-03-29,172,172,41.682162322998046,14338.663839111327,1,3,0,13,8004,4
100113,Toys,32.842525482177734,2022-03-30,78,103,35.41287925720215,6357.159164123535,2,3,0,13,8082,4
100113,Toys,32.842525482177734,2022-03-31,97,0,37.5157585144043,3639.028575897217,3,3,0,13,8179,4
100113,Toys,32.842525482177734,2022-04-01,100,117,37.87303184509277,8220.266369018555,4,4,0,13,8279,4
100113,Toys,32.842525482177734,2022-04-02,76,66,32.87718490600586,4691.53210571289,5,4,1,13,8355,4
100113,Toys,32.842525482177734,2022-04-03,102,132,35.83846725463867,8391.947319946288,6,4,1,13,8457,4
100113,Toys,32.842525482177734,2022-04-04,113,120,28.50525291442871,6623.5571586608885,0,4,0,14,8570,4
100113,Toys,32.842525482177734,2022-04-05,107,153,34.38800117492676,8989.272251434326,1,4,0,14,8677,4
100113,Toys,32.842525482177734,2022-04-06,190,220,36.38151206970215,14943.974586486816,2,4,0,14,8867,4
100113,Toys,32.842525482177734,2022-04-07,111,0,35.4630241394043,3936.395679473877,3,4,0,14,8978,4
100113,Toys,32.842525482177734,2022-04-08,109,181,39.8213777923584,11620.82035873413,4,4,0,14,9087,4
100113,Toys,32.842525482177734,2022-04-09,107,0,38.8127555847168,4152.964847564697,5,4,1,14,9194,4
100113,Toys,32.842525482177734,2022-04-10,74,132,38.219814224243166,7865.752505187988,6,4,1,14,9268,4
100113,Toys,32.842525482177734,2022-04-11,74,92,34.29408721923828,5662.324908447266,0,4,0,15,9342,4
100113,Toys,32.842525482177734,2022-04-12,94,75,30.38272575378418,5187.932441711426,1,4,0,15,9436,4
100113,Toys,32.842525482177734,2022-04-13,73,98,32.646077957153324,5577.077381744384,2,4,0,15,9509,4
100113,Toys,32.842525482177734,2022-04-14,62,0,32.86215591430664,2037.4536666870117,3,4,0,15,9571,4
100113,Toys,32.842525482177734,2022-04-15,94,146,34.0345059967041,8183.127127380371,4,4,0,15,9665,4
100113,Toys,32.842525482177734,2022-04-16,68,95,29.671692085266113,4788.650123596191,5,4,1,15,9733,4
100113,Toys,32.842525482177734,2022-04-17,110,111,35.481435775756836,7843.165870666504,6,4,1,15,9843,4
100113,Toys,32.842525482177734,2022-04-18,122,0,33.71287155151367,4112.970329284668,0,4,0,16,9965,4
100113,Toys,32.842525482177734,2022-04-19,52,211,40.24355361938477,10697.969576416015,1,4,0,16,10017,4
100113,Toys,32.842525482177734,2022-04-20,145,229,44.04505668640137,16592.546439056394,2,4,0,16,10162,4
100113,Toys,32.842525482177734,2022-04-21,102,0,42.620113372802734,4347.251564025879,3,4,0,16,10264,4
100113,Toys,32.842525482177734,2022-04-22,175,158,41.64843620300293,13875.192671051025,4,4,0,16,10439,4
100113,Toys,32.842525482177734,2022-04-23,15,0,42.01687240600586,630.2530860900879,5,4,1,16,10454,4
100113,Toys,32.842525482177734,2022-04-24,20,0,42.01687240600586,840.3374481201172,6,4,1,16,10474,4
100113,Toys,32.842525482177734,2022-04-25,18,0,42.01687240600586,756.3037033081055,0,4,0,17,10492,4
100113,Toys,32.842525482177734,2022-04-26,44,0,42.01687240600586,1848.7423858642578,1,4,0,17,10536,4
100113,Toys,32.842525482177734,2022-04-27,17,50,29.606988372802732,1802.927604675293,2,4,0,17,10553,4
100113,Toys,32.842525482177734,2022-04-28,19,0,35.08397674560547,666.5955581665039,3,4,0,17,10572,4
100113,Toys,32.842525482177734,2022-04-29,19,50,29.102341995239257,1918.7089958190918,4,4,0,17,10591,4
100113,Toys,32.842525482177734,2022-04-30,45,77,31.69099739074707,3862.109765167236,5,4,1,17,10636,4
100113,Toys,32.842525482177734,2022-05-01,6,0,31.82199478149414,190.93196868896484,6,5,1,17,10642,4
100113,Toys,32.842525482177734,2022-05-02,32,0,31.82199478149414,1018.3038330078125,0,5,0,18,10674,4
100113,Toys,32.842525482177734,2022-05-03,51,54,30.29649829864502,3178.742826461792,1,5,0,18,10725,4
100113,Toys,32.842525482177734,2022-05-04,25,0,31.09299659729004,777.324914932251,2,5,0,18,10750,4
100113,Toys,32.842525482177734,2022-05-05,47,61,28.383272857666014,3048.6876486206056,3,5,0,18,10797,4
100113,Toys,32.842525482177734,2022-05-06,23,0,29.57654571533203,680.2605514526367,4,5,0,18,10820,4
100113,Toys,32.842525482177734,2022-05-07,36,50,27.38131206512451,2340.494468688965,5,5,1,18,10856,4
100113,Toys,32.842525482177734,2022-05-08,66,68,28.099274978637695,3765.044297180176,6,5,1,18,10922,4
100113,Toys,32.842525482177734,2022-05-09,34,50,23.63215866088867,1947.7867889404297,0,5,0,19,10956,4
100113,Toys,32.842525482177734,2022-05-10,53,79,27.856928787231446,3698.2544514465335,1,5,0,19,11009,4
100113,Toys,32.842525482177734,2022-05-11,11,0,27.04385757446289,297.4824333190918,2,5,0,19,11020,4
100113,Toys,32.842525482177734,2022-05-12,18,0,27.04385757446289,486.78943634033203,3,5,0,19,11038,4
100113,Toys,32.842525482177734,2022-05-13,25,0,27.04385757446289,676.0964393615723,4,5,0,19,11063,4
100113,Toys,32.842525482177734,2022-05-14,45,50,27.52890480041504,2616.4014320373535,5,5,1,19,11108,4
100113,Toys,32.842525482177734,2022-05-15,20,0,27.297809600830078,545.9561920166016,6,5,1,19,11128,4
100113,Toys,32.842525482177734,2022-05-16,42,50,27.80219627380371,2559.5444869995117,0,5,0,20,11170,4
100113,Toys,32.842525482177734,2022-05-17,47,58,29.926369743347166,3153.0887558746335,1,5,0,20,11217,4
100113,Toys,32.842525482177734,2022-05-18,25,50,25.659518508911134,1884.4759254455566,2,5,0,20,11242,4
100113,Toys,32.842525482177734,2022-05-19,22,0,27.259037017822266,599.6988143920898,3,5,0,20,11264,4
100113,Toys,32.842525482177734,2022-05-20,5,0,27.259037017822266,136.29518508911133,4,5,0,20,11269,4
100113,Toys,32.842525482177734,2022-05-21,46,50,24.303952636718748,2327.483642578125,5,5,1,20,11315,4
100113,Toys,32.842525482177734,2022-05-22,33,50,25.461281814575194,2111.054599761963,6,5,1,20,11348,4
100113,Toys,32.842525482177734,2022-05-23,41,0,25.59256362915039,1049.295108795166,0,5,0,21,11389,4
100113,Toys,32.842525482177734,2022-05-24,23,50,23.319256477355957,1676.405797958374,1,5,0,21,11412,4
100113,Toys,32.842525482177734,2022-05-25,36,0,24.278512954711914,874.0264663696289,2,5,0,21,11448,4
100113,Toys,32.842525482177734,2022-05-26,64,81,28.004775314331056,4078.6312402343747,3,5,0,21,11512,4
100113,Toys,32.842525482177734,2022-05-27,81,181,30.7205029296875,8117.721474609375,4,5,0,21,11593,4
100113,Toys,32.842525482177734,2022-05-28,156,159,36.620003585815425,11542.471118774414,5,5,1,21,11749,4
100113,Toys,32.842525482177734,2022-05-29,99,142,37.31650413513184,9045.457818756104,6,5,1,21,11848,4
100113,Toys,32.842525482177734,2022-05-30,109,0,36.10300827026367,3935.2279014587402,0,5,0,22,11957,4
100113,Toys,32.842525482177734,2022-05-31,118,149,35.72673278808594,9535.72893798828,1,5,0,22,12075,4
100113,Toys,32.842525482177734,2022-06-01,83,103,28.82963592529297,5303.519563598633,2,6,0,22,12158,4
100113,Toys,32.842525482177734,2022-06-02,66,0,31.769271850585938,2096.771942138672,3,6,0,22,12224,4
100113,Toys,32.842525482177734,2022-06-03,56,59,27.909089736938476,3204.148050537109,4,6,0,22,12280,4
100113,Toys,32.842525482177734,2022-06-04,41,51,25.820978088378908,2355.7202032470705,5,6,1,22,12321,4
100113,Toys,32.842525482177734,2022-06-05,106,132,28.804086380004883,6863.326312561036,6,6,1,22,12427,4
100113,Toys,32.842525482177734,2022-06-06,142,135,32.67158954620361,9039.961431121827,0,6,0,23,12569,4
100113,Toys,32.842525482177734,2022-06-07,89,93,29.442914695739745,5355.598815841675,1,6,0,23,12658,4
100113,Toys,32.842525482177734,2022-06-08,46,0,30.195829391479492,1389.0081520080566,2,6,0,23,12704,4
100113,Toys,32.842525482177734,2022-06-09,54,63,30.514621925354003,3571.4291679382322,3,6,0,23,12758,4
100113,Toys,32.842525482177734,2022-06-10,38,0,30.379243850708008,1154.4112663269043,4,6,0,23,12796,4
100113,Toys,32.842525482177734,2022-06-11,64,83,29.331535835266113,4306.196586914062,5,6,1,23,12860,4
100113,Toys,32.842525482177734,2022-06-12,71,99,31.519765892028808,5374.046756668091,6,6,1,23,12931,4
100113,Toys,32.842525482177734,2022-06-13,79,97,34.88968292236328,6166.329901733398,0,6,0,24,13010,4
100113,Toys,32.842525482177734,2022-06-14,72,100,33.33051933288574,5731.434783935547,1,6,0,24,13082,4
100113,Toys,32.842525482177734,2022-06-15,106,117,34.22223213195801,7635.273211975098,2,6,0,24,13188,4
100113,Toys,32.842525482177734,2022-06-16,93,109,33.797743682861324,6826.540325012207,3,6,0,24,13281,4
100113,Toys,32.842525482177734,2022-06-17,83,0,33.835487365722656,2808.3454513549805,4,6,0,24,13364,4
100113,Toys,32.842525482177734,2022-06-18,72,72,30.652266426086427,4413.926365356445,5,6,1,24,13436,4
100113,Toys,32.842525482177734,2022-06-19,101,192,35.10583198547363,10345.538061065674,6,6,1,24,13537,4
100113,Toys,32.842525482177734,2022-06-20,158,151,33.9535855102539,10493.013021240233,0,6,0,25,13695,4
100113,Toys,32.842525482177734,2022-06-21,70,0,34.14717102050781,2390.301971435547,1,6,0,25,13765,4
100113,Toys,32.842525482177734,2022-06-22,115,131,34.45584335327148,8477.64397125244,2,6,0,25,13880,4
100113,Toys,32.842525482177734,2022-06-23,33,0,34.36168670654297,1133.935661315918,3,6,0,25,13913,4
100113,Toys,32.842525482177734,2022-06-24,98,164,42.12424667358398,11154.41234802246,4,6,0,25,14011,4
100113,Toys,32.842525482177734,2022-06-25,147,135,38.38731307983399,10834.070045471191,5,6,1,25,14158,4
100113,Toys,32.842525482177734,2022-06-26,61,0,39.12462615966797,2386.602195739746,6,6,1,25,14219,4
100113,Toys,32.842525482177734,2022-06-27,80,68,30.66950096130371,4579.760153808594,0,6,0,26,14299,4
100113,Toys,32.842525482177734,2022-06-28,79,98,35.37263107299805,6268.125709533691,1,6,0,26,14378,4
100113,Toys,32.842525482177734,2022-06-29,25,0,34.995262145996094,874.8815536499023,2,6,0,26,14403,4
100113,Toys,32.842525482177734,2022-06-30,10,50,28.155952224731443,1573.919044494629,3,6,0,26,14413,4
100113,Toys,32.842525482177734,2022-07-01,33,0,31.04190444946289,1024.3828468322754,4,7,0,26,14446,4
100113,Toys,32.842525482177734,2022-07-02,11,0,31.04190444946289,341.4609489440918,5,7,1,26,14457,4
100113,Toys,32.842525482177734,2022-07-03,14,50,26.21908187866211,1607.134292602539,6,7,1,26,14471,4
100113,Toys,32.842525482177734,2022-07-04,20,0,28.18816375732422,563.7632751464844,0,7,0,27,14491,4
100113,Toys,32.842525482177734,2022-07-05,18,50,23.523311080932615,1530.9991989135742,1,7,0,27,14509,4
100113,Toys,32.842525482177734,2022-07-06,8,0,25.666622161865234,205.33297729492188,2,7,0,27,14517,4
100113,Toys,32.842525482177734,2022-07-07,16,0,25.666622161865234,410.66595458984375,3,7,0,27,14533,4
100113,Toys,32.842525482177734,2022-07-08,25,0,25.666622161865234,641.6655540466309,4,7,0,27,14558,4
100113,Toys,32.842525482177734,2022-07-09,45,50,24.82902633666992,2357.062370300293,5,7,1,27,14603,4
100113,Toys,32.842525482177734,2022-07-10,18,50,25.647633361816407,1750.5148010253906,6,7,1,27,14621,4
100113,Toys,32.842525482177734,2022-07-11,14,0,25.445266723632812,356.2337341308594,0,7,0,28,14635,4
100113,Toys,32.842525482177734,2022-07-12,20,0,25.445266723632812,508.90533447265625,1,7,0,28,14655,4
100113,Toys,32.842525482177734,2022-07-13,33,50,26.43080131530762,2200.7128868103027,2,7,0,28,14688,4
100113,Toys,32.842525482177734,2022-07-14,28,50,24.208627395629883,1869.6031341552734,3,7,0,28,14716,4
100113,Toys,32.842525482177734,2022-07-15,38,0,25.057254791259766,952.1756820678711,4,7,0,28,14754,4
100113,Toys,32.842525482177734,2022-07-16,25,50,25.24951747894287,1895.7258739471436,5,7,1,28,14779,4
100113,Toys,32.842525482177734,2022-07-17,14,0,25.169034957885742,352.3664894104004,6,7,1,28,14793,4
100113,Toys,32.842525482177734,2022-07-18,23,50,25.135300216674807,1834.463809967041,0,7,0,29,14816,4
100113,Toys,32.842525482177734,2022-07-19,11,0,25.15060043334961,276.6566047668457,1,7,0,29,14827,4
100113,Toys,32.842525482177734,2022-07-20,7,0,25.15060043334961,176.05420303344727,2,7,0,29,14834,4
100113,Toys,32.842525482177734,2022-07-21,24,50,25.10287097930908,1857.017807006836,3,7,0,29,14858,4
100113,Toys,32.842525482177734,2022-07-22,40,0,25.125741958618164,1005.0296783447266,4,7,0,29,14898,4
100113,Toys,32.842525482177734,2022-07-23,14,50,20.74128070831299,1258.2758598327637,5,7,1,29,14912,4
100113,Toys,32.842525482177734,2022-07-24,52,0,22.662561416625977,1178.4531936645508,6,7,1,29,14964,4
100113,Toys,32.842525482177734,2022-07-25,62,86,26.075671424865725,3880.90325668335,0,7,0,30,15026,4
100113,Toys,32.842525482177734,2022-07-26,86,162,34.86640090942383,8801.420956420898,1,7,0,30,15112,4
100113,Toys,32.842525482177734,2022-07-27,67,0,32.832801818847656,2199.797721862793,2,7,0,30,15179,4
100113,Toys,32.842525482177734,2022-07-28,82,90,30.363151435852053,5215.636835479736,3,7,0,30,15261,4
100113,Toys,32.842525482177734,2022-07-29,48,67,32.55723220825195,3755.1542919921876,4,7,0,30,15309,4
100113,Toys,32.842525482177734,2022-07-30,86,94,31.052742691040038,5586.591742858887,5,7,1,30,15395,4
100113,Toys,32.842525482177734,2022-07-31,96,93,31.432854385375975,5940.788041992188,6,7,1,30,15491,4
100113,Toys,32.842525482177734,2022-08-01,111,87,31.611576766967772,6257.210042266846,0,8,0,31,15602,4
100113,Toys,32.842525482177734,2022-08-02,103,107,31.749653968811035,6667.708717575073,1,8,0,31,15705,4
100113,Toys,32.842525482177734,2022-08-03,89,128,32.08145961761475,6966.299811935425,2,8,0,31,15794,4
100113,Toys,32.842525482177734,2022-08-04,132,91,32.92967575073242,7325.67439819336,3,8,0,31,15926,4
100113,Toys,32.842525482177734,2022-08-05,47,69,29.497218704223634,3393.1385581970217,4,8,0,31,15973,4
100113,Toys,32.842525482177734,2022-08-06,123,154,35.574454650878906,9897.385844116212,5,8,1,31,16096,4
100113,Toys,32.842525482177734,2022-08-07,109,136,28.812020225524904,7005.7004091644285,6,8,1,31,16205,4
100113,Toys,32.842525482177734,2022-08-08,73,0,30.784040451049805,2247.2349529266357,0,8,0,32,16278,4
100113,Toys,32.842525482177734,2022-08-09,84,110,32.964442825317384,6414.22639465332,1,8,0,32,16362,4
100113,Toys,32.842525482177734,2022-08-10,63,0,32.228885650634766,2030.4197959899902,2,8,0,32,16425,4
100113,Toys,32.842525482177734,2022-08-11,75,101,35.22010292053223,6219.795438079835,3,8,0,32,16500,4
100113,Toys,32.842525482177734,2022-08-12,101,124,31.098423309326172,6975.101508483887,4,8,0,32,16601,4
100113,Toys,32.842525482177734,2022-08-13,88,134,33.55583061218262,7471.206187744141,5,8,1,32,16689,4
100113,Toys,32.842525482177734,2022-08-14,42,0,33.081661224365234,1389.4297714233398,6,8,1,32,16731,4
100113,Toys,32.842525482177734,2022-08-15,60,106,33.915924301147456,5644.4909161376945,0,8,0,33,16791,4
100113,Toys,32.842525482177734,2022-08-16,107,146,31.430689392089846,7920.347529907227,1,8,0,33,16898,4
100113,Toys,32.842525482177734,2022-08-17,86,0,32.24137878417969,2772.758575439453,2,8,0,33,16984,4
100113,Toys,32.842525482177734,2022-08-18,97,162,32.232500305175776,8348.0550592041,3,8,0,33,17081,4
100113,Toys,32.842525482177734,2022-08-19,68,0,32.23500061035156,2191.9800415039062,4,8,0,33,17149,4
100113,Toys,32.842525482177734,2022-08-20,65,78,33.43747459411621,4788.481697235107,5,8,1,33,17214,4
100113,Toys,32.842525482177734,2022-08-21,81,0,32.90494918823242,2665.300884246826,6,8,1,33,17295,4
100113,Toys,32.842525482177734,2022-08-22,56,55,31.001969032287597,3441.860531616211,0,8,0,34,17351,4
100113,Toys,32.842525482177734,2022-08-23,55,219,42.06716560363769,11717.108216400145,1,8,0,34,17406,4
100113,Toys,32.842525482177734,2022-08-24,89,0,40.90433120727539,3640.4854774475098,2,8,0,34,17495,4
100113,Toys,32.842525482177734,2022-08-25,47,84,34.14061424255371,4363.247738800049,3,8,0,34,17542,4
100113,Toys,32.842525482177734,2022-08-26,67,0,37.09122848510742,2485.1123085021973,4,8,0,34,17609,4
100113,Toys,32.842525482177734,2022-08-27,100,201,32.83738052368164,9798.466104736328,5,8,1,34,17709,4
100113,Toys,32.842525482177734,2022-08-28,84,0,33.68476104736328,2829.5199279785156,6,8,1,34,17793,4
100113,Toys,32.842525482177734,2022-08-29,84,117,31.22868927001953,6249.949797363281,0,8,0,35,17877,4
100113,Toys,32.842525482177734,2022-08-30,73,0,32.04737854003906,2339.4586334228516,1,8,0,35,17950,4
100113,Toys,32.842525482177734,2022-08-31,56,82,32.6935474395752,4517.077313232421,2,8,0,35,18006,4
100113,Toys,32.842525482177734,2022-09-01,74,77,31.58966850280762,4768.960938415527,3,9,0,35,18080,4
100113,Toys,32.842525482177734,2022-09-02,68,77,32.22685615539551,4673.912437133789,4,9,0,35,18148,4
100113,Toys,32.842525482177734,2022-09-03,83,99,29.785436477661133,5407.262455291748,5,9,1,35,18231,4
100113,Toys,32.842525482177734,2022-09-04,118,80,30.412711410522462,6025.6198928833,6,9,1,35,18349,4
100113,Toys,32.842525482177734,2022-09-05,61,70,28.81050437927246,3768.05153427124,0,9,0,36,18410,4
100113,Toys,32.842525482177734,2022-09-06,71,73,30.34766540527344,4370.7684875488285,1,9,0,36,18481,4
100113,Toys,32.842525482177734,2022-09-07,75,115,30.204782257080076,5741.517338562011,2,9,0,36,18556,4
100113,Toys,32.842525482177734,2022-09-08,62,81,28.127060737609863,4004.175531463623,3,9,0,36,18618,4
100113,Toys,32.842525482177734,2022-09-09,148,188,34.207581405639644,11555.844096069335,4,9,0,36,18766,4
100113,Toys,32.842525482177734,2022-09-10,65,0,32.6551628112793,2122.5855827331543,5,9,1,36,18831,4
100113,Toys,32.842525482177734,2022-09-11,125,139,28.498795089721682,7504.37877243042,6,9,1,36,18956,4
100113,Toys,32.842525482177734,2022-09-12,57,88,31.758403244018556,4631.987969818116,0,9,0,37,19013,4
100113,Toys,32.842525482177734,2022-09-13,90,0,30.88680648803711,2779.81258392334,1,9,0,37,19103,4
100113,Toys,32.842525482177734,2022-09-14,93,128,34.418807678222656,7639.498228149414,2,9,0,37,19196,4
100113,Toys,32.842525482177734,2022-09-15,114,113,28.4411092376709,6457.952906188964,3,9,0,37,19310,4
100113,Toys,32.842525482177734,2022-09-16,79,64,29.593198661804202,4236.825388565064,4,9,0,37,19389,4
100113,Toys,32.842525482177734,2022-09-17,96,123,29.601609230041504,6480.008972167969,5,9,1,37,19485,4
100113,Toys,32.842525482177734,2022-09-18,55,0,29.703218460083008,1633.6770153045654,6,9,1,37,19540,4
100113,Toys,32.842525482177734,2022-09-19,84,148,34.90920379638672,8172.586237792969,0,9,0,38,19624,4
100113,Toys,32.842525482177734,2022-09-20,26,0,33.75840759277344,877.7185974121094,1,9,0,38,19650,4
100113,Toys,32.842525482177734,2022-09-21,85,78,30.882214126586916,5042.636401519776,2,9,0,38,19735,4
100113,Toys,32.842525482177734,2022-09-22,115,108,33.73677017211914,7519.427139587402,3,9,0,38,19850,4
100113,Toys,32.842525482177734,2022-09-23,54,93,29.677816696166992,4312.414203186036,4,9,0,38,19904,4
100113,Toys,32.842525482177734,2022-09-24,120,201,39.4407162475586,12844.281899414063,5,9,1,38,20024,4
100113,Toys,32.842525482177734,2022-09-25,90,0,37.17143249511719,3345.428924560547,6,9,1,38,20114,4
100113,Toys,32.842525482177734,2022-09-26,84,92,31.906430435180663,5597.480313110351,0,9,0,39,20198,4
100113,Toys,32.842525482177734,2022-09-27,102,103,28.06091941833496,5749.957561340332,1,9,0,39,20300,4
100113,Toys,32.842525482177734,2022-09-28,130,154,32.78986740112305,9329.365524291992,2,9,0,39,20430,4
100113,Toys,32.842525482177734,2022-09-29,71,0,32.079734802246094,2277.6611709594727,3,9,0,39,20501,4
100113,Toys,32.842525482177734,2022-09-30,100,160,38.73533454895019,10166.26690979004,4,9,0,39,20601,4
100113,Toys,32.842525482177734,2022-10-01,83,88,34.061183853149416,5817.106519622803,5,10,1,39,20684,4
100113,Toys,32.842525482177734,2022-10-02,116,128,35.8826978302002,8757.025896606447,6,10,1,39,20800,4
100113,Toys,32.842525482177734,2022-10-03,48,0,35.74539566040039,1715.7789916992188,0,10,0,40,20848,4
100113,Toys,32.842525482177734,2022-10-04,25,0,35.74539566040039,893.6348915100098,1,10,0,40,20873,4
100113,Toys,32.842525482177734,2022-10-05,77,112,33.25852142333984,6258.262299194335,2,10,0,40,20950,4
100113,Toys,32.842525482177734,2022-10-06,101,100,32.88604362487793,6610.570812225342,3,10,0,40,21051,4
100113,Toys,32.842525482177734,2022-10-07,138,169,31.585159454345703,9680.674009399414,4,10,0,40,21189,4
100113,Toys,32.842525482177734,2022-10-08,114,116,32.325217208862306,7434.989523620606,5,10,1,40,21303,4
100113,Toys,32.842525482177734,2022-10-09,58,0,32.23043441772461,1869.3651962280273,6,10,1,40,21361,4
100113,Toys,32.842525482177734,2022-10-10,90,105,30.615112686157225,5961.470283508301,0,10,0,41,21451,4
100113,Toys,32.842525482177734,2022-10-11,62,94,33.79916351318359,5306.616275634766,1,10,0,41,21513,4
100113,Toys,32.842525482177734,2022-10-12,41,0,32.73832702636719,1342.2714080810547,2,10,0,41,21554,4
100113,Toys,32.842525482177734,2022-10-13,95,90,30.321772270202636,5614.336731338501,3,10,0,41,21649,4
100113,Toys,32.842525482177734,2022-10-14,38,0,31.283544540405273,1188.7746925354004,4,10,0,41,21687,4
100113,Toys,32.842525482177734,2022-10-15,76,198,38.76530967712402,10768.667070922851,5,10,1,41,21763,4
100113,Toys,32.842525482177734,2022-10-16,81,0,37.56061935424805,3042.410167694092,6,10,1,41,21844,4
100113,Toys,32.842525482177734,2022-10-17,117,123,35.50315086364746,8516.777302093506,0,10,0,42,21961,4
100113,Toys,32.842525482177734,2022-10-18,79,101,30.55402931213379,5452.996631317139,1,10,0,42,22040,4
100113,Toys,32.842525482177734,2022-10-19,74,97,31.89495590209961,5446.333473510742,2,10,0,42,22114,4
100113,Toys,32.842525482177734,2022-10-20,57,0,32.22991180419922,1837.1049728393555,3,10,0,42,22171,4
100113,Toys,32.842525482177734,2022-10-21,52,63,27.278851013183594,3111.5605053710938,4,10,0,42,22223,4
100113,Toys,32.842525482177734,2022-10-22,122,152,35.93507194519043,9900.657554626465,5,10,1,42,22345,4
100113,Toys,32.842525482177734,2022-10-23,126,224,37.439177169799805,13186.112646789552,6,10,1,42,22471,4
100113,Toys,32.842525482177734,2022-10-24,160,0,36.59835433959961,5855.7366943359375,0,10,0,43,22631,4
100113,Toys,32.842525482177734,2022-10-25,90,92,34.04777954101563,6195.020317382812,1,10,0,43,22721,4
100113,Toys,32.842525482177734,2022-10-26,54,95,32.4308332824707,4799.359994506836,2,10,0,43,22775,4
100113,Toys,32.842525482177734,2022-10-27,52,0,33.231666564941406,1728.0466613769531,3,10,0,43,22827,4
100113,Toys,32.842525482177734,2022-10-28,7,0,33.231666564941406,232.62166595458984,4,10,0,43,22834,4
100113,Toys,32.842525482177734,2022-10-29,63,100,32.49811210632324,5289.8621253967285,5,10,1,43,22897,4
100113,Toys,32.842525482177734,2022-10-30,81,111,33.11155700683594,6361.572235107422,6,10,1,43,22978,4
100113,Toys,32.842525482177734,2022-10-31,98,99,33.92435279846191,6683.493148498535,0,10,0,44,23076,4
100113,Toys,32.842525482177734,2022-11-01,137,112,35.18672470092773,8745.412568054198,1,11,0,44,23213,4
100113,Toys,32.842525482177734,2022-11-02,117,131,34.7394832611084,8616.239083099365,2,11,0,44,23330,4
100113,Toys,32.842525482177734,2022-11-03,56,0,34.6789665222168,1942.0221252441406,3,11,0,44,23386,4
100113,Toys,32.842525482177734,2022-11-04,75,159,34.96534706115723,8186.482059173584,4,11,0,44,23461,4
100113,Toys,32.842525482177734,2022-11-05,69,88,34.91700454711914,5482.026627502441,5,11,1,44,23530,4
100113,Toys,32.842525482177734,2022-11-06,56,0,34.91400909423828,1955.1845092773438,6,11,1,44,23586,4
100113,Toys,32.842525482177734,2022-11-07,62,0,34.91400909423828,2164.6685638427734,0,11,0,45,23648,4
100113,Toys,32.842525482177734,2022-11-08,60,72,30.150911331176758,3963.109359741211,1,11,0,45,23708,4
100113,Toys,32.842525482177734,2022-11-09,68,65,28.15186569213867,3747.8337341308597,2,11,0,45,23776,4
100113,Toys,32.842525482177734,2022-11-10,69,103,28.729207191467285,4936.010592422485,3,11,0,45,23845,4
100113,Toys,32.842525482177734,2022-11-11,83,80,30.276412162780762,4933.424419021607,4,11,0,45,23928,4
100113,Toys,32.842525482177734,2022-11-12,84,135,27.132728424072265,5906.228375244141,5,11,1,45,24012,4
100113,Toys,32.842525482177734,2022-11-13,131,119,32.51393321990967,8106.690503616333,6,11,1,45,24143,4
100113,Toys,32.842525482177734,2022-11-14,63,81,31.24659824371338,4504.071378707886,0,11,0,46,24206,4
100113,Toys,32.842525482177734,2022-11-15,60,0,30.993196487426758,1859.5917892456055,1,11,0,46,24266,4
100113,Toys,32.842525482177734,2022-11-16,97,152,34.71879631042481,8694.546484222412,2,11,0,46,24363,4
100113,Toys,32.842525482177734,2022-11-17,106,95,35.74387435913086,7175.101364135742,3,11,0,46,24469,4
100113,Toys,32.842525482177734,2022-11-18,122,161,35.42606346130371,10031.969484558107,4,11,0,46,24591,4
100113,Toys,32.842525482177734,2022-11-19,57,0,35.26212692260742,2009.941234588623,5,11,1,46,24648,4
100113,Toys,32.842525482177734,2022-11-20,85,106,32.86875831604004,6259.478913726807,6,11,1,46,24733,4
100113,Toys,32.842525482177734,2022-11-21,109,113,29.35825366973877,6510.699300003052,0,11,0,47,24842,4
100113,Toys,32.842525482177734,2022-11-22,60,0,31.06650733947754,1863.9904403686523,1,11,0,47,24902,4
100113,Toys,32.842525482177734,2022-11-23,88,199,35.048906097412114,10139.07747314453,2,11,0,47,24990,4
100113,Toys,32.842525482177734,2022-11-24,114,0,34.32781219482422,3913.370590209961,3,11,0,47,25104,4
100113,Toys,32.842525482177734,2022-11-25,40,52,32.00475929260254,2931.900743408203,4,11,0,47,25144,4
100113,Toys,32.842525482177734,2022-11-26,97,85,34.95701522827149,6353.860954284668,5,11,1,47,25241,4
100113,Toys,32.842525482177734,2022-11-27,79,96,30.565062370300293,5329.589854507446,6,11,1,47,25320,4
100113,Toys,32.842525482177734,2022-11-28,84,69,29.81231773376465,4573.319379272461,0,11,0,48,25404,4
100113,Toys,32.842525482177734,2022-11-29,87,114,30.540481338500975,6138.08375289917,1,11,0,48,25491,4
100113,Toys,32.842525482177734,2022-11-30,91,85,32.122989654541016,5649.884117126465,2,11,0,48,25582,4
100113,Toys,32.842525482177734,2022-12-01,87,95,29.759374084472654,5411.171090698243,3,12,0,48,25669,4
100113,Toys,32.842525482177734,2022-12-02,92,169,37.2793936920166,9865.488439331055,4,12,0,48,25761,4
100113,Toys,32.842525482177734,2022-12-03,121,162,34.82790962219238,9845.724128570557,5,12,1,48,25882,4
100113,Toys,32.842525482177734,2022-12-04,81,0,35.085819244384766,2841.951358795166,6,12,1,48,25963,4
100113,Toys,32.842525482177734,2022-12-05,138,113,37.18327201843262,9311.833077087402,0,12,0,49,26101,4
100113,Toys,32.842525482177734,2022-12-06,48,67,30.601738357543944,3465.966882324219,1,12,0,49,26149,4
100113,Toys,32.842525482177734,2022-12-07,129,128,35.51118339538574,9125.605316009522,2,12,0,49,26278,4
100113,Toys,32.842525482177734,2022-12-08,74,85,33.94732765197754,5393.584492492675,3,12,0,49,26352,4
100113,Toys,32.842525482177734,2022-12-09,55,0,34.31465530395508,1887.3060417175293,4,12,0,49,26407,4
100113,Toys,32.842525482177734,2022-12-10,102,177,36.3702059173584,10181.772007141113,5,12,1,49,26509,4
100113,Toys,32.842525482177734,2022-12-11,77,0,35.9104118347168,2765.1017112731934,6,12,1,49,26586,4
100113,Toys,32.842525482177734,2022-12-12,84,101,33.52114700317382,6187.962696533203,0,12,0,50,26670,4
100113,Toys,32.842525482177734,2022-12-13,104,128,36.18316055297852,8408.577395019533,1,12,0,50,26774,4
100113,Toys,32.842525482177734,2022-12-14,75,143,33.6219571685791,7285.253575286865,2,12,0,50,26849,4
100113,Toys,32.842525482177734,2022-12-15,62,0,34.2739143371582,2124.9826889038086,3,12,0,50,26911,4
100113,Toys,32.842525482177734,2022-12-16,84,105,27.43572479248047,5126.221765136719,4,12,0,50,26995,4
100113,Toys,32.842525482177734,2022-12-17,69,0,30.251449584960938,2087.3500213623047,5,12,1,50,27064,4
100113,Toys,32.842525482177734,2022-12-18,99,132,32.81173789978027,7602.554104156494,6,12,1,50,27163,4
100113,Toys,32.842525482177734,2022-12-19,132,153,35.54564765930176,10152.230982055664,0,12,0,51,27295,4
100113,Toys,32.842525482177734,2022-12-20,74,115,29.208392066955568,5433.532025909424,1,12,0,51,27369,4
100113,Toys,32.842525482177734,2022-12-21,38,0,31.326784133911133,1190.417797088623,2,12,0,51,27407,4
100113,Toys,32.842525482177734,2022-12-22,87,92,31.91850444793701,5714.76977394104,3,12,0,51,27494,4
100113,Toys,32.842525482177734,2022-12-23,69,0,31.647008895874023,2183.6436138153076,4,12,0,51,27563,4
100113,Toys,32.842525482177734,2022-12-24,92,116,32.33472312927246,6730.309055786132,5,12,1,51,27655,4
100113,Toys,32.842525482177734,2022-12-25,116,119,35.431309585571285,8329.593823852538,6,12,1,51,27771,4
100113,Toys,32.842525482177734,2022-12-26,119,168,40.08164123535156,11576.85061401367,0,12,0,52,27890,4
100113,Toys,32.842525482177734,2022-12-27,47,0,38.583282470703125,1813.4142761230469,1,12,0,52,27937,4
100113,Toys,32.842525482177734,2022-12-28,121,184,36.87315902709961,11219.654484558105,2,12,0,52,28058,4
100113,Toys,32.842525482177734,2022-12-29,105,0,37.29631805419922,3916.113395690918,3,12,0,52,28163,4
100113,Toys,32.842525482177734,2022-12-30,3,0,37.29631805419922,111.88895416259766,4,12,0,52,28166,4
100113,Toys,32.842525482177734,2022-12-31,76,69,33.06330993652344,4804.703110351562,5,12,1,52,28242,4
100113,Toys,32.842525482177734,2023-01-01,69,117,34.02364654541016,6322.463223266601,6,1,1,52,28311,4
100113,Toys,32.842525482177734,2023-01-02,61,90,31.5666259765625,4737.078369140625,0,1,0,1,28372,4
100113,Toys,32.842525482177734,2023-01-03,100,185,37.04700210571289,10665.750421142578,1,1,0,1,28472,4
100113,Toys,32.842525482177734,2023-01-04,106,0,35.78400421142578,3793.104446411133,2,1,0,1,28578,4
100113,Toys,32.842525482177734,2023-01-05,76,82,32.70273071289063,5159.035068359375,3,1,0,1,28654,4
100113,Toys,32.842525482177734,2023-01-06,131,199,41.533266372680664,13832.235789642335,4,1,0,1,28785,4
100113,Toys,32.842525482177734,2023-01-07,175,144,32.28880477905273,10393.711672668458,5,1,1,1,28960,4
100113,Toys,32.842525482177734,2023-01-08,134,133,35.201192932128905,9398.759705810546,6,1,1,1,29094,4
100113,Toys,32.842525482177734,2023-01-09,100,160,32.89496604919434,8504.393209838869,0,1,0,2,29194,4
100113,Toys,32.842525482177734,2023-01-10,89,0,33.69993209838867,2999.293956756592,1,1,0,2,29283,4
100113,Toys,32.842525482177734,2023-01-11,72,90,31.056953506469725,5010.58130493164,2,1,0,2,29355,4
100113,Toys,32.842525482177734,2023-01-12,96,94,31.788418579101563,6040.1763671875,3,1,0,2,29451,4
100113,Toys,32.842525482177734,2023-01-13,118,110,32.41116134643555,7388.31407775879,4,1,0,2,29569,4
100113,Toys,32.842525482177734,2023-01-14,100,76,32.77441169738769,5761.922339477539,5,1,1,2,29669,4
100113,Toys,32.842525482177734,2023-01-15,94,122,34.46720558166504,7463.194649353027,6,1,1,2,29763,4
100113,Toys,32.842525482177734,2023-01-16,117,124,33.86204666137695,8160.878918762207,0,1,0,3,29880,4
100113,Toys,32.842525482177734,2023-01-17,32,0,33.844093322753906,1083.010986328125,1,1,0,3,29912,4
100113,Toys,32.842525482177734,2023-01-18,91,151,29.33886219024658,7020.8729186248775,2,1,0,3,30003,4
100113,Toys,32.842525482177734,2023-01-19,63,0,30.657724380493164,1931.4366359710693,3,1,0,3,30066,4
100113,Toys,32.842525482177734,2023-01-20,71,117,33.511887664794926,6345.228048400879,4,1,0,3,30137,4
100113,Toys,32.842525482177734,2023-01-21,102,127,33.70409103393555,7729.884570922852,5,1,1,3,30239,4
100113,Toys,32.842525482177734,2023-01-22,85,0,33.238182067871094,2825.245475769043,6,1,1,3,30324,4
100113,Toys,32.842525482177734,2023-01-23,99,131,29.315112075805665,6705.832191009522,0,1,0,4,30423,4
100113,Toys,32.842525482177734,2023-01-24,89,0,30.460224151611328,2710.959949493408,1,1,0,4,30512,4
100113,Toys,32.842525482177734,2023-01-25,51,109,27.91294273376465,4438.060158843994,2,1,0,4,30563,4
100113,Toys,32.842525482177734,2023-01-26,109,82,29.992516937255857,5711.358692321777,3,1,0,4,30672,4
100113,Toys,32.842525482177734,2023-01-27,24,50,28.448457260131836,2094.565948486328,4,1,0,4,30696,4
100113,Toys,32.842525482177734,2023-01-28,31,50,28.14147735595703,2272.401596069336,5,1,1,4,30727,4
100113,Toys,32.842525482177734,2023-01-29,10,0,28.512954711914062,285.1295471191406,6,1,1,4,30737,4
100113,Toys,32.842525482177734,2023-01-30,16,0,28.512954711914062,456.207275390625,0,1,0,5,30753,4
100113,Toys,32.842525482177734,2023-01-31,27,50,26.6540673828125,2030.879638671875,1,1,0,5,30780,4
100113,Toys,32.842525482177734,2023-02-01,31,0,27.588134765625,855.232177734375,2,2,0,5,30811,4
100113,Toys,32.842525482177734,2023-02-02,50,50,26.617645454406738,2661.764545440674,3,2,0,5,30861,4
100113,Toys,32.842525482177734,2023-02-03,39,57,26.84014057159424,2574.6709645843507,4,2,0,5,30900,4
100113,Toys,32.842525482177734,2023-02-04,46,0,26.950281143188477,1239.71293258667,5,2,1,5,30946,4
100113,Toys,32.842525482177734,2023-02-05,30,50,26.54116672515869,2120.0700035095215,6,2,1,5,30976,4
100113,Toys,32.842525482177734,2023-02-06,9,0,26.702333450317383,240.32100105285645,0,2,0,6,30985,4
100113,Toys,32.842525482177734,2023-02-07,24,50,25.694989089965823,1890.1194763183594,1,2,0,6,31009,4
100113,Toys,32.842525482177734,2023-02-08,11,0,26.12997817993164,287.42975997924805,2,2,0,6,31020,4
100113,Toys,32.842525482177734,2023-02-09,29,50,22.53350368499756,1744.1632137298584,3,2,0,6,31049,4
100113,Toys,32.842525482177734,2023-02-10,8,0,24.247007369995117,193.97605895996094,4,2,0,6,31057,4
100113,Toys,32.842525482177734,2023-02-11,49,50,27.587171096801757,2732.8327674865723,5,2,1,6,31106,4
100113,Toys,32.842525482177734,2023-02-12,36,0,25.884342193603516,931.8363189697266,6,2,1,6,31142,4
100113,Toys,32.842525482177734,2023-02-13,12,50,22.756889572143557,1362.4053497314453,0,2,0,7,31154,4
100113,Toys,32.842525482177734,2023-02-14,21,0,24.03377914428711,504.7093620300293,1,2,0,7,31175,4
100113,Toys,32.842525482177734,2023-02-15,49,52,27.47320713043213,2779.4642987823486,2,2,0,7,31224,4
100113,Toys,32.842525482177734,2023-02-16,16,0,25.916414260864258,414.6626281738281,3,2,0,7,31240,4
100113,Toys,32.842525482177734,2023-02-17,32,50,24.842960662841797,2028.969482421875,4,2,0,7,31272,4
100113,Toys,32.842525482177734,2023-02-18,25,50,25.569605445861818,1920.9802722930908,5,2,1,7,31297,4
100113,Toys,32.842525482177734,2023-02-19,16,0,25.439210891723633,407.0273742675781,6,2,1,7,31313,4
100113,Toys,32.842525482177734,2023-02-20,54,61,26.680749053955076,3072.2008978271483,0,2,0,8,31367,4
100113,Toys,32.842525482177734,2023-02-21,22,0,26.121498107910156,574.6729583740234,1,2,0,8,31389,4
100113,Toys,32.842525482177734,2023-02-22,21,50,26.99065715789795,1927.9176006317139,2,2,0,8,31410,4
100113,Toys,32.842525482177734,2023-02-23,12,0,26.5913143157959,319.0957717895508,3,2,0,8,31422,4
100113,Toys,32.842525482177734,2023-02-24,9,0,26.5913143157959,239.3218288421631,4,2,0,8,31431,4
100113,Toys,32.842525482177734,2023-02-25,32,50,26.30700107574463,2154.7080688476562,5,2,1,8,31463,4
100113,Toys,32.842525482177734,2023-02-26,36,0,26.444002151489258,951.9840774536133,6,2,1,8,31499,4
100113,Toys,32.842525482177734,2023-02-27,14,50,22.500200538635255,1379.165615081787,0,2,0,9,31513,4
100113,Toys,32.842525482177734,2023-02-28,26,0,24.190401077270508,628.9504280090332,1,2,0,9,31539,4
100113,Toys,32.842525482177734,2023-03-01,55,57,27.210155487060547,3050.11710357666,2,3,0,9,31594,4
100113,Toys,32.842525482177734,2023-03-02,71,96,31.172287254333497,5246.714790115357,3,3,0,9,31665,4
100113,Toys,32.842525482177734,2023-03-03,112,180,40.15087791442871,11895.356652832032,4,3,0,9,31777,4
100113,Toys,32.842525482177734,2023-03-04,102,0,37.63175582885742,3838.439094543457,5,3,1,9,31879,4
100113,Toys,32.842525482177734,2023-03-05,78,168,37.52930343627929,9230.47133605957,6,3,1,9,31957,4
100113,Toys,32.842525482177734,2023-03-06,93,0,37.548606872558594,3492.020439147949,0,3,0,10,32050,4
100113,Toys,32.842525482177734,2023-03-07,75,254,43.7608292388916,14540.36438583374,1,3,0,10,32125,4
100113,Toys,32.842525482177734,2023-03-08,110,0,42.9616584777832,4725.782432556152,2,3,0,10,32235,4
100113,Toys,32.842525482177734,2023-03-09,126,157,41.469234466552734,11721.247085571289,3,3,0,10,32361,4
100113,Toys,32.842525482177734,2023-03-10,112,146,34.46903701782227,8797.844291992187,4,3,0,10,32473,4
100113,Toys,32.842525482177734,2023-03-11,151,201,40.5182413482666,14318.008887176515,5,3,1,10,32624,4
100113,Toys,32.842525482177734,2023-03-12,117,0,39.4064826965332,4610.558475494385,6,3,1,10,32741,4
100113,Toys,32.842525482177734,2023-03-13,120,183,39.84689270019531,12081.364248046875,0,3,0,11,32861,4
100113,Toys,32.842525482177734,2023-03-14,149,221,43.47229583740234,16170.264159545897,1,3,0,11,33010,4
100113,Toys,32.842525482177734,2023-03-15,195,0,42.28459167480469,8245.495376586914,2,3,0,11,33205,4
100113,Toys,32.842525482177734,2023-03-16,82,238,40.18808883666992,12812.126569213868,3,3,0,11,33287,4
100113,Toys,32.842525482177734,2023-03-17,179,0,40.496177673339844,7248.815803527832,4,3,0,11,33466,4
100113,Toys,32.842525482177734,2023-03-18,59,207,39.69938926696777,10545.327933502198,5,3,1,11,33525,4
100113,Toys,32.842525482177734,2023-03-19,111,144,42.10540977478027,10768.71097000122,6,3,1,11,33636,4
100113,Toys,32.842525482177734,2023-03-20,119,172,40.41732650756836,11745.683708801269,0,3,0,12,33755,4
100113,Toys,32.842525482177734,2023-03-21,105,0,40.71465301513672,4275.0385665893555,1,3,0,12,33860,4
100113,Toys,32.842525482177734,2023-03-22,167,180,37.85205894470215,13121.897687530516,2,3,0,12,34027,4
100113,Toys,32.842525482177734,2023-03-23,56,0,38.8341178894043,2174.7106018066406,3,3,0,12,34083,4
100113,Toys,32.842525482177734,2023-03-24,135,183,40.085041732788085,12764.081267852784,4,3,0,12,34218,4
100113,Toys,32.842525482177734,2023-03-25,139,0,39.73008346557617,5522.481601715088,5,3,1,12,34357,4
100113,Toys,32.842525482177734,2023-03-26,54,116,34.23713073730469,5756.010119628907,6,3,1,12,34411,4
100113,Toys,32.842525482177734,2023-03-27,116,110,38.02896903991699,8588.840817260741,0,3,0,13,34527,4
100113,Toys,32.842525482177734,2023-03-28,110,131,32.95048355102539,7915.436381225586,1,3,0,13,34637,4
100113,Toys,32.842525482177734,2023-03-29,72,103,33.457385864257816,5846.443564453125,2,3,0,13,34709,4
100113,Toys,32.842525482177734,2023-03-30,135,123,37.589460906982424,9679.714444885252,3,3,0,13,34844,4
100113,Toys,32.842525482177734,2023-03-31,150,159,40.345952377319335,12479.2657131958,4,3,0,13,34994,4
100113,Toys,32.842525482177734,2023-04-01,61,0,38.97190475463867,2377.286190032959,5,4,1,13,35055,4
100113,Toys,32.842525482177734,2023-04-02,96,109,35.65779441833496,7296.486528320313,6,4,1,13,35151,4
100113,Toys,32.842525482177734,2023-04-03,111,123,33.70632614135742,7876.164403381348,0,4,0,14,35262,4
100113,Toys,32.842525482177734,2023-04-04,44,0,34.632652282714844,1523.8367004394531,1,4,0,14,35306,4
100113,Toys,32.842525482177734,2023-04-05,79,184,39.788743591308595,10560.121487426757,2,4,0,14,35385,4
100113,Toys,32.842525482177734,2023-04-06,71,0,38.87748718261719,2760.3015899658203,3,4,0,14,35456,4
100113,Toys,32.842525482177734,2023-04-07,113,207,35.462290039062495,11279.097548828126,4,4,0,14,35569,4
100113,Toys,32.842525482177734,2023-04-08,60,0,36.194580078125,2171.6748046875,5,4,1,14,35629,4
100113,Toys,32.842525482177734,2023-04-09,147,290,41.25647987365723,18175.445082855225,6,4,1,14,35776,4
100113,Toys,32.842525482177734,2023-04-10,88,0,40.23295974731445,3540.500457763672,0,4,0,15,35864,4
100113,Toys,32.842525482177734,2023-04-11,38,0,40.23295974731445,1528.8524703979492,1,4,0,15,35902,4
100113,Toys,32.842525482177734,2023-04-12,35,0,40.23295974731445,1408.1535911560059,2,4,0,15,35937,4
100113,Toys,32.842525482177734,2023-04-13,19,0,40.23295974731445,764.4262351989746,3,4,0,15,35956,4
100113,Toys,32.842525482177734,2023-04-14,71,59,32.00812294006347,4208.673457489013,4,4,0,15,36027,4
100113,Toys,32.842525482177734,2023-04-15,44,50,29.12233757019043,2717.145706176758,5,4,1,15,36071,4
100113,Toys,32.842525482177734,2023-04-16,19,0,32.51467514038086,617.7788276672363,6,4,1,15,36090,4
100113,Toys,32.842525482177734,2023-04-17,23,50,26.015916481018067,1818.542158126831,0,4,0,16,36113,4
100113,Toys,32.842525482177734,2023-04-18,12,0,29.001832962036133,348.0219955444336,1,4,0,16,36125,4
100113,Toys,32.842525482177734,2023-04-19,36,0,29.001832962036133,1044.0659866333008,2,4,0,16,36161,4
100113,Toys,32.842525482177734,2023-04-20,10,50,22.886479377746582,1277.7295875549316,3,4,0,16,36171,4
100113,Toys,32.842525482177734,2023-04-21,25,0,25.272958755493164,631.8239688873291,4,4,0,16,36196,4
100113,Toys,32.842525482177734,2023-04-22,79,71,29.138278732299803,4359.688039703369,5,4,1,16,36275,4
100113,Toys,32.842525482177734,2023-04-23,71,76,29.230664825439455,4299.254405212402,6,4,1,16,36346,4
100113,Toys,32.842525482177734,2023-04-24,17,50,23.319766387939453,1484.8820571899414,0,4,0,17,36363,4
100113,Toys,32.842525482177734,2023-04-25,31,0,25.669532775878906,795.7555160522461,1,4,0,17,36394,4
100113,Toys,32.842525482177734,2023-04-26,32,50,27.02571731567383,2226.805908203125,2,4,0,17,36426,4
100113,Toys,32.842525482177734,2023-04-27,64,53,28.660596237182617,3341.636318359375,3,4,0,17,36490,4
100113,Toys,32.842525482177734,2023-04-28,41,50,27.56611576080322,2508.3714923858643,4,4,0,17,36531,4
100113,Toys,32.842525482177734,2023-04-29,30,0,27.582231521606445,827.4669456481934,5,4,1,17,36561,4
100113,Toys,32.842525482177734,2023-04-30,12,50,23.32238109588623,1382.8171463012695,6,4,1,17,36573,4
100113,Toys,32.842525482177734,2023-05-01,26,0,24.98476219177246,649.603816986084,0,5,0,18,36599,4
100113,Toys,32.842525482177734,2023-05-02,55,52,28.72906997680664,3069.2676974487304,1,5,0,18,36654,4
100113,Toys,32.842525482177734,2023-05-03,40,50,26.76969211578369,2407.6753692626953,2,5,0,18,36694,4
100113,Toys,32.842525482177734,2023-05-04,33,50,26.001048126220702,2150.9291763305664,3,5,0,18,36727,4
100113,Toys,32.842525482177734,2023-05-05,60,54,27.77132984161377,3162.0395809936526,4,5,0,18,36787,4
100113,Toys,32.842525482177734,2023-05-06,37,52,28.171883544921876,2514.769382324219,5,5,1,18,36824,4
100113,Toys,32.842525482177734,2023-05-07,45,63,25.491978874206545,2734.9180986785886,6,5,1,18,36869,4
100113,Toys,32.842525482177734,2023-05-08,12,0,26.503957748413086,318.04749298095703,0,5,0,19,36881,4
100113,Toys,32.842525482177734,2023-05-09,56,0,26.503957748413086,1484.2216339111328,1,5,0,19,36937,4
100113,Toys,32.842525482177734,2023-05-10,33,50,25.80818119049072,2137.6899585723877,2,5,0,19,36970,4
100113,Toys,32.842525482177734,2023-05-11,73,50,24.364776077270506,3013.767307281494,3,5,0,19,37043,4
100113,Toys,32.842525482177734,2023-05-12,13,50,22.470661430358888,1381.957197189331,4,5,0,19,37056,4
100113,Toys,32.842525482177734,2023-05-13,90,160,29.74343807220459,7533.618852996826,5,5,1,19,37146,4
100113,Toys,32.842525482177734,2023-05-14,76,0,28.34687614440918,2154.3625869750977,6,5,1,19,37222,4
100113,Toys,32.842525482177734,2023-05-15,84,161,34.961464920043944,8670.936106567384,0,5,0,20,37306,4
100113,Toys,32.842525482177734,2023-05-16,110,123,34.81613006591797,8118.448614501953,1,5,0,20,37416,4
100113,Toys,32.842525482177734,2023-05-17,128,0,34.33226013183594,4394.529296875,2,5,0,20,37544,4
100113,Toys,32.842525482177734,2023-05-18,46,129,34.451896057128906,6030.5844372558595,3,5,0,20,37590,4
100113,Toys,32.842525482177734,2023-05-19,101,98,33.21411727905273,6611.061690368651,4,5,0,20,37691,4
100113,Toys,32.842525482177734,2023-05-20,126,158,38.22855163574219,10898.235012207031,5,5,1,20,37817,4
100113,Toys,32.842525482177734,2023-05-21,150,169,34.45930000305176,10977.520000915527,6,5,1,20,37967,4
100113,Toys,32.842525482177734,2023-05-22,142,116,38.564849853515625,9912.417358398438,0,5,0,21,38109,4
100113,Toys,32.842525482177734,2023-05-23,73,125,35.72060653686523,7045.088554382324,1,5,0,21,38182,4
100113,Toys,32.842525482177734,2023-05-24,68,0,36.25121307373047,2465.082489013672,2,5,0,21,38250,4
100113,Toys,32.842525482177734,2023-05-25,63,107,35.39947143554687,6003.413400878906,3,5,0,21,38313,4
100113,Toys,32.842525482177734,2023-05-26,161,130,36.042250595092774,10484.334691619873,4,5,0,21,38474,4
100113,Toys,32.842525482177734,2023-05-27,141,188,36.87789649963379,12145.61681289673,5,5,1,21,38615,4
100113,Toys,32.842525482177734,2023-05-28,86,0,36.60579299926758,3148.0981979370117,6,5,1,21,38701,4
100113,Toys,32.842525482177734,2023-05-29,49,50,31.278400421142578,3093.7832412719727,0,5,0,22,38750,4
100113,Toys,32.842525482177734,2023-05-30,93,126,33.806162109374995,7401.03615234375,1,5,0,22,38843,4
100113,Toys,32.842525482177734,2023-05-31,101,100,36.28733016967773,7292.750694274902,2,5,0,22,38944,4
100113,Toys,32.842525482177734,2023-06-01,97,93,29.49604713439941,5614.273144073486,3,6,0,22,39041,4
100113,Toys,32.842525482177734,2023-06-02,103,111,32.96202568054199,7056.81729019165,4,6,0,22,39144,4
100113,Toys,32.842525482177734,2023-06-03,28,0,32.594051361083984,912.6334381103516,5,6,1,22,39172,4
100113,Toys,32.842525482177734,2023-06-04,118,179,36.869996871948246,11015.049261779786,6,6,1,22,39290,4
100113,Toys,32.842525482177734,2023-06-05,58,0,35.809993743896484,2076.979637145996,0,6,0,23,39348,4
100113,Toys,32.842525482177734,2023-06-06,121,156,31.315863876342775,8630.539058074952,1,6,0,23,39469,4
100113,Toys,32.842525482177734,2023-06-07,91,144,32.17084945678711,7552.684601135254,2,6,0,23,39560,4
100113,Toys,32.842525482177734,2023-06-08,48,0,32.31169891357422,1550.9615478515625,3,6,0,23,39608,4
100113,Toys,32.842525482177734,2023-06-09,70,0,32.31169891357422,2261.8189239501953,4,6,0,23,39678,4
100113,Toys,32.842525482177734,2023-06-10,59,90,30.45385269165039,4518.284617614746,5,6,1,23,39737,4
100113,Toys,32.842525482177734,2023-06-11,89,95,32.10737312316894,5910.172415924072,6,6,1,23,39826,4
100113,Toys,32.842525482177734,2023-06-12,38,0,31.70474624633789,1204.7803573608398,0,6,0,24,39864,4
100113,Toys,32.842525482177734,2023-06-13,59,74,29.17618022918701,3866.089267044067,1,6,0,24,39923,4
100113,Toys,32.842525482177734,2023-06-14,86,82,28.879165000915528,4853.65638015747,2,6,0,24,40009,4
100113,Toys,32.842525482177734,2023-06-15,101,86,31.35500328063965,5852.360662689209,3,6,0,24,40110,4
100113,Toys,32.842525482177734,2023-06-16,86,110,30.284337730407714,5933.466089630127,4,6,0,24,40196,4
100113,Toys,32.842525482177734,2023-06-17,71,75,27.751498527526856,4047.2727909088135,5,6,1,24,40267,4
100113,Toys,32.842525482177734,2023-06-18,64,106,31.950367584228516,5476.90705078125,6,6,1,24,40331,4
100113,Toys,32.842525482177734,2023-06-19,127,108,35.53430854797364,8313.404371185303,0,6,0,25,40458,4
100113,Toys,32.842525482177734,2023-06-20,136,140,35.38615631103515,9768.954516601563,1,6,0,25,40594,4
100113,Toys,32.842525482177734,2023-06-21,109,111,35.93582481384277,7906.769809417725,2,6,0,25,40703,4
100113,Toys,32.842525482177734,2023-06-22,143,125,38.13732414245605,10203.474704742432,3,6,0,25,40846,4
100113,Toys,32.842525482177734,2023-06-23,125,151,30.835672607421877,8462.398151855468,4,6,0,25,40971,4
100113,Toys,32.842525482177734,2023-06-24,72,99,31.817906112670897,5430.658480224609,5,6,1,25,41043,4
100113,Toys,32.842525482177734,2023-06-25,110,147,34.22482215881348,8824.090874938965,6,6,1,25,41153,4
100113,Toys,32.842525482177734,2023-06-26,183,195,36.57344421386719,13838.040582275391,0,6,0,26,41336,4
100113,Toys,32.842525482177734,2023-06-27,46,0,35.466888427734375,1631.4768676757812,1,6,0,26,41382,4
100113,Toys,32.842525482177734,2023-06-28,53,0,35.466888427734375,1879.7450866699219,2,6,0,26,41435,4
100113,Toys,32.842525482177734,2023-06-29,89,101,31.592710418701174,5984.582454528809,3,6,0,26,41524,4
100113,Toys,32.842525482177734,2023-06-30,66,77,31.03916862487793,4427.830258483887,4,6,0,26,41590,4
100113,Toys,32.842525482177734,2023-07-01,135,112,33.6592561340332,8298.639156188965,5,7,1,26,41725,4
100113,Toys,32.842525482177734,2023-07-02,75,125,36.77962425231934,7419.9436378479,6,7,1,26,41800,4
100113,Toys,32.842525482177734,2023-07-03,151,118,31.47865867614746,8524.804920196533,0,7,0,27,41951,4
100113,Toys,32.842525482177734,2023-07-04,98,176,32.99263366699219,9035.096198730469,1,7,0,27,42049,4
100113,Toys,32.842525482177734,2023-07-05,89,0,33.055267333984375,2941.9187927246094,2,7,0,27,42138,4
100113,Toys,32.842525482177734,2023-07-06,68,123,32.977443313598634,6297.182290649414,3,7,0,27,42206,4
100113,Toys,32.842525482177734,2023-07-07,109,112,36.12990692138672,7988.999708862305,4,7,0,27,42315,4
100113,Toys,32.842525482177734,2023-07-08,93,160,34.554494857788086,8738.636043548584,5,7,1,27,42408,4
100113,Toys,32.842525482177734,2023-07-09,179,0,34.60898971557617,6195.009159088135,6,7,1,27,42587,4
100113,Toys,32.842525482177734,2023-07-10,80,140,29.496179275512695,6420.988684082031,0,7,0,28,42667,4
100113,Toys,32.842525482177734,2023-07-11,61,96,26.705784225463866,4134.855675506592,1,7,0,28,42728,4
100113,Toys,32.842525482177734,2023-07-12,108,0,28.361568450927734,3063.0493927001953,2,7,0,28,42836,4
100113,Toys,32.842525482177734,2023-07-13,67,68,24.886833305358884,3358.5756629180905,3,7,0,28,42903,4
100113,Toys,32.842525482177734,2023-07-14,36,55,26.42174545288086,2407.195672607422,4,7,0,28,42939,4
100113,Toys,32.842525482177734,2023-07-15,33,50,25.022166938781737,2066.9430179595947,5,7,1,28,42972,4
100113,Toys,32.842525482177734,2023-07-16,21,0,25.604333877563477,537.691011428833,6,7,1,28,42993,4
100113,Toys,32.842525482177734,2023-07-17,83,95,31.14536479949951,5564.090556716919,0,7,0,29,43076,4
100113,Toys,32.842525482177734,2023-07-18,34,64,28.97635055541992,2833.4918377685544,1,7,0,29,43110,4
100113,Toys,32.842525482177734,2023-07-19,88,90,27.123808517456055,4826.350299072266,2,7,0,29,43198,4
100113,Toys,32.842525482177734,2023-07-20,86,98,28.47177215576172,5241.1848107910155,3,7,0,29,43284,4
100113,Toys,32.842525482177734,2023-07-21,89,159,33.87597755432129,8520.524004669189,4,7,0,29,43373,4
100113,Toys,32.842525482177734,2023-07-22,167,158,31.483908157348633,10234.735324554444,5,7,1,29,43540,4
100113,Toys,32.842525482177734,2023-07-23,66,0,31.757816314697266,2096.0158767700195,6,7,1,29,43606,4
100113,Toys,32.842525482177734,2023-07-24,120,107,31.18901954650879,7082.754691162109,0,7,0,30,43726,4
100113,Toys,32.842525482177734,2023-07-25,61,0,31.408039093017578,1915.8903846740723,1,7,0,30,43787,4
100113,Toys,32.842525482177734,2023-07-26,60,113,31.864284019470215,5517.594082336425,2,7,0,30,43847,4
100113,Toys,32.842525482177734,2023-07-27,113,90,31.314946479797364,6360.9579044342045,3,7,0,30,43960,4
100113,Toys,32.842525482177734,2023-07-28,90,133,33.11033798217774,7401.220836791993,4,7,0,30,44050,4
100113,Toys,32.842525482177734,2023-07-29,37,0,32.70067596435547,1209.9250106811523,5,7,1,30,44087,4
100113,Toys,32.842525482177734,2023-07-30,83,123,33.87138137817383,6990.649308776856,6,7,1,30,44170,4
100113,Toys,32.842525482177734,2023-07-31,74,65,29.981034355163573,4183.753084564209,0,7,0,31,44244,4
100113,Toys,32.842525482177734,2023-08-01,98,120,36.332312774658206,7954.933303833008,1,8,0,31,44342,4
100113,Toys,32.842525482177734,2023-08-02,146,116,36.06245246887207,9433.136120910644,2,8,0,31,44488,4
100113,Toys,32.842525482177734,2023-08-03,54,84,27.874541015625,3751.1504296875,3,8,0,31,44542,4
100113,Toys,32.842525482177734,2023-08-04,111,107,27.429733009338378,5985.64072807312,4,8,0,31,44653,4
100113,Toys,32.842525482177734,2023-08-05,89,145,35.549866561889644,8442.436248016358,5,8,1,31,44742,4
100113,Toys,32.842525482177734,2023-08-06,76,0,33.3397331237793,2533.8197174072266,6,8,1,31,44818,4
100113,Toys,32.842525482177734,2023-08-07,125,129,34.516076278686526,8768.61906967163,0,8,0,32,44943,4
100113,Toys,32.842525482177734,2023-08-08,105,124,35.419501953125,8119.43541015625,1,8,0,32,45048,4
100113,Toys,32.842525482177734,2023-08-09,80,93,29.39454933166504,5053.087893066406,2,8,0,32,45128,4
100113,Toys,32.842525482177734,2023-08-10,117,136,34.056623992919924,8631.780014343261,3,8,0,32,45245,4
100113,Toys,32.842525482177734,2023-08-11,94,0,33.243247985839844,3124.8653106689453,4,8,0,32,45339,4
100113,Toys,32.842525482177734,2023-08-12,86,102,32.508029479980465,6108.021070556641,5,8,1,32,45425,4
100113,Toys,32.842525482177734,2023-08-13,102,120,30.133283309936523,6675.669795227051,6,8,1,32,45527,4
100113,Toys,32.842525482177734,2023-08-14,120,187,37.780273056030275,11710.415533447267,0,8,0,33,45647,4
100113,Toys,32.842525482177734,2023-08-15,99,0,36.11054611206055,3574.944065093994,1,8,0,33,45746,4
100113,Toys,32.842525482177734,2023-08-16,88,152,40.2016015625,9707.161875,2,8,0,33,45834,4
100113,Toys,32.842525482177734,2023-08-17,110,114,32.0594873046875,7169.76720703125,3,8,0,33,45944,4
100113,Toys,32.842525482177734,2023-08-18,67,0,34.948974609375,2341.581298828125,4,8,0,33,46011,4
100113,Toys,32.842525482177734,2023-08-19,88,78,34.172182388305664,5675.404100341797,5,8,1,33,46099,4
100113,Toys,32.842525482177734,2023-08-20,79,133,34.19857246398926,7246.934449310303,6,8,1,33,46178,4
100113,Toys,32.842525482177734,2023-08-21,89,90,32.39237670898437,5797.443054199219,0,8,0,34,46267,4
100113,Toys,32.842525482177734,2023-08-22,98,97,32.24423568725586,6288.0101947021485,1,8,0,34,46365,4
100113,Toys,32.842525482177734,2023-08-23,133,178,31.945702438354495,9926.756848602296,2,8,0,34,46498,4
100113,Toys,32.842525482177734,2023-08-24,83,0,32.131404876708984,2666.9066047668457,3,8,0,34,46581,4
100113,Toys,32.842525482177734,2023-08-25,64,61,32.33212562561035,4041.252080078125,4,8,0,34,46645,4
100113,Toys,32.842525482177734,2023-08-26,92,77,30.523523750305174,5168.128370056153,5,8,1,34,46737,4
100113,Toys,32.842525482177734,2023-08-27,77,83,34.33588401794434,5499.766138763428,6,8,1,34,46814,4
100113,Toys,32.842525482177734,2023-08-28,83,100,34.4593081665039,6311.675155639648,0,8,0,35,46897,4
100113,Toys,32.842525482177734,2023-08-29,88,123,33.384936294555665,7036.698787841797,1,8,0,35,46985,4
100113,Toys,32.842525482177734,2023-08-30,124,135,37.79246780395508,9803.622015380859,2,8,0,35,47109,4
100113,Toys,32.842525482177734,2023-08-31,90,98,34.68147621154785,6514.265718078614,3,8,0,35,47199,4
100113,Toys,32.842525482177734,2023-09-01,67,98,29.973403015136718,4871.4160040283205,4,9,0,35,47266,4
100113,Toys,32.842525482177734,2023-09-02,134,0,32.36680603027344,4337.152008056641,5,9,1,35,47400,4
100113,Toys,32.842525482177734,2023-09-03,51,67,31.358081855773925,3695.80434928894,6,9,1,35,47451,4
100113,Toys,32.842525482177734,2023-09-04,67,79,30.483297653198242,4446.441885528564,0,9,0,36,47518,4
100113,Toys,32.842525482177734,2023-09-05,79,117,29.99092067718506,5870.2054669952395,1,9,0,36,47597,4
100113,Toys,32.842525482177734,2023-09-06,80,94,32.09411254882812,5594.5380078125,2,9,0,36,47677,4
100113,Toys,32.842525482177734,2023-09-07,87,94,35.700794448852534,6474.298234100342,3,9,0,36,47764,4
100113,Toys,32.842525482177734,2023-09-08,88,86,31.637007293701174,5506.873283691406,4,9,0,36,47852,4
100113,Toys,32.842525482177734,2023-09-09,60,84,28.754513626098635,4098.781635131836,5,9,1,36,47912,4
100113,Toys,32.842525482177734,2023-09-10,73,90,30.64248893737793,4995.873384857177,6,9,1,36,47985,4
100113,Toys,32.842525482177734,2023-09-11,83,0,30.57497787475586,2537.7231636047363,0,9,0,37,48068,4
100113,Toys,32.842525482177734,2023-09-12,94,151,36.37356758117676,8989.98070526123,1,9,0,37,48162,4
100113,Toys,32.842525482177734,2023-09-13,99,107,32.66485939025879,6721.24215927124,2,9,0,37,48261,4
100113,Toys,32.842525482177734,2023-09-14,65,0,33.62971878051758,2185.9317207336426,3,9,0,37,48326,4
100113,Toys,32.842525482177734,2023-09-15,94,163,33.83422798156738,8698.554860534668,4,9,0,37,48420,4
100113,Toys,32.842525482177734,2023-09-16,87,100,29.476308364868164,5486.897655487061,5,9,1,37,48507,4
100113,Toys,32.842525482177734,2023-09-17,66,0,31.412616729736328,2073.2327041625977,6,9,1,37,48573,4
100113,Toys,32.842525482177734,2023-09-18,84,83,31.854061737060547,5319.452371826172,0,9,0,38,48657,4
100113,Toys,32.842525482177734,2023-09-19,70,68,30.302162857055663,4182.922799987793,1,9,0,38,48727,4
100113,Toys,32.842525482177734,2023-09-20,39,50,30.113798713684083,2675.5762996673584,2,9,0,38,48766,4
100113,Toys,32.842525482177734,2023-09-21,107,97,30.340689430236814,6190.207538070679,3,9,0,38,48873,4
100113,Toys,32.842525482177734,2023-09-22,59,87,30.135613098144532,4396.842345581055,4,9,0,38,48932,4
100113,Toys,32.842525482177734,2023-09-23,61,97,31.72748271942139,5034.99289176941,5,9,1,38,48993,4
100113,Toys,32.842525482177734,2023-09-24,110,0,31.114965438842773,3422.646198272705,6,9,1,38,49103,4
100113,Toys,32.842525482177734,2023-09-25,57,68,28.712337951660157,3580.7665264892576,0,9,0,39,49160,4
100113,Toys,32.842525482177734,2023-09-26,73,194,32.62030082702637,8770.083920745848,1,9,0,39,49233,4
100113,Toys,32.842525482177734,2023-09-27,152,0,32.120601654052734,4882.331451416016,2,9,0,39,49385,4
100113,Toys,32.842525482177734,2023-09-28,42,70,29.276362953186037,3260.574488067627,3,9,0,39,49427,4
100113,Toys,32.842525482177734,2023-09-29,70,109,32.85880104064941,5909.462145690918,4,9,0,39,49497,4
100113,Toys,32.842525482177734,2023-09-30,51,0,32.14760208129883,1639.5277061462402,5,9,1,39,49548,4
100113,Toys,32.842525482177734,2023-10-01,58,119,35.37717712402343,6300.362546386718,6,10,1,39,49606,4
100113,Toys,32.842525482177734,2023-10-02,88,105,28.521000633239744,5466.286111450196,0,10,0,40,49694,4
100113,Toys,32.842525482177734,2023-10-03,123,87,28.317022438049314,5985.347519760131,1,10,0,40,49817,4
100113,Toys,32.842525482177734,2023-10-04,71,86,30.17345283508301,4741.530302581787,2,10,0,40,49888,4
100113,Toys,32.842525482177734,2023-10-05,63,96,30.420222816467287,4843.408074874878,3,10,0,40,49951,4
100113,Toys,32.842525482177734,2023-10-06,58,0,30.22044563293457,1752.785846710205,4,10,0,40,50009,4
100113,Toys,32.842525482177734,2023-10-07,20,50,25.653357620239255,1730.8343048095703,5,10,1,40,50029,4
100113,Toys,32.842525482177734,2023-10-08,23,0,27.816715240478516,639.7844505310059,6,10,1,40,50052,4
100113,Toys,32.842525482177734,2023-10-09,36,50,28.368372268676758,2443.4828033447266,0,10,0,41,50088,4
100113,Toys,32.842525482177734,2023-10-10,49,0,28.096744537353516,1376.7404823303223,1,10,0,41,50137,4
100113,Toys,32.842525482177734,2023-10-11,10,50,24.374545669555665,1405.4909133911133,2,10,0,41,50147,4
100113,Toys,32.842525482177734,2023-10-12,31,0,25.799091339111328,799.7718315124512,3,10,0,41,50178,4
100113,Toys,32.842525482177734,2023-10-13,18,50,23.602171630859374,1575.7581787109375,4,10,0,41,50196,4
100113,Toys,32.842525482177734,2023-10-14,8,0,24.51434326171875,196.11474609375,5,10,1,41,50204,4
100113,Toys,32.842525482177734,2023-10-15,37,50,23.980216369628906,2082.896011352539,6,10,1,41,50241,4
100113,Toys,32.842525482177734,2023-10-16,47,50,25.78040126800537,2503.097719192505,0,10,0,42,50288,4
100113,Toys,32.842525482177734,2023-10-17,36,0,24.980802536010742,899.3088912963867,1,10,0,42,50324,4
100113,Toys,32.842525482177734,2023-10-18,57,58,27.400038528442384,3151.954392242432,2,10,0,42,50381,4
100113,Toys,32.842525482177734,2023-10-19,61,61,28.19155376434326,3439.369559249878,3,10,0,42,50442,4
100113,Toys,32.842525482177734,2023-10-20,12,50,23.728556556701662,1408.9053573608398,4,10,0,42,50454,4
100113,Toys,32.842525482177734,2023-10-21,39,0,25.36711311340332,989.3174114227295,5,10,1,42,50493,4
100113,Toys,32.842525482177734,2023-10-22,57,80,26.764140586853028,3676.9420269012453,6,10,1,42,50550,4
100113,Toys,32.842525482177734,2023-10-23,14,0,26.318281173706055,368.45593643188477,0,10,0,43,50564,4
100113,Toys,32.842525482177734,2023-10-24,10,0,26.318281173706055,263.18281173706055,1,10,0,43,50574,4
100113,Toys,32.842525482177734,2023-10-25,74,114,27.058598632812497,5094.27259765625,2,10,0,43,50648,4
100113,Toys,32.842525482177734,2023-10-26,114,121,35.09004341125488,8264.569897766112,3,10,0,43,50762,4
100113,Toys,32.842525482177734,2023-10-27,88,84,31.564830513000487,5430.650170288086,4,10,0,43,50850,4
100113,Toys,32.842525482177734,2023-10-28,56,50,29.938803367614746,3179.9859771728516,5,10,1,43,50906,4
100113,Toys,32.842525482177734,2023-10-29,25,0,31.017606735229492,775.4401683807373,6,10,1,43,50931,4
100113,Toys,32.842525482177734,2023-10-30,86,147,36.11612487792969,8485.443479003907,0,10,0,44,51017,4
100113,Toys,32.842525482177734,2023-10-31,59,85,32.39875267028809,4634.5128150939945,1,10,0,44,51076,4
100113,Toys,32.842525482177734,2023-11-01,121,125,31.55944274902344,7760.305145263672,2,11,0,44,51197,4
100113,Toys,32.842525482177734,2023-11-02,92,0,32.388885498046875,2979.7774658203125,3,11,0,44,51289,4
100113,Toys,32.842525482177734,2023-11-03,70,109,32.52251365661621,5822.99191192627,4,11,0,44,51359,4
100113,Toys,32.842525482177734,2023-11-04,124,118,32.95732170104981,7974.695781860351,5,11,1,44,51483,4
100113,Toys,32.842525482177734,2023-11-05,69,94,31.254075126647948,5079.562367477417,6,11,1,44,51552,4
100113,Toys,32.842525482177734,2023-11-06,60,0,31.8481502532959,1910.889015197754,0,11,0,45,51612,4
100113,Toys,32.842525482177734,2023-11-07,76,102,32.09004409790039,5713.846702880859,1,11,0,45,51688,4
100113,Toys,32.842525482177734,2023-11-08,109,138,31.45888557434082,7765.737055206299,2,11,0,45,51797,4
100113,Toys,32.842525482177734,2023-11-09,61,0,31.61777114868164,1928.68404006958,3,11,0,45,51858,4
100113,Toys,32.842525482177734,2023-11-10,70,58,30.69725326538086,3933.65545715332,4,11,0,45,51928,4
100113,Toys,32.842525482177734,2023-11-11,65,81,33.30768165588379,4873.198615264893,5,11,1,45,51993,4
100113,Toys,32.842525482177734,2023-11-12,33,54,28.53160942077637,2445.04622177124,6,11,1,45,52026,4
100113,Toys,32.842525482177734,2023-11-13,45,67,28.63919635772705,3191.767672195435,0,11,0,46,52071,4
100113,Toys,32.842525482177734,2023-11-14,124,105,29.877337608337402,6838.249726867676,1,11,0,46,52195,4
100113,Toys,32.842525482177734,2023-11-15,89,77,30.933656425476073,5128.910843734741,2,11,0,46,52284,4
100113,Toys,32.842525482177734,2023-11-16,93,105,32.87020164489746,6517.297505950928,3,11,0,46,52377,4
100113,Toys,32.842525482177734,2023-11-17,42,50,28.271426582336424,2585.1998329162598,4,11,0,46,52419,4
100113,Toys,32.842525482177734,2023-11-18,57,57,25.64753692626953,2923.8192095947265,5,11,1,46,52476,4
100113,Toys,32.842525482177734,2023-11-19,37,0,27.935073852539062,1033.5977325439453,6,11,1,46,52513,4
100113,Toys,32.842525482177734,2023-11-20,74,97,29.171866188049314,4996.396195831299,0,11,0,47,52587,4
100113,Toys,32.842525482177734,2023-11-21,45,58,26.246654777526857,2687.978929977417,1,11,0,47,52632,4
100113,Toys,32.842525482177734,2023-11-22,96,112,33.610827407836915,7023.9988623046875,2,11,0,47,52728,4
100113,Toys,32.842525482177734,2023-11-23,120,116,28.061089668273926,6627.381520385742,3,11,0,47,52848,4
100113,Toys,32.842525482177734,2023-11-24,49,0,29.30217933654785,1435.8067874908447,4,11,0,47,52897,4
100113,Toys,32.842525482177734,2023-11-25,29,50,24.316654052734375,1876.1459350585938,5,11,1,47,52926,4
100113,Toys,32.842525482177734,2023-11-26,71,74,28.05846378326416,4070.3718572235107,6,11,1,47,52997,4
100113,Toys,32.842525482177734,2023-11-27,90,116,36.66650184631348,7625.150332336426,0,11,0,48,53087,4
100113,Toys,32.842525482177734,2023-11-28,118,140,35.979198989868166,9296.730961608886,1,11,0,48,53205,4
100113,Toys,32.842525482177734,2023-11-29,85,101,33.77043312072754,6270.733630523682,2,11,0,48,53290,4
100113,Toys,32.842525482177734,2023-11-30,87,0,34.43086624145508,2995.485363006592,3,11,0,48,53377,4
100113,Toys,32.842525482177734,2023-12-01,62,58,26.915021629333495,3241.7026820373535,4,12,0,48,53439,4
100113,Toys,32.842525482177734,2023-12-02,72,169,33.547682495117186,8147.296279296875,5,12,1,48,53511,4
100113,Toys,32.842525482177734,2023-12-03,106,103,33.473818054199214,6995.259427490234,6,12,1,48,53617,4
100113,Toys,32.842525482177734,2023-12-04,97,108,33.4911457824707,6866.9922817993165,0,12,0,49,53714,4
100113,Toys,32.842525482177734,2023-12-05,42,0,33.372291564941406,1401.636245727539,1,12,0,49,53756,4
100113,Toys,32.842525482177734,2023-12-06,85,128,29.653858718872073,6261.0659822082525,2,12,0,49,53841,4
100113,Toys,32.842525482177734,2023-12-07,86,0,30.93771743774414,2660.643699645996,3,12,0,49,53927,4
100113,Toys,32.842525482177734,2023-12-08,81,116,33.41622596740723,6607.628606719971,4,12,0,49,54008,4
100113,Toys,32.842525482177734,2023-12-09,27,0,32.71245193481445,883.2362022399902,5,12,1,49,54035,4
100113,Toys,32.842525482177734,2023-12-10,100,107,32.301026306152345,6685.395261230469,6,12,1,49,54135,4
100113,Toys,32.842525482177734,2023-12-11,107,95,33.422995223999024,6747.160977935791,0,12,0,50,54242,4
100113,Toys,32.842525482177734,2023-12-12,43,69,31.93225227355957,3564.393695526123,1,12,0,50,54285,4
100113,Toys,32.842525482177734,2023-12-13,76,62,29.519767570495606,4093.604670715332,2,12,0,50,54361,4
100113,Toys,32.842525482177734,2023-12-14,66,115,31.84310859680176,5777.660334777833,3,12,0,50,54427,4
100113,Toys,32.842525482177734,2023-12-15,130,124,33.60780258178711,8531.628671264647,4,12,0,50,54557,4
100113,Toys,32.842525482177734,2023-12-16,57,0,32.81560516357422,1870.4894943237305,5,12,1,50,54614,4
100113,Toys,32.842525482177734,2023-12-17,93,137,35.994459533691405,8314.1694732666,6,12,1,50,54707,4
100113,Toys,32.842525482177734,2023-12-18,85,84,32.94701835632324,5569.053120574951,0,12,0,51,54792,4
100113,Toys,32.842525482177734,2023-12-19,131,120,35.92654067993164,9009.71365814209,1,12,0,51,54923,4
100113,Toys,32.842525482177734,2023-12-20,107,108,32.15938903808593,6913.14925415039,2,12,0,51,55030,4
100113,Toys,32.842525482177734,2023-12-21,92,105,34.32693992614746,6767.516946411133,3,12,0,51,55122,4
100113,Toys,32.842525482177734,2023-12-22,93,102,30.47265354156494,5929.5435587310785,4,12,0,51,55215,4
100113,Toys,32.842525482177734,2023-12-23,35,0,31.875307083129883,1115.635747909546,5,12,1,51,55250,4
100113,Toys,32.842525482177734,2023-12-24,98,180,37.19832740783691,10445.412171936034,6,12,1,51,55348,4
100113,Toys,32.842525482177734,2023-12-25,102,0,35.92665481567383,3664.5187911987305,0,12,0,52,55450,4
100113,Toys,32.842525482177734,2023-12-26,65,86,33.46418647766113,5034.944242095948,1,12,0,52,55515,4
100113,Toys,32.842525482177734,2023-12-27,41,0,34.328372955322266,1407.463291168213,2,12,0,52,55556,4
100113,Toys,32.842525482177734,2023-12-28,18,50,29.434882698059084,1935.495777130127,3,12,0,52,55574,4
100113,Toys,32.842525482177734,2023-12-29,21,0,31.499765396118164,661.4950733184814,4,12,0,52,55595,4
100113,Toys,32.842525482177734,2023-12-30,9,0,31.499765396118164,283.4978885650635,5,12,1,52,55604,4
100113,Toys,32.842525482177734,2023-12-31,28,50,27.5729296875,2113.6640625,6,12,1,52,55632,4
100113,Toys,32.842525482177734,2024-01-01,25,0,29.255859375,731.396484375,0,1,0,1,55657,4
100113,Toys,32.842525482177734,2024-01-02,12,50,23.295171165466307,1349.4841079711914,1,1,0,1,55669,4
100113,Toys,32.842525482177734,2024-01-03,31,0,25.790342330932617,799.5006122589111,2,1,0,1,55700,4
100113,Toys,32.842525482177734,2024-01-04,15,50,23.64626750946045,1503.8880252838135,3,1,0,1,55715,4
100113,Toys,32.842525482177734,2024-01-05,19,0,24.5925350189209,467.25816535949707,4,1,0,1,55734,4
100113,Toys,32.842525482177734,2024-01-06,32,50,26.823244171142576,2219.067626953125,5,1,1,1,55766,4
100113,Toys,32.842525482177734,2024-01-07,29,0,25.736488342285156,746.3581619262695,6,1,1,1,55795,4
100113,Toys,32.842525482177734,2024-01-08,25,50,24.66098876953125,1837.2994384765625,0,1,0,2,55820,4
100113,Toys,32.842525482177734,2024-01-09,88,125,28.264862518310547,6055.385803222656,1,1,0,2,55908,4
100113,Toys,32.842525482177734,2024-01-10,146,175,34.528161239624026,11145.073081970215,2,1,0,2,56054,4
100113,Toys,32.842525482177734,2024-01-11,81,0,32.40632247924805,2624.912120819092,3,1,0,2,56135,4
100113,Toys,32.842525482177734,2024-01-12,42,50,26.75720287322998,2439.7650413513184,4,1,0,2,56177,4
100113,Toys,32.842525482177734,2024-01-13,102,118,35.98983917236328,7949.12719116211,5,1,1,2,56279,4
100113,Toys,32.842525482177734,2024-01-14,38,61,30.10140319824219,2935.616643066406,6,1,1,2,56317,4
100113,Toys,32.842525482177734,2024-01-15,65,0,32.032806396484375,2082.1324157714844,0,1,0,3,56382,4
100113,Toys,32.842525482177734,2024-01-16,76,153,31.354876861572265,7169.881282958984,1,1,0,3,56458,4
100113,Toys,32.842525482177734,2024-01-17,101,110,33.19892044067383,7011.281929016113,2,1,0,3,56559,4
100113,Toys,32.842525482177734,2024-01-18,37,0,32.497840881347656,1202.4201126098633,3,1,0,3,56596,4
100113,Toys,32.842525482177734,2024-01-19,71,92,32.62041564941406,5318.169022216797,4,1,0,3,56667,4
100113,Toys,32.842525482177734,2024-01-20,115,137,32.44406623840332,8174.935234832764,5,1,1,3,56782,4
100113,Toys,32.842525482177734,2024-01-21,122,139,37.39984703063965,9792.812675476074,6,1,1,3,56904,4
100113,Toys,32.842525482177734,2024-01-22,68,0,35.5496940612793,2417.379196166992,0,1,0,4,56972,4
100113,Toys,32.842525482177734,2024-01-23,62,113,29.129856796264647,4986.042242736817,1,1,0,4,57034,4
100113,Toys,32.842525482177734,2024-01-24,70,0,31.319713592529297,2192.379951477051,2,1,0,4,57104,4
100113,Toys,32.842525482177734,2024-01-25,98,200,38.35545646667481,11571.149467468262,3,1,0,4,57202,4
100113,Toys,32.842525482177734,2024-01-26,99,0,36.97091293334961,3660.1203804016113,4,1,0,4,57301,4
100113,Toys,32.842525482177734,2024-01-27,76,67,27.024738311767578,3903.010223388672,5,1,1,4,57377,4
100113,Toys,32.842525482177734,2024-01-28,55,56,28.708486099243164,3185.473470916748,6,1,1,4,57432,4
100113,Toys,32.842525482177734,2024-01-29,93,91,32.25559356689453,5933.420403442383,0,1,0,5,57525,4
100113,Toys,32.842525482177734,2024-01-30,81,138,33.30126274108886,7319.124564056397,1,1,0,5,57606,4
100114,Groceries,76.92658996582031,2022-01-01,121,731,80.13000244140625,68270.76059082031,5,1,1,52,121,3
100114,Groceries,76.92658996582031,2022-01-02,81,0,80.1300048828125,6490.5303955078125,6,1,1,52,202,3
100114,Groceries,76.92658996582031,2022-01-03,50,0,80.1300048828125,4006.500244140625,0,1,0,1,252,3
100114,Groceries,76.92658996582031,2022-01-04,147,368,77.87787734985352,39910.88594085693,1,1,0,1,399,3
100114,Groceries,76.92658996582031,2022-01-05,86,0,78.76575469970703,6773.854904174805,2,1,0,1,485,3
100114,Groceries,76.92658996582031,2022-01-06,138,0,78.76575469970703,10869.67414855957,3,1,0,1,623,3
100114,Groceries,76.92658996582031,2022-01-07,109,0,78.76575469970703,8585.467262268066,4,1,0,1,732,3
100114,Groceries,76.92658996582031,2022-01-08,75,348,61.67914260864258,24479.811391296385,5,1,1,1,807,3
100114,Groceries,76.92658996582031,2022-01-09,178,0,67.57828521728516,12028.934768676758,6,1,1,1,985,3
100114,Groceries,76.92658996582031,2022-01-10,107,0,67.57828521728516,7230.876518249512,0,1,0,2,1092,3
100114,Groceries,76.92658996582031,2022-01-11,99,329,61.15203971862793,25655.10386428833,1,1,0,2,1191,3
100114,Groceries,76.92658996582031,2022-01-12,69,0,63.40407943725586,4374.881481170654,2,1,0,2,1260,3
100114,Groceries,76.92658996582031,2022-01-13,79,0,63.40407943725586,5008.922275543213,3,1,0,2,1339,3
100114,Groceries,76.92658996582031,2022-01-14,140,458,76.28851089477538,46943.88305053711,4,1,0,2,1479,3
100114,Groceries,76.92658996582031,2022-01-15,87,0,72.12702178955078,6275.050895690918,5,1,1,2,1566,3
100114,Groceries,76.92658996582031,2022-01-16,91,0,72.12702178955078,6563.558982849121,6,1,1,2,1657,3
100114,Groceries,76.92658996582031,2022-01-17,187,820,90.8080453491211,94521.31896057128,0,1,0,3,1844,3
100114,Groceries,76.92658996582031,2022-01-18,85,0,85.94609069824219,7305.417709350586,1,1,0,3,1929,3
100114,Groceries,76.92658996582031,2022-01-19,118,0,85.94609069824219,10141.638702392578,2,1,0,3,2047,3
100114,Groceries,76.92658996582031,2022-01-20,81,0,85.94609069824219,6961.633346557617,3,1,0,3,2128,3
100114,Groceries,76.92658996582031,2022-01-21,108,0,85.94609069824219,9282.177795410156,4,1,0,3,2236,3
100114,Groceries,76.92658996582031,2022-01-22,58,0,85.94609069824219,4984.873260498047,5,1,1,3,2294,3
100114,Groceries,76.92658996582031,2022-01-23,149,0,85.94609069824219,12805.967514038086,6,1,1,3,2443,3
100114,Groceries,76.92658996582031,2022-01-24,128,475,77.6192547607422,45673.44921875,0,1,0,4,2571,3
100114,Groceries,76.92658996582031,2022-01-25,80,0,80.87850952148438,6470.28076171875,1,1,0,4,2651,3
100114,Groceries,76.92658996582031,2022-01-26,107,0,80.87850952148438,8654.000518798828,2,1,0,4,2758,3
100114,Groceries,76.92658996582031,2022-01-27,129,0,80.87850952148438,10433.327728271484,3,1,0,4,2887,3
100114,Groceries,76.92658996582031,2022-01-28,77,0,80.87850952148438,6227.645233154297,4,1,0,4,2964,3
100114,Groceries,76.92658996582031,2022-01-29,182,425,79.80760330200195,48339.30760192871,5,1,1,4,3146,3
100114,Groceries,76.92658996582031,2022-01-30,191,0,80.2352066040039,15324.924461364746,6,1,1,4,3337,3
100114,Groceries,76.92658996582031,2022-01-31,97,0,80.2352066040039,7782.815040588379,0,1,0,5,3434,3
100114,Groceries,76.92658996582031,2022-02-01,115,0,80.2352066040039,9227.04875946045,1,2,0,5,3549,3
100114,Groceries,76.92658996582031,2022-02-02,83,0,80.2352066040039,6659.522148132324,2,2,0,5,3632,3
100114,Groceries,76.92658996582031,2022-02-03,111,348,72.36834091186523,32627.33168243408,3,2,0,5,3743,3
100114,Groceries,76.92658996582031,2022-02-04,147,0,74.85668182373047,11003.932228088379,4,2,0,5,3890,3
100114,Groceries,76.92658996582031,2022-02-05,64,426,76.88791885375977,37914.753613281246,5,2,1,5,3954,3
100114,Groceries,76.92658996582031,2022-02-06,115,0,76.22583770751953,8765.971336364746,6,2,1,5,4069,3
100114,Groceries,76.92658996582031,2022-02-07,114,0,76.22583770751953,8689.745498657227,0,2,0,6,4183,3
100114,Groceries,76.92658996582031,2022-02-08,84,0,76.22583770751953,6402.970367431641,1,2,0,6,4267,3
100114,Groceries,76.92658996582031,2022-02-09,149,534,81.81488037109375,56528.33435058594,2,2,0,6,4416,3
100114,Groceries,76.92658996582031,2022-02-10,109,0,80.1297607421875,8734.143920898438,3,2,0,6,4525,3
100114,Groceries,76.92658996582031,2022-02-11,123,0,80.1297607421875,9855.960571289062,4,2,0,6,4648,3
100114,Groceries,76.92658996582031,2022-02-12,159,0,80.1297607421875,12740.631958007812,5,2,1,6,4807,3
100114,Groceries,76.92658996582031,2022-02-13,102,0,80.1297607421875,8173.235595703125,6,2,1,6,4909,3
100114,Groceries,76.92658996582031,2022-02-14,49,0,80.1297607421875,3926.3582763671875,0,2,0,7,4958,3
100114,Groceries,76.92658996582031,2022-02-15,114,345,64.0253074645996,28249.87010192871,1,2,0,7,5072,3
100114,Groceries,76.92658996582031,2022-02-16,145,0,68.95061492919922,9997.839164733887,2,2,0,7,5217,3
100114,Groceries,76.92658996582031,2022-02-17,6,0,68.95061492919922,413.7036895751953,3,2,0,7,5223,3
100114,Groceries,76.92658996582031,2022-02-18,162,547,78.95163192749024,56977.078744506834,4,2,0,7,5385,3
100114,Groceries,76.92658996582031,2022-02-19,122,0,76.35326385498047,9315.098190307617,5,2,1,7,5507,3
100114,Groceries,76.92658996582031,2022-02-20,46,0,76.35326385498047,3512.2501373291016,6,2,1,7,5553,3
100114,Groceries,76.92658996582031,2022-02-21,100,0,76.35326385498047,7635.326385498047,0,2,0,8,5653,3
100114,Groceries,76.92658996582031,2022-02-22,112,0,76.35326385498047,8551.565551757812,1,2,0,8,5765,3
100114,Groceries,76.92658996582031,2022-02-23,208,533,81.87400894165039,61148.33771972656,2,2,0,8,5973,3
100114,Groceries,76.92658996582031,2022-02-24,118,0,80.39801788330078,9486.966110229492,3,2,0,8,6091,3
100114,Groceries,76.92658996582031,2022-02-25,63,0,80.39801788330078,5065.075126647949,4,2,0,8,6154,3
100114,Groceries,76.92658996582031,2022-02-26,81,0,80.39801788330078,6512.239448547363,5,2,1,8,6235,3
100114,Groceries,76.92658996582031,2022-02-27,100,543,74.89675582885742,47442.391165771485,6,2,1,8,6335,3
100114,Groceries,76.92658996582031,2022-02-28,95,0,76.51351165771484,7268.78360748291,0,2,0,9,6430,3
100114,Groceries,76.92658996582031,2022-03-01,187,0,76.51351165771484,14308.026679992676,1,3,0,9,6617,3
100114,Groceries,76.92658996582031,2022-03-02,63,0,76.51351165771484,4820.351234436035,2,3,0,9,6680,3
100114,Groceries,76.92658996582031,2022-03-03,127,0,76.51351165771484,9717.215980529785,3,3,0,9,6807,3
100114,Groceries,76.92658996582031,2022-03-04,114,450,75.9273959350586,42760.08627319336,4,3,0,9,6921,3
100114,Groceries,76.92658996582031,2022-03-05,75,0,76.11479187011719,5708.609390258789,5,3,1,9,6996,3
100114,Groceries,76.92658996582031,2022-03-06,128,0,76.11479187011719,9742.693359375,6,3,1,9,7124,3
100114,Groceries,76.92658996582031,2022-03-07,147,0,76.11479187011719,11188.874404907227,0,3,0,10,7271,3
100114,Groceries,76.92658996582031,2022-03-08,147,437,83.26926651000977,49290.66435394287,1,3,0,10,7418,3
100114,Groceries,76.92658996582031,2022-03-09,116,0,80.98853302001953,9394.669830322266,2,3,0,10,7534,3
100114,Groceries,76.92658996582031,2022-03-10,146,501,74.23434829711914,47147.67970275879,3,3,0,10,7680,3
100114,Groceries,76.92658996582031,2022-03-11,75,0,76.71869659423828,5753.902244567871,4,3,0,10,7755,3
100114,Groceries,76.92658996582031,2022-03-12,90,0,76.71869659423828,6904.682693481445,5,3,1,10,7845,3
100114,Groceries,76.92658996582031,2022-03-13,117,0,76.71869659423828,8976.087501525879,6,3,1,10,7962,3
100114,Groceries,76.92658996582031,2022-03-14,145,0,76.71869659423828,11124.21100616455,0,3,0,11,8107,3
100114,Groceries,76.92658996582031,2022-03-15,114,0,76.71869659423828,8745.931411743164,1,3,0,11,8221,3
100114,Groceries,76.92658996582031,2022-03-16,82,437,71.54577621459961,36558.65729919434,2,3,0,11,8303,3
100114,Groceries,76.92658996582031,2022-03-17,121,0,73.16155242919922,8852.547843933105,3,3,0,11,8424,3
100114,Groceries,76.92658996582031,2022-03-18,68,0,73.16155242919922,4974.985565185547,4,3,0,11,8492,3
100114,Groceries,76.92658996582031,2022-03-19,186,541,74.23322372436523,54097.759225463866,5,3,1,11,8678,3
100114,Groceries,76.92658996582031,2022-03-20,62,0,73.86644744873047,4579.719741821289,6,3,1,11,8740,3
100114,Groceries,76.92658996582031,2022-03-21,127,0,73.86644744873047,9381.03882598877,0,3,0,12,8867,3
100114,Groceries,76.92658996582031,2022-03-22,98,0,73.86644744873047,7238.911849975586,1,3,0,12,8965,3
100114,Groceries,76.92658996582031,2022-03-23,102,0,73.86644744873047,7534.377639770508,2,3,0,12,9067,3
100114,Groceries,76.92658996582031,2022-03-24,149,0,73.86644744873047,11006.10066986084,3,3,0,12,9216,3
100114,Groceries,76.92658996582031,2022-03-25,51,0,73.86644744873047,3767.188819885254,4,3,0,12,9267,3
100114,Groceries,76.92658996582031,2022-03-26,103,381,72.89342193603515,35198.84491882324,5,3,1,12,9370,3
100114,Groceries,76.92658996582031,2022-03-27,142,0,73.18684387207031,10392.531829833984,6,3,1,12,9512,3
100114,Groceries,76.92658996582031,2022-03-28,84,343,79.59936401367187,34659.90315429687,0,3,0,13,9596,3
100114,Groceries,76.92658996582031,2022-03-29,39,0,77.00872802734375,3003.3403930664062,1,3,0,13,9635,3
100114,Groceries,76.92658996582031,2022-03-30,52,0,77.00872802734375,4004.453857421875,2,3,0,13,9687,3
100114,Groceries,76.92658996582031,2022-03-31,167,0,77.00872802734375,12860.457580566406,3,3,0,13,9854,3
100114,Groceries,76.92658996582031,2022-04-01,217,835,93.3622396850586,100421.95202331543,4,4,0,13,10071,3
100114,Groceries,76.92658996582031,2022-04-02,129,0,89.79447937011719,11583.487838745117,5,4,1,13,10200,3
100114,Groceries,76.92658996582031,2022-04-03,104,0,89.79447937011719,9338.625854492188,6,4,1,13,10304,3
100114,Groceries,76.92658996582031,2022-04-04,88,0,89.79447937011719,7901.9141845703125,0,4,0,14,10392,3
100114,Groceries,76.92658996582031,2022-04-05,114,0,89.79447937011719,10236.57064819336,1,4,0,14,10506,3
100114,Groceries,76.92658996582031,2022-04-06,133,0,89.79447937011719,11942.665756225586,2,4,0,14,10639,3
100114,Groceries,76.92658996582031,2022-04-07,155,563,86.53446090698242,61713.762881164555,3,4,0,14,10794,3
100114,Groceries,76.92658996582031,2022-04-08,245,0,87.55892181396484,21451.935844421387,4,4,0,14,11039,3
100114,Groceries,76.92658996582031,2022-04-09,100,0,87.55892181396484,8755.892181396484,5,4,1,14,11139,3
100114,Groceries,76.92658996582031,2022-04-10,87,0,87.55892181396484,7617.626197814941,6,4,1,14,11226,3
100114,Groceries,76.92658996582031,2022-04-11,187,473,81.21166564941407,52978.602952880865,0,4,0,15,11413,3
100114,Groceries,76.92658996582031,2022-04-12,16,0,83.38333129882812,1334.13330078125,1,4,0,15,11429,3
100114,Groceries,76.92658996582031,2022-04-13,84,0,83.38333129882812,7004.1998291015625,2,4,0,15,11513,3
100114,Groceries,76.92658996582031,2022-04-14,131,0,83.38333129882812,10923.216400146484,3,4,0,15,11644,3
100114,Groceries,76.92658996582031,2022-04-15,108,0,83.38333129882812,9005.399780273438,4,4,0,15,11752,3
100114,Groceries,76.92658996582031,2022-04-16,85,450,80.74499649047851,42882.84940338135,5,4,1,15,11837,3
100114,Groceries,76.92658996582031,2022-04-17,118,0,81.60999298095703,9629.97917175293,6,4,1,15,11955,3
100114,Groceries,76.92658996582031,2022-04-18,106,0,81.60999298095703,8650.659255981445,0,4,0,16,12061,3
100114,Groceries,76.92658996582031,2022-04-19,45,0,81.60999298095703,3672.4496841430664,1,4,0,16,12106,3
100114,Groceries,76.92658996582031,2022-04-20,133,453,90.79126892089843,54294.47753295898,2,4,0,16,12239,3
100114,Groceries,76.92658996582031,2022-04-21,102,0,87.38253784179688,8913.018859863281,3,4,0,16,12341,3
100114,Groceries,76.92658996582031,2022-04-22,46,0,87.38253784179688,4019.5967407226562,4,4,0,16,12387,3
100114,Groceries,76.92658996582031,2022-04-23,97,0,87.38253784179688,8476.106170654297,5,4,1,16,12484,3
100114,Groceries,76.92658996582031,2022-04-24,69,0,87.38253784179688,6029.395111083984,6,4,1,16,12553,3
100114,Groceries,76.92658996582031,2022-04-25,101,0,87.38253784179688,8825.636322021484,0,4,0,17,12654,3
100114,Groceries,76.92658996582031,2022-04-26,90,0,87.38253784179688,7864.428405761719,1,4,0,17,12744,3
100114,Groceries,76.92658996582031,2022-04-27,52,0,87.38253784179688,4543.8919677734375,2,4,0,17,12796,3
100114,Groceries,76.92658996582031,2022-04-28,50,0,87.38253784179688,4369.126892089844,3,4,0,17,12846,3
100114,Groceries,76.92658996582031,2022-04-29,50,178,72.45087829589843,15734.047829589843,4,4,0,17,12896,3
100114,Groceries,76.92658996582031,2022-04-30,48,0,78.58175659179688,3771.92431640625,5,4,1,17,12944,3
100114,Groceries,76.92658996582031,2022-05-01,28,0,78.58175659179688,2200.2891845703125,6,5,1,17,12972,3
100114,Groceries,76.92658996582031,2022-05-02,67,328,75.06392333984374,29362.12572753906,0,5,0,18,13039,3
100114,Groceries,76.92658996582031,2022-05-03,91,0,76.1678466796875,6931.2740478515625,1,5,0,18,13130,3
100114,Groceries,76.92658996582031,2022-05-04,63,0,76.1678466796875,4798.5743408203125,2,5,0,18,13193,3
100114,Groceries,76.92658996582031,2022-05-05,134,431,69.70333236694336,38766.60307434082,3,5,0,18,13327,3
100114,Groceries,76.92658996582031,2022-05-06,96,0,71.77666473388672,6890.559814453125,4,5,0,18,13423,3
100114,Groceries,76.92658996582031,2022-05-07,58,0,71.77666473388672,4163.04655456543,5,5,1,18,13481,3
100114,Groceries,76.92658996582031,2022-05-08,79,0,71.77666473388672,5670.356513977051,6,5,1,18,13560,3
100114,Groceries,76.92658996582031,2022-05-09,54,0,71.77666473388672,3875.939895629883,0,5,0,19,13614,3
100114,Groceries,76.92658996582031,2022-05-10,154,446,71.66543334960937,42988.91347167968,1,5,0,19,13768,3
100114,Groceries,76.92658996582031,2022-05-11,43,0,71.70086669921875,3083.1372680664062,2,5,0,19,13811,3
100114,Groceries,76.92658996582031,2022-05-12,113,0,71.70086669921875,8102.197937011719,3,5,0,19,13924,3
100114,Groceries,76.92658996582031,2022-05-13,71,0,71.70086669921875,5090.761535644531,4,5,0,19,13995,3
100114,Groceries,76.92658996582031,2022-05-14,74,0,71.70086669921875,5305.8641357421875,5,5,1,19,14069,3
100114,Groceries,76.92658996582031,2022-05-15,42,0,71.70086669921875,3011.4364013671875,6,5,1,19,14111,3
100114,Groceries,76.92658996582031,2022-05-16,65,0,71.70086669921875,4660.556335449219,0,5,0,20,14176,3
100114,Groceries,76.92658996582031,2022-05-17,85,228,64.04438781738281,19610.545928955078,1,5,0,20,14261,3
100114,Groceries,76.92658996582031,2022-05-18,78,0,67.08877563476562,5232.924499511719,2,5,0,20,14339,3
100114,Groceries,76.92658996582031,2022-05-19,43,0,67.08877563476562,2884.817352294922,3,5,0,20,14382,3
100114,Groceries,76.92658996582031,2022-05-20,74,400,65.1714616394043,30711.496322631836,4,5,0,20,14456,3
100114,Groceries,76.92658996582031,2022-05-21,48,0,65.7229232788086,3154.7003173828125,5,5,1,20,14504,3
100114,Groceries,76.92658996582031,2022-05-22,67,0,65.7229232788086,4403.435859680176,6,5,1,20,14571,3
100114,Groceries,76.92658996582031,2022-05-23,7,0,65.7229232788086,460.06046295166016,0,5,0,21,14578,3
100114,Groceries,76.92658996582031,2022-05-24,104,0,65.7229232788086,6835.184020996094,1,5,0,21,14682,3
100114,Groceries,76.92658996582031,2022-05-25,120,430,73.0381866455078,40918.664794921875,2,5,0,21,14802,3
100114,Groceries,76.92658996582031,2022-05-26,87,0,70.62637329101562,6144.494476318359,3,5,0,21,14889,3
100114,Groceries,76.92658996582031,2022-05-27,136,555,74.2331364440918,51851.05311279297,4,5,0,21,15025,3
100114,Groceries,76.92658996582031,2022-05-28,64,0,72.9062728881836,4666.00146484375,5,5,1,21,15089,3
100114,Groceries,76.92658996582031,2022-05-29,65,0,72.9062728881836,4738.907737731934,6,5,1,21,15154,3
100114,Groceries,76.92658996582031,2022-05-30,81,0,72.9062728881836,5905.408103942871,0,5,0,22,15235,3
100114,Groceries,76.92658996582031,2022-05-31,178,0,72.9062728881836,12977.31657409668,1,5,0,22,15413,3
100114,Groceries,76.92658996582031,2022-06-01,106,0,72.9062728881836,7728.064926147461,2,6,0,22,15519,3
100114,Groceries,76.92658996582031,2022-06-02,63,0,72.9062728881836,4593.095191955566,3,6,0,22,15582,3
100114,Groceries,76.92658996582031,2022-06-03,189,506,83.51458862304688,59166.53449951172,4,6,0,22,15771,3
100114,Groceries,76.92658996582031,2022-06-04,225,854,93.78136123657227,104019.73255645751,5,6,1,22,15996,3
100114,Groceries,76.92658996582031,2022-06-05,59,0,89.28272247314453,5267.680625915527,6,6,1,22,16055,3
100114,Groceries,76.92658996582031,2022-06-06,113,0,89.28272247314453,10088.947639465332,0,6,0,23,16168,3
100114,Groceries,76.92658996582031,2022-06-07,82,0,89.28272247314453,7321.183242797852,1,6,0,23,16250,3
100114,Groceries,76.92658996582031,2022-06-08,119,0,89.28272247314453,10624.6439743042,2,6,0,23,16369,3
100114,Groceries,76.92658996582031,2022-06-09,108,0,89.28272247314453,9642.53402709961,3,6,0,23,16477,3
100114,Groceries,76.92658996582031,2022-06-10,75,0,89.28272247314453,6696.20418548584,4,6,0,23,16552,3
100114,Groceries,76.92658996582031,2022-06-11,167,0,89.28272247314453,14910.214653015137,5,6,1,23,16719,3
100114,Groceries,76.92658996582031,2022-06-12,39,0,89.28272247314453,3482.0261764526367,6,6,1,23,16758,3
100114,Groceries,76.92658996582031,2022-06-13,86,0,89.28272247314453,7678.31413269043,0,6,0,24,16844,3
100114,Groceries,76.92658996582031,2022-06-14,140,574,89.4219125366211,63868.115510253905,1,6,0,24,16984,3
100114,Groceries,76.92658996582031,2022-06-15,112,0,89.37382507324219,10009.868408203125,2,6,0,24,17096,3
100114,Groceries,76.92658996582031,2022-06-16,147,0,89.37382507324219,13137.952285766602,3,6,0,24,17243,3
100114,Groceries,76.92658996582031,2022-06-17,130,0,89.37382507324219,11618.597259521484,4,6,0,24,17373,3
100114,Groceries,76.92658996582031,2022-06-18,192,0,89.37382507324219,17159.7744140625,5,6,1,24,17565,3
100114,Groceries,76.92658996582031,2022-06-19,67,0,89.37382507324219,5988.046279907227,6,6,1,24,17632,3
100114,Groceries,76.92658996582031,2022-06-20,132,371,82.22960556030273,40771.25586791993,0,6,0,25,17764,3
100114,Groceries,76.92658996582031,2022-06-21,130,0,84.69921112060547,11010.897445678711,1,6,0,25,17894,3
100114,Groceries,76.92658996582031,2022-06-22,130,709,84.49366256713867,70859.11226745605,2,6,0,25,18024,3
100114,Groceries,76.92658996582031,2022-06-23,109,0,84.54732513427734,9215.65843963623,3,6,0,25,18133,3
100114,Groceries,76.92658996582031,2022-06-24,120,0,84.54732513427734,10145.679016113281,4,6,0,25,18253,3
100114,Groceries,76.92658996582031,2022-06-25,61,0,84.54732513427734,5157.386833190918,5,6,1,25,18314,3
100114,Groceries,76.92658996582031,2022-06-26,201,697,86.55410446166992,78085.62999359131,6,6,1,25,18515,3
100114,Groceries,76.92658996582031,2022-06-27,120,0,85.82820892333984,10299.385070800781,0,6,0,26,18635,3
100114,Groceries,76.92658996582031,2022-06-28,61,0,85.82820892333984,5235.5207443237305,1,6,0,26,18696,3
100114,Groceries,76.92658996582031,2022-06-29,59,0,85.82820892333984,5063.864326477051,2,6,0,26,18755,3
100114,Groceries,76.92658996582031,2022-06-30,142,0,85.82820892333984,12187.605667114258,3,6,0,26,18897,3
100114,Groceries,76.92658996582031,2022-07-01,26,0,85.82820892333984,2231.533432006836,4,7,0,26,18923,3
100114,Groceries,76.92658996582031,2022-07-02,85,0,85.82820892333984,7295.397758483887,5,7,1,26,19008,3
100114,Groceries,76.92658996582031,2022-07-03,147,0,85.82820892333984,12616.746711730957,6,7,1,26,19155,3
100114,Groceries,76.92658996582031,2022-07-04,93,0,85.82820892333984,7982.0234298706055,0,7,0,27,19248,3
100114,Groceries,76.92658996582031,2022-07-05,48,0,85.82820892333984,4119.7540283203125,1,7,0,27,19296,3
100114,Groceries,76.92658996582031,2022-07-06,85,0,85.82820892333984,7295.397758483887,2,7,0,27,19381,3
100114,Groceries,76.92658996582031,2022-07-07,99,0,85.82820892333984,8496.992683410645,3,7,0,27,19480,3
100114,Groceries,76.92658996582031,2022-07-08,169,433,81.8152296447754,48966.267619934086,4,7,0,27,19649,3
100114,Groceries,76.92658996582031,2022-07-09,25,0,82.90045928955078,2072.5114822387695,5,7,1,27,19674,3
100114,Groceries,76.92658996582031,2022-07-10,56,0,82.90045928955078,4642.425720214844,6,7,1,27,19730,3
100114,Groceries,76.92658996582031,2022-07-11,75,0,82.90045928955078,6217.534446716309,0,7,0,28,19805,3
100114,Groceries,76.92658996582031,2022-07-12,76,0,82.90045928955078,6300.434906005859,1,7,0,28,19881,3
100114,Groceries,76.92658996582031,2022-07-13,126,325,72.71478790283203,32080.996551513672,2,7,0,28,20007,3
100114,Groceries,76.92658996582031,2022-07-14,106,0,76.29957580566406,8087.755035400391,3,7,0,28,20113,3
100114,Groceries,76.92658996582031,2022-07-15,67,0,76.29957580566406,5112.071578979492,4,7,0,28,20180,3
100114,Groceries,76.92658996582031,2022-07-16,38,0,76.29957580566406,2899.3838806152344,5,7,1,28,20218,3
100114,Groceries,76.92658996582031,2022-07-17,103,298,71.14565444946288,28163.654816589355,6,7,1,28,20321,3
100114,Groceries,76.92658996582031,2022-07-18,82,0,73.02130889892578,5987.747329711914,0,7,0,29,20403,3
100114,Groceries,76.92658996582031,2022-07-19,96,0,73.02130889892578,7010.045654296875,1,7,0,29,20499,3
100114,Groceries,76.92658996582031,2022-07-20,73,0,73.02130889892578,5330.555549621582,2,7,0,29,20572,3
100114,Groceries,76.92658996582031,2022-07-21,95,247,60.58856536865234,20029.907420043943,3,7,0,29,20667,3
100114,Groceries,76.92658996582031,2022-07-22,113,0,65.13713073730469,7360.49577331543,4,7,0,29,20780,3
100114,Groceries,76.92658996582031,2022-07-23,74,230,66.78782592773437,20409.918237304686,5,7,1,29,20854,3
100114,Groceries,76.92658996582031,2022-07-24,90,0,66.10565185546875,5949.5086669921875,6,7,1,29,20944,3
100114,Groceries,76.92658996582031,2022-07-25,160,480,88.75643768310547,58898.06005859375,0,7,0,30,21104,3
100114,Groceries,76.92658996582031,2022-07-26,131,0,82.21287536621094,10769.886672973633,1,7,0,30,21235,3
100114,Groceries,76.92658996582031,2022-07-27,55,0,82.21287536621094,4521.708145141602,2,7,0,30,21290,3
100114,Groceries,76.92658996582031,2022-07-28,105,0,82.21287536621094,8632.351913452148,3,7,0,30,21395,3
100114,Groceries,76.92658996582031,2022-07-29,111,0,82.21287536621094,9125.629165649414,4,7,0,30,21506,3
100114,Groceries,76.92658996582031,2022-07-30,102,381,77.85454635620117,37253.72745666504,5,7,1,30,21608,3
100114,Groceries,76.92658996582031,2022-07-31,156,619,91.3823728942871,72649.09034301757,6,7,1,30,21764,3
100114,Groceries,76.92658996582031,2022-08-01,50,0,87.43474578857422,4371.737289428711,0,8,0,31,21814,3
100114,Groceries,76.92658996582031,2022-08-02,134,0,87.43474578857422,11716.255935668945,1,8,0,31,21948,3
100114,Groceries,76.92658996582031,2022-08-03,148,0,87.43474578857422,12940.342376708984,2,8,0,31,22096,3
100114,Groceries,76.92658996582031,2022-08-04,185,0,87.43474578857422,16175.42797088623,3,8,0,31,22281,3
100114,Groceries,76.92658996582031,2022-08-05,241,578,99.23589370727538,82529.22076690674,4,8,0,31,22522,3
100114,Groceries,76.92658996582031,2022-08-06,77,0,95.51178741455078,7354.40763092041,5,8,1,31,22599,3
100114,Groceries,76.92658996582031,2022-08-07,151,0,95.51178741455078,14422.279899597168,6,8,1,31,22750,3
100114,Groceries,76.92658996582031,2022-08-08,74,0,95.51178741455078,7067.872268676758,0,8,0,32,22824,3
100114,Groceries,76.92658996582031,2022-08-09,204,737,103.13854873657226,98184.1078845215,1,8,0,32,23028,3
100114,Groceries,76.92658996582031,2022-08-10,85,0,101.01709747314453,8586.453285217285,2,8,0,32,23113,3
100114,Groceries,76.92658996582031,2022-08-11,129,0,101.01709747314453,13031.205574035645,3,8,0,32,23242,3
100114,Groceries,76.92658996582031,2022-08-12,35,0,101.01709747314453,3535.5984115600586,4,8,0,32,23277,3
100114,Groceries,76.92658996582031,2022-08-13,124,0,101.01709747314453,12526.120086669922,5,8,1,32,23401,3
100114,Groceries,76.92658996582031,2022-08-14,106,0,101.01709747314453,10707.81233215332,6,8,1,32,23507,3
100114,Groceries,76.92658996582031,2022-08-15,218,789,89.48144470214844,88245.52989013672,0,8,0,33,23725,3
100114,Groceries,76.92658996582031,2022-08-16,171,0,92.74288940429688,15859.034088134766,1,8,0,33,23896,3
100114,Groceries,76.92658996582031,2022-08-17,62,0,92.74288940429688,5750.059143066406,2,8,0,33,23958,3
100114,Groceries,76.92658996582031,2022-08-18,182,0,92.74288940429688,16879.20587158203,3,8,0,33,24140,3
100114,Groceries,76.92658996582031,2022-08-19,157,0,92.74288940429688,14560.63363647461,4,8,0,33,24297,3
100114,Groceries,76.92658996582031,2022-08-20,182,509,95.36609237670899,66222.97762512206,5,8,1,33,24479,3
100114,Groceries,76.92658996582031,2022-08-21,136,0,94.37218475341797,12834.617126464844,6,8,1,33,24615,3
100114,Groceries,76.92658996582031,2022-08-22,195,0,94.37218475341797,18402.576026916504,0,8,0,34,24810,3
100114,Groceries,76.92658996582031,2022-08-23,92,0,94.37218475341797,8682.240997314453,1,8,0,34,24902,3
100114,Groceries,76.92658996582031,2022-08-24,143,0,94.37218475341797,13495.22241973877,2,8,0,34,25045,3
100114,Groceries,76.92658996582031,2022-08-25,156,364,80.17565490722657,40675.124331054685,3,8,0,34,25201,3
100114,Groceries,76.92658996582031,2022-08-26,94,0,85.06130981445312,7995.763122558594,4,8,0,34,25295,3
100114,Groceries,76.92658996582031,2022-08-27,132,0,85.06130981445312,11228.092895507812,5,8,1,34,25427,3
100114,Groceries,76.92658996582031,2022-08-28,233,600,91.33896102905274,76621.55583953857,6,8,1,34,25660,3
100114,Groceries,76.92658996582031,2022-08-29,131,0,89.87792205810547,11774.007789611816,0,8,0,35,25791,3
100114,Groceries,76.92658996582031,2022-08-31,74,0,89.87792205810547,6650.966232299805,2,8,0,35,25865,3
100114,Groceries,76.92658996582031,2022-09-01,99,0,89.87792205810547,8897.914283752441,3,9,0,35,25964,3
100114,Groceries,76.92658996582031,2022-09-02,211,670,92.11854751586914,81404.96705169677,4,9,0,35,26175,3
100114,Groceries,76.92658996582031,2022-09-03,71,0,91.57709503173828,6501.973747253418,5,9,1,35,26246,3
100114,Groceries,76.92658996582031,2022-09-04,99,0,91.57709503173828,9066.13240814209,6,9,1,35,26345,3
100114,Groceries,76.92658996582031,2022-09-05,148,0,91.57709503173828,13553.410064697266,0,9,0,36,26493,3
100114,Groceries,76.92658996582031,2022-09-06,98,0,91.57709503173828,8974.555313110352,1,9,0,36,26591,3
100114,Groceries,76.92658996582031,2022-09-07,74,0,91.57709503173828,6776.705032348633,2,9,0,36,26665,3
100114,Groceries,76.92658996582031,2022-09-08,155,488,79.29498291015625,49806.19470214844,3,9,0,36,26820,3
100114,Groceries,76.92658996582031,2022-09-09,56,0,82.8399658203125,4639.0380859375,4,9,0,36,26876,3
100114,Groceries,76.92658996582031,2022-09-10,83,0,82.8399658203125,6875.7171630859375,5,9,1,36,26959,3
100114,Groceries,76.92658996582031,2022-09-11,113,0,82.8399658203125,9360.916137695312,6,9,1,36,27072,3
100114,Groceries,76.92658996582031,2022-09-12,107,0,82.8399658203125,8863.876342773438,0,9,0,37,27179,3
100114,Groceries,76.92658996582031,2022-09-13,70,0,82.8399658203125,5798.797607421875,1,9,0,37,27249,3
100114,Groceries,76.92658996582031,2022-09-14,113,300,74.57499328613281,30284.288482666012,2,9,0,37,27362,3
100114,Groceries,76.92658996582031,2022-09-15,179,603,84.35051208496094,66818.36332641602,3,9,0,37,27541,3
100114,Groceries,76.92658996582031,2022-09-16,8,0,82.33102416992188,658.648193359375,4,9,0,37,27549,3
100114,Groceries,76.92658996582031,2022-09-17,135,0,82.33102416992188,11114.688262939453,5,9,1,37,27684,3
100114,Groceries,76.92658996582031,2022-09-18,47,0,82.33102416992188,3869.558135986328,6,9,1,37,27731,3
100114,Groceries,76.92658996582031,2022-09-19,85,0,82.33102416992188,6998.137054443359,0,9,0,38,27816,3
100114,Groceries,76.92658996582031,2022-09-20,138,0,82.33102416992188,11361.681335449219,1,9,0,38,27954,3
100114,Groceries,76.92658996582031,2022-09-21,100,0,82.33102416992188,8233.102416992188,2,9,0,38,28054,3
100114,Groceries,76.92658996582031,2022-09-22,53,0,82.33102416992188,4363.544281005859,3,9,0,38,28107,3
100114,Groceries,76.92658996582031,2022-09-23,126,603,86.30584976196289,63338.70414001465,4,9,0,38,28233,3
100114,Groceries,76.92658996582031,2022-09-24,146,0,85.42169952392578,12471.568130493164,5,9,1,38,28379,3
100114,Groceries,76.92658996582031,2022-09-25,73,0,85.42169952392578,6235.784065246582,6,9,1,38,28452,3
100114,Groceries,76.92658996582031,2022-09-26,197,509,81.20032257080078,56837.487092895506,0,9,0,39,28649,3
100114,Groceries,76.92658996582031,2022-09-27,64,0,82.77064514160156,5297.3212890625,1,9,0,39,28713,3
100114,Groceries,76.92658996582031,2022-09-28,134,0,82.77064514160156,11091.26644897461,2,9,0,39,28847,3
100114,Groceries,76.92658996582031,2022-09-29,70,0,82.77064514160156,5793.945159912109,3,9,0,39,28917,3
100114,Groceries,76.92658996582031,2022-09-30,89,0,82.77064514160156,7366.587417602539,4,9,0,39,29006,3
100114,Groceries,76.92658996582031,2022-10-01,103,0,82.77064514160156,8525.376449584961,5,10,1,39,29109,3
100114,Groceries,76.92658996582031,2022-10-02,162,638,95.86745574951172,78332.6156628418,6,10,1,39,29271,3
100114,Groceries,76.92658996582031,2022-10-03,157,0,92.42491149902344,14510.71110534668,0,10,0,40,29428,3
100114,Groceries,76.92658996582031,2022-10-04,136,0,92.42491149902344,12569.787963867188,1,10,0,40,29564,3
100114,Groceries,76.92658996582031,2022-10-05,92,0,92.42491149902344,8503.091857910156,2,10,0,40,29656,3
100114,Groceries,76.92658996582031,2022-10-06,57,0,92.42491149902344,5268.219955444336,3,10,0,40,29713,3
100114,Groceries,76.92658996582031,2022-10-07,101,0,92.42491149902344,9334.916061401367,4,10,0,40,29814,3
100114,Groceries,76.92658996582031,2022-10-08,136,554,82.14593719482423,55566.33491699219,5,10,1,40,29950,3
100114,Groceries,76.92658996582031,2022-10-09,128,0,84.81187438964844,10855.919921875,6,10,1,40,30078,3
100114,Groceries,76.92658996582031,2022-10-10,111,0,84.81187438964844,9414.118057250977,0,10,0,41,30189,3
100114,Groceries,76.92658996582031,2022-10-11,112,0,84.81187438964844,9498.929931640625,1,10,0,41,30301,3
100114,Groceries,76.92658996582031,2022-10-12,85,0,84.81187438964844,7209.009323120117,2,10,0,41,30386,3
100114,Groceries,76.92658996582031,2022-10-13,71,0,84.81187438964844,6021.643081665039,3,10,0,41,30457,3
100114,Groceries,76.92658996582031,2022-10-14,51,0,84.81187438964844,4325.40559387207,4,10,0,41,30508,3
100114,Groceries,76.92658996582031,2022-10-15,109,454,79.12090225219727,44123.85669097901,5,10,1,41,30617,3
100114,Groceries,76.92658996582031,2022-10-16,52,0,80.34180450439453,4177.773834228516,6,10,1,41,30669,3
100114,Groceries,76.92658996582031,2022-10-17,60,0,80.34180450439453,4820.508270263672,0,10,0,42,30729,3
100114,Groceries,76.92658996582031,2022-10-18,68,0,80.34180450439453,5463.242706298828,1,10,0,42,30797,3
100114,Groceries,76.92658996582031,2022-10-19,77,0,80.34180450439453,6186.318946838379,2,10,0,42,30874,3
100114,Groceries,76.92658996582031,2022-10-20,93,245,73.28184707641601,24332.74355621338,3,10,0,42,30967,3
100114,Groceries,76.92658996582031,2022-10-21,61,0,76.15369415283203,4645.375343322754,4,10,0,42,31028,3
100114,Groceries,76.92658996582031,2022-10-22,133,379,74.73956512451173,38141.304323120115,5,10,1,42,31161,3
100114,Groceries,76.92658996582031,2022-10-23,56,0,75.24913024902344,4213.9512939453125,6,10,1,42,31217,3
100114,Groceries,76.92658996582031,2022-10-24,63,0,75.24913024902344,4740.695205688477,0,10,0,43,31280,3
100114,Groceries,76.92658996582031,2022-10-25,49,0,75.24913024902344,3687.2073822021484,1,10,0,43,31329,3
100114,Groceries,76.92658996582031,2022-10-26,77,0,75.24913024902344,5794.183029174805,2,10,0,43,31406,3
100114,Groceries,76.92658996582031,2022-10-27,104,0,75.24913024902344,7825.9095458984375,3,10,0,43,31510,3
100114,Groceries,76.92658996582031,2022-10-28,104,431,78.84708694458007,42504.60408447265,4,10,0,43,31614,3
100114,Groceries,76.92658996582031,2022-10-29,98,0,77.86417388916016,7630.689041137695,5,10,1,43,31712,3
100114,Groceries,76.92658996582031,2022-10-30,122,0,77.86417388916016,9499.429214477539,6,10,1,43,31834,3
100114,Groceries,76.92658996582031,2022-10-31,68,0,77.86417388916016,5294.763824462891,0,10,0,44,31902,3
100114,Groceries,76.92658996582031,2022-11-01,156,673,88.99562423706055,74999.75476196289,1,11,0,44,32058,3
100114,Groceries,76.92658996582031,2022-11-02,153,0,86.6312484741211,13254.581016540527,2,11,0,44,32211,3
100114,Groceries,76.92658996582031,2022-11-03,54,0,86.6312484741211,4678.087417602539,3,11,0,44,32265,3
100114,Groceries,76.92658996582031,2022-11-04,147,0,86.6312484741211,12734.7935256958,4,11,0,44,32412,3
100114,Groceries,76.92658996582031,2022-11-05,157,516,83.33339630126953,55683.66643859863,5,11,1,44,32569,3
100114,Groceries,76.92658996582031,2022-11-06,74,0,84.44679260253906,6249.062652587891,6,11,1,44,32643,3
100114,Groceries,76.92658996582031,2022-11-07,120,0,84.44679260253906,10133.615112304688,0,11,0,45,32763,3
100114,Groceries,76.92658996582031,2022-11-08,137,0,84.44679260253906,11569.210586547852,1,11,0,45,32900,3
100114,Groceries,76.92658996582031,2022-11-09,103,0,84.44679260253906,8698.019638061523,2,11,0,45,33003,3
100114,Groceries,76.92658996582031,2022-11-10,87,0,84.44679260253906,7346.870956420898,3,11,0,45,33090,3
100114,Groceries,76.92658996582031,2022-11-11,55,0,84.44679260253906,4644.573593139648,4,11,0,45,33145,3
100114,Groceries,76.92658996582031,2022-11-12,69,0,84.44679260253906,5826.828689575195,5,11,1,45,33214,3
100114,Groceries,76.92658996582031,2022-11-13,65,191,65.30564971923829,15787.654463500978,6,11,1,45,33279,3
100114,Groceries,76.92658996582031,2022-11-14,134,494,80.16089233398438,51067.91914550782,0,11,0,46,33413,3
100114,Groceries,76.92658996582031,2022-11-15,41,0,78.14178466796875,3203.8131713867188,1,11,0,46,33454,3
100114,Groceries,76.92658996582031,2022-11-16,136,0,78.14178466796875,10627.28271484375,2,11,0,46,33590,3
100114,Groceries,76.92658996582031,2022-11-17,139,0,78.14178466796875,10861.708068847656,3,11,0,46,33729,3
100114,Groceries,76.92658996582031,2022-11-18,198,671,87.54862594604492,77121.00587463379,4,11,0,46,33927,3
100114,Groceries,76.92658996582031,2022-11-19,121,0,85.34725189208984,10327.017478942871,5,11,1,46,34048,3
100114,Groceries,76.92658996582031,2022-11-20,91,0,85.34725189208984,7766.599922180176,6,11,1,46,34139,3
100114,Groceries,76.92658996582031,2022-11-21,148,0,85.34725189208984,12631.393280029297,0,11,0,47,34287,3
100114,Groceries,76.92658996582031,2022-11-22,199,720,90.86098388671874,84266.60158691407,1,11,0,47,34486,3
100114,Groceries,76.92658996582031,2022-11-23,52,0,89.3919677734375,4648.38232421875,2,11,0,47,34538,3
100114,Groceries,76.92658996582031,2022-11-24,119,0,89.3919677734375,10637.644165039062,3,11,0,47,34657,3
100114,Groceries,76.92658996582031,2022-11-25,115,0,89.3919677734375,10280.076293945312,4,11,0,47,34772,3
100114,Groceries,76.92658996582031,2022-11-26,164,0,89.3919677734375,14660.28271484375,5,11,1,47,34936,3
100114,Groceries,76.92658996582031,2022-11-27,65,0,89.3919677734375,5810.4779052734375,6,11,1,47,35001,3
100114,Groceries,76.92658996582031,2022-11-28,55,0,89.3919677734375,4916.5582275390625,0,11,0,48,35056,3
100114,Groceries,76.92658996582031,2022-11-29,19,0,89.3919677734375,1698.4473876953125,1,11,0,48,35075,3
100114,Groceries,76.92658996582031,2022-11-30,107,0,89.3919677734375,9564.940551757812,2,11,0,48,35182,3
100114,Groceries,76.92658996582031,2022-12-01,46,0,89.3919677734375,4112.030517578125,3,12,0,48,35228,3
100114,Groceries,76.92658996582031,2022-12-02,41,0,89.3919677734375,3665.0706787109375,4,12,0,48,35269,3
100114,Groceries,76.92658996582031,2022-12-03,40,0,89.3919677734375,3575.6787109375,5,12,1,48,35309,3
100114,Groceries,76.92658996582031,2022-12-04,76,226,74.04849517822265,21606.871267089846,6,12,1,48,35385,3
100114,Groceries,76.92658996582031,2022-12-05,94,317,68.8200765991211,27439.864400634768,0,12,0,49,35479,3
100114,Groceries,76.92658996582031,2022-12-06,51,0,72.61015319824219,3703.1178131103516,1,12,0,49,35530,3
100114,Groceries,76.92658996582031,2022-12-07,48,0,72.61015319824219,3485.287353515625,2,12,0,49,35578,3
100114,Groceries,76.92658996582031,2022-12-08,103,0,72.61015319824219,7478.845779418945,3,12,0,49,35681,3
100114,Groceries,76.92658996582031,2022-12-09,93,387,73.65779006958007,35459.2889529419,4,12,0,49,35774,3
100114,Groceries,76.92658996582031,2022-12-10,179,0,73.30558013916016,13121.698844909668,5,12,1,49,35953,3
100114,Groceries,76.92658996582031,2022-12-11,120,0,73.30558013916016,8796.669616699219,6,12,1,49,36073,3
100114,Groceries,76.92658996582031,2022-12-12,134,652,85.18198318481446,68360.97149353028,0,12,0,50,36207,3
100114,Groceries,76.92658996582031,2022-12-13,106,0,82.4639663696289,8741.180435180664,1,12,0,50,36313,3
100114,Groceries,76.92658996582031,2022-12-14,147,0,82.4639663696289,12122.20305633545,2,12,0,50,36460,3
100114,Groceries,76.92658996582031,2022-12-15,47,0,82.4639663696289,3875.8064193725586,3,12,0,50,36507,3
100114,Groceries,76.92658996582031,2022-12-16,283,762,88.83853073120117,93703.95839385987,4,12,0,50,36790,3
100114,Groceries,76.92658996582031,2022-12-17,105,0,87.02706146240234,9137.841453552246,5,12,1,50,36895,3
100114,Groceries,76.92658996582031,2022-12-18,144,0,87.02706146240234,12531.896850585938,6,12,1,50,37039,3
100114,Groceries,76.92658996582031,2022-12-19,69,0,87.02706146240234,6004.867240905762,0,12,0,51,37108,3
100114,Groceries,76.92658996582031,2022-12-20,95,0,87.02706146240234,8267.570838928223,1,12,0,51,37203,3
100114,Groceries,76.92658996582031,2022-12-21,57,0,87.02706146240234,4960.542503356934,2,12,0,51,37260,3
100114,Groceries,76.92658996582031,2022-12-22,81,0,87.02706146240234,7049.19197845459,3,12,0,51,37341,3
100114,Groceries,76.92658996582031,2022-12-23,37,0,87.02706146240234,3220.0012741088867,4,12,0,51,37378,3
100114,Groceries,76.92658996582031,2022-12-24,89,0,87.02706146240234,7745.408470153809,5,12,1,51,37467,3
100114,Groceries,76.92658996582031,2022-12-25,80,0,87.02706146240234,6962.1649169921875,6,12,1,51,37547,3
100114,Groceries,76.92658996582031,2022-12-26,118,513,80.94898056030274,50498.55941223145,0,12,0,52,37665,3
100114,Groceries,76.92658996582031,2022-12-27,58,0,82.41796112060547,4780.241744995117,1,12,0,52,37723,3
100114,Groceries,76.92658996582031,2022-12-28,80,0,82.41796112060547,6593.4368896484375,2,12,0,52,37803,3
100114,Groceries,76.92658996582031,2022-12-29,120,0,82.41796112060547,9890.155334472656,3,12,0,52,37923,3
100114,Groceries,76.92658996582031,2022-12-30,85,0,82.41796112060547,7005.526695251465,4,12,0,52,38008,3
100114,Groceries,76.92658996582031,2022-12-31,71,0,82.41796112060547,5851.675239562988,5,12,1,52,38079,3
100114,Groceries,76.92658996582031,2023-01-01,123,319,66.35107666015625,28301.884858398436,6,1,1,52,38202,3
100114,Groceries,76.92658996582031,2023-01-02,23,0,71.5821533203125,1646.3895263671875,0,1,0,1,38225,3
100114,Groceries,76.92658996582031,2023-01-03,56,0,71.5821533203125,4008.6005859375,1,1,0,1,38281,3
100114,Groceries,76.92658996582031,2023-01-04,65,0,71.5821533203125,4652.8399658203125,2,1,0,1,38346,3
100114,Groceries,76.92658996582031,2023-01-05,102,256,75.1479020690918,27129.652022094728,3,1,0,1,38448,3
100114,Groceries,76.92658996582031,2023-01-06,131,0,73.6758041381836,9651.53034210205,4,1,0,1,38579,3
100114,Groceries,76.92658996582031,2023-01-07,127,633,80.56897827148438,62042.54048095703,5,1,1,1,38706,3
100114,Groceries,76.92658996582031,2023-01-08,109,0,78.96795654296875,8607.507263183594,6,1,1,1,38815,3
100114,Groceries,76.92658996582031,2023-01-09,124,0,78.96795654296875,9792.026611328125,0,1,0,2,38939,3
100114,Groceries,76.92658996582031,2023-01-10,69,0,78.96795654296875,5448.789001464844,1,1,0,2,39008,3
100114,Groceries,76.92658996582031,2023-01-11,223,528,91.93663803100586,70457.5905618286,2,1,0,2,39231,3
100114,Groceries,76.92658996582031,2023-01-12,151,0,87.30327606201172,13182.79468536377,3,1,0,2,39382,3
100114,Groceries,76.92658996582031,2023-01-13,202,0,87.30327606201172,17635.261764526367,4,1,0,2,39584,3
100114,Groceries,76.92658996582031,2023-01-14,83,0,87.30327606201172,7246.171913146973,5,1,1,2,39667,3
100114,Groceries,76.92658996582031,2023-01-15,117,366,84.61273483276366,40610.7999508667,6,1,1,2,39784,3
100114,Groceries,76.92658996582031,2023-01-16,53,0,85.64546966552734,4539.209892272949,0,1,0,3,39837,3
100114,Groceries,76.92658996582031,2023-01-17,145,0,85.64546966552734,12418.593101501465,1,1,0,3,39982,3
100114,Groceries,76.92658996582031,2023-01-18,218,666,84.64564758300781,74703.26234619142,2,1,0,3,40200,3
100114,Groceries,76.92658996582031,2023-01-19,97,0,84.92129516601562,8237.365631103516,3,1,0,3,40297,3
100114,Groceries,76.92658996582031,2023-01-20,189,0,84.92129516601562,16050.124786376953,4,1,0,3,40486,3
100114,Groceries,76.92658996582031,2023-01-21,107,0,84.92129516601562,9086.578582763672,5,1,1,3,40593,3
100114,Groceries,76.92658996582031,2023-01-22,153,0,84.92129516601562,12992.95816040039,6,1,1,3,40746,3
100114,Groceries,76.92658996582031,2023-01-23,83,0,84.92129516601562,7048.467498779297,0,1,0,4,40829,3
100114,Groceries,76.92658996582031,2023-01-24,197,592,81.08766067504882,63651.238305969244,1,1,0,4,41026,3
100114,Groceries,76.92658996582031,2023-01-25,97,0,81.91532135009766,7945.786170959473,2,1,0,4,41123,3
100114,Groceries,76.92658996582031,2023-01-26,32,0,81.91532135009766,2621.290283203125,3,1,0,4,41155,3
100114,Groceries,76.92658996582031,2023-01-27,104,0,81.91532135009766,8519.193420410156,4,1,0,4,41259,3
100114,Groceries,76.92658996582031,2023-01-28,71,0,81.91532135009766,5815.987815856934,5,1,1,4,41330,3
100114,Groceries,76.92658996582031,2023-01-29,20,0,81.91532135009766,1638.3064270019531,6,1,1,4,41350,3
100114,Groceries,76.92658996582031,2023-01-30,67,0,81.91532135009766,5488.326530456543,0,1,0,5,41417,3
100114,Groceries,76.92658996582031,2023-01-31,44,0,81.91532135009766,3604.274139404297,1,1,0,5,41461,3
100114,Groceries,76.92658996582031,2023-02-01,102,308,73.28609695434571,29483.66377868652,2,2,0,5,41563,3
100114,Groceries,76.92658996582031,2023-02-02,83,0,76.0221939086914,6309.842094421387,3,2,0,5,41646,3
100114,Groceries,76.92658996582031,2023-02-03,53,0,76.0221939086914,4029.1762771606445,4,2,0,5,41699,3
100114,Groceries,76.92658996582031,2023-02-04,92,0,76.0221939086914,6994.041839599609,5,2,1,5,41791,3
100114,Groceries,76.92658996582031,2023-02-05,38,0,76.0221939086914,2888.8433685302734,6,2,1,5,41829,3
100114,Groceries,76.92658996582031,2023-02-06,65,204,64.5422264099121,16793.039433288577,0,2,0,6,41894,3
100114,Groceries,76.92658996582031,2023-02-07,37,0,68.63445281982422,2539.474754333496,1,2,0,6,41931,3
100114,Groceries,76.92658996582031,2023-02-08,79,306,66.75560073852539,25552.08491668701,2,2,0,6,42010,3
100114,Groceries,76.92658996582031,2023-02-09,81,0,67.41120147705078,5460.307319641113,3,2,0,6,42091,3
100114,Groceries,76.92658996582031,2023-02-10,36,0,67.41120147705078,2426.803253173828,4,2,0,6,42127,3
100114,Groceries,76.92658996582031,2023-02-11,32,0,67.41120147705078,2157.158447265625,5,2,1,6,42159,3
100114,Groceries,76.92658996582031,2023-02-12,47,0,67.41120147705078,3168.3264694213867,6,2,1,6,42206,3
100114,Groceries,76.92658996582031,2023-02-13,58,0,67.41120147705078,3909.8496856689453,0,2,0,7,42264,3
100114,Groceries,76.92658996582031,2023-02-14,72,284,69.86876235961914,25053.741779785156,1,2,0,7,42336,3
100114,Groceries,76.92658996582031,2023-02-15,61,0,69.01752471923828,4210.069007873535,2,2,0,7,42397,3
100114,Groceries,76.92658996582031,2023-02-16,86,0,69.01752471923828,5935.507125854492,3,2,0,7,42483,3
100114,Groceries,76.92658996582031,2023-02-17,47,0,69.01752471923828,3243.823661804199,4,2,0,7,42530,3
100114,Groceries,76.92658996582031,2023-02-18,77,0,69.01752471923828,5314.349403381348,5,2,1,7,42607,3
100114,Groceries,76.92658996582031,2023-02-19,56,0,69.01752471923828,3864.9813842773438,6,2,1,7,42663,3
100114,Groceries,76.92658996582031,2023-02-20,24,0,69.01752471923828,1656.4205932617188,0,2,0,8,42687,3
100114,Groceries,76.92658996582031,2023-02-21,124,365,78.01578826904297,38543.565490722656,1,2,0,8,42811,3
100114,Groceries,76.92658996582031,2023-02-22,38,0,76.38157653808594,2902.4999084472656,2,2,0,8,42849,3
100114,Groceries,76.92658996582031,2023-02-24,140,329,75.22327545166016,35201.60712646485,4,2,0,8,42989,3
100114,Groceries,76.92658996582031,2023-02-25,96,0,75.63655090332031,7261.10888671875,5,2,1,8,43085,3
100114,Groceries,76.92658996582031,2023-02-26,43,0,75.63655090332031,3252.3716888427734,6,2,1,8,43128,3
100114,Groceries,76.92658996582031,2023-02-27,124,455,67.14851486206055,37999.02168579101,0,2,0,9,43252,3
100114,Groceries,76.92658996582031,2023-02-28,85,0,69.8070297241211,5933.597526550293,1,2,0,9,43337,3
100114,Groceries,76.92658996582031,2023-03-01,150,0,69.8070297241211,10471.054458618164,2,3,0,9,43487,3
100114,Groceries,76.92658996582031,2023-03-02,104,0,69.8070297241211,7259.931091308594,3,3,0,9,43591,3
100114,Groceries,76.92658996582031,2023-03-03,229,650,74.88036529541016,66329.09730529785,4,3,0,9,43820,3
100114,Groceries,76.92658996582031,2023-03-04,96,0,73.67073059082031,7072.39013671875,5,3,1,9,43916,3
100114,Groceries,76.92658996582031,2023-03-05,82,0,73.67073059082031,6040.999908447266,6,3,1,9,43998,3
100114,Groceries,76.92658996582031,2023-03-06,34,0,73.67073059082031,2504.8048400878906,0,3,0,10,44032,3
100114,Groceries,76.92658996582031,2023-03-07,163,0,73.67073059082031,12008.329086303711,1,3,0,10,44195,3
100114,Groceries,76.92658996582031,2023-03-08,80,318,75.49933898925781,30229.77423828125,2,3,0,10,44275,3
100114,Groceries,76.92658996582031,2023-03-09,150,0,74.73867797851562,11210.801696777344,3,3,0,10,44425,3
100114,Groceries,76.92658996582031,2023-03-10,100,420,84.09479034423828,44902.15806884766,4,3,0,10,44525,3
100114,Groceries,76.92658996582031,2023-03-11,65,0,80.42958068847656,5227.922744750977,5,3,1,10,44590,3
100114,Groceries,76.92658996582031,2023-03-12,43,0,80.42958068847656,3458.471969604492,6,3,1,10,44633,3
100114,Groceries,76.92658996582031,2023-03-13,46,0,80.42958068847656,3699.760711669922,0,3,0,11,44679,3
100114,Groceries,76.92658996582031,2023-03-14,61,0,80.42958068847656,4906.20442199707,1,3,0,11,44740,3
100114,Groceries,76.92658996582031,2023-03-15,161,0,80.42958068847656,12949.162490844727,2,3,0,11,44901,3
100114,Groceries,76.92658996582031,2023-03-16,100,0,80.42958068847656,8042.958068847656,3,3,0,11,45001,3
100114,Groceries,76.92658996582031,2023-03-17,68,358,73.88020126342774,30808.807371826173,4,3,0,11,45069,3
100114,Groceries,76.92658996582031,2023-03-18,135,0,76.17040252685547,10283.004341125488,5,3,1,11,45204,3
100114,Groceries,76.92658996582031,2023-03-19,123,0,76.17040252685547,9368.959510803223,6,3,1,11,45327,3
100114,Groceries,76.92658996582031,2023-03-20,50,0,76.17040252685547,3808.5201263427734,0,3,0,12,45377,3
100114,Groceries,76.92658996582031,2023-03-21,111,385,80.78159881591796,40475.494937133786,1,3,0,12,45488,3
100114,Groceries,76.92658996582031,2023-03-22,138,0,79.29319763183594,10942.46127319336,2,3,0,12,45626,3
100114,Groceries,76.92658996582031,2023-03-23,118,0,79.29319763183594,9356.59732055664,3,3,0,12,45744,3
100114,Groceries,76.92658996582031,2023-03-24,121,402,81.04331176757813,42544.89144775391,4,3,0,12,45865,3
100114,Groceries,76.92658996582031,2023-03-25,109,0,80.47662353515625,8771.951965332031,5,3,1,12,45974,3
100114,Groceries,76.92658996582031,2023-03-26,151,0,80.47662353515625,12151.970153808594,6,3,1,12,46125,3
100114,Groceries,76.92658996582031,2023-03-27,128,404,72.65559722900392,37930.872890625,0,3,0,13,46253,3
100114,Groceries,76.92658996582031,2023-03-28,90,0,75.27119445800781,6774.407501220703,1,3,0,13,46343,3
100114,Groceries,76.92658996582031,2023-03-29,46,0,75.27119445800781,3462.4749450683594,2,3,0,13,46389,3
100114,Groceries,76.92658996582031,2023-03-30,108,0,75.27119445800781,8129.289001464844,3,3,0,13,46497,3
100114,Groceries,76.92658996582031,2023-03-31,95,0,75.27119445800781,7150.763473510742,4,3,0,13,46592,3
100114,Groceries,76.92658996582031,2023-04-01,131,322,80.61346755981445,36872.49850067138,5,4,1,13,46723,3
100114,Groceries,76.92658996582031,2023-04-02,108,0,78.7569351196289,8505.748992919922,6,4,1,13,46831,3
100114,Groceries,76.92658996582031,2023-04-03,104,443,80.88804153442382,44480.33263916016,0,4,0,14,46935,3
100114,Groceries,76.92658996582031,2023-04-04,123,0,80.19608306884766,9864.118217468262,1,4,0,14,47058,3
100114,Groceries,76.92658996582031,2023-04-05,69,0,80.19608306884766,5533.529731750488,2,4,0,14,47127,3
100114,Groceries,76.92658996582031,2023-04-06,129,0,80.19608306884766,10345.294715881348,3,4,0,14,47256,3
100114,Groceries,76.92658996582031,2023-04-07,61,0,80.19608306884766,4891.961067199707,4,4,0,14,47317,3
100114,Groceries,76.92658996582031,2023-04-08,161,494,87.27300262451172,57822.15684509277,5,4,1,14,47478,3
100114,Groceries,76.92658996582031,2023-04-09,98,0,85.29600524902344,8359.008514404297,6,4,1,14,47576,3
100114,Groceries,76.92658996582031,2023-04-10,124,0,85.29600524902344,10576.704650878906,0,4,0,15,47700,3
100114,Groceries,76.92658996582031,2023-04-11,110,0,85.29600524902344,9382.560577392578,1,4,0,15,47810,3
100114,Groceries,76.92658996582031,2023-04-12,61,0,85.29600524902344,5203.05632019043,2,4,0,15,47871,3
100114,Groceries,76.92658996582031,2023-04-13,49,0,85.29600524902344,4179.504257202148,3,4,0,15,47920,3
100114,Groceries,76.92658996582031,2023-04-14,50,0,85.29600524902344,4264.800262451172,4,4,0,15,47970,3
100114,Groceries,76.92658996582031,2023-04-15,115,314,77.23842483520508,32713.71771209717,5,4,1,15,48085,3
100114,Groceries,76.92658996582031,2023-04-16,103,0,79.35684967041016,8173.755516052246,6,4,1,15,48188,3
100114,Groceries,76.92658996582031,2023-04-17,6,0,79.35684967041016,476.14109802246094,0,4,0,16,48194,3
100114,Groceries,76.92658996582031,2023-04-18,23,0,79.35684967041016,1825.2075424194336,1,4,0,16,48217,3
100114,Groceries,76.92658996582031,2023-04-19,44,183,67.8961831665039,14706.844118652343,2,4,0,16,48261,3
100114,Groceries,76.92658996582031,2023-04-20,97,0,72.97236633300781,7078.319534301758,3,4,0,16,48358,3
100114,Groceries,76.92658996582031,2023-04-21,52,311,65.80811050415039,23241.33349243164,4,4,0,16,48410,3
100114,Groceries,76.92658996582031,2023-04-22,41,0,68.30622100830078,2800.555061340332,5,4,1,16,48451,3
100114,Groceries,76.92658996582031,2023-04-23,73,0,68.30622100830078,4986.354133605957,6,4,1,16,48524,3
100114,Groceries,76.92658996582031,2023-04-24,42,0,68.30622100830078,2868.861282348633,0,4,0,17,48566,3
100114,Groceries,76.92658996582031,2023-04-25,71,0,68.30622100830078,4849.7416915893555,1,4,0,17,48637,3
100114,Groceries,76.92658996582031,2023-04-26,68,0,68.30622100830078,4644.823028564453,2,4,0,17,48705,3
100114,Groceries,76.92658996582031,2023-04-27,81,203,68.73770614624024,19543.74839569092,3,4,0,17,48786,3
100114,Groceries,76.92658996582031,2023-04-28,51,0,68.55541229248047,3496.326026916504,4,4,0,17,48837,3
100114,Groceries,76.92658996582031,2023-04-29,117,277,73.24731307983399,29159.071260681154,5,4,1,17,48954,3
100114,Groceries,76.92658996582031,2023-04-30,80,0,71.37462615966797,5709.9700927734375,6,4,1,17,49034,3
100114,Groceries,76.92658996582031,2023-05-01,49,0,71.37462615966797,3497.3566818237305,0,5,0,18,49083,3
100114,Groceries,76.92658996582031,2023-05-02,50,0,71.37462615966797,3568.7313079833984,1,5,0,18,49133,3
100114,Groceries,76.92658996582031,2023-05-03,52,0,71.37462615966797,3711.4805603027344,2,5,0,18,49185,3
100114,Groceries,76.92658996582031,2023-05-04,61,0,71.37462615966797,4353.852195739746,3,5,0,18,49246,3
100114,Groceries,76.92658996582031,2023-05-05,62,236,65.7761555480957,19276.583287963866,4,5,0,18,49308,3
100114,Groceries,76.92658996582031,2023-05-06,56,0,67.6423110961914,3787.9694213867188,5,5,1,18,49364,3
100114,Groceries,76.92658996582031,2023-05-07,86,0,67.6423110961914,5817.238754272461,6,5,1,18,49450,3
100114,Groceries,76.92658996582031,2023-05-08,73,0,67.6423110961914,4937.888710021973,0,5,0,19,49523,3
100114,Groceries,76.92658996582031,2023-05-09,59,274,65.98496856689454,21879.476290893555,1,5,0,19,49582,3
100114,Groceries,76.92658996582031,2023-05-10,89,0,66.41993713378906,5911.374404907227,2,5,0,19,49671,3
100114,Groceries,76.92658996582031,2023-05-11,47,268,71.11966079711914,22791.7281149292,3,5,0,19,49718,3
100114,Groceries,76.92658996582031,2023-05-12,24,0,69.35932159423828,1664.6237182617188,4,5,0,19,49742,3
100114,Groceries,76.92658996582031,2023-05-13,101,481,86.18204895019531,52395.37388793945,5,5,1,19,49843,3
100114,Groceries,76.92658996582031,2023-05-14,84,0,80.29409790039062,6744.7042236328125,6,5,1,19,49927,3
100114,Groceries,76.92658996582031,2023-05-15,116,0,80.29409790039062,9314.115356445312,0,5,0,20,50043,3
100114,Groceries,76.92658996582031,2023-05-16,265,801,81.79462432861328,87437.15089416504,1,5,0,20,50308,3
100114,Groceries,76.92658996582031,2023-05-17,56,0,81.33924865722656,4554.9979248046875,2,5,0,20,50364,3
100114,Groceries,76.92658996582031,2023-05-18,203,0,81.33924865722656,16511.867477416992,3,5,0,20,50567,3
100114,Groceries,76.92658996582031,2023-05-19,107,0,81.33924865722656,8703.299606323242,4,5,0,20,50674,3
100114,Groceries,76.92658996582031,2023-05-20,97,0,81.33924865722656,7889.907119750977,5,5,1,20,50771,3
100114,Groceries,76.92658996582031,2023-05-21,132,0,81.33924865722656,10736.780822753906,6,5,1,20,50903,3
100114,Groceries,76.92658996582031,2023-05-22,132,0,81.33924865722656,10736.780822753906,0,5,0,21,51035,3
100114,Groceries,76.92658996582031,2023-05-23,101,0,81.33924865722656,8215.264114379883,1,5,0,21,51136,3
100114,Groceries,76.92658996582031,2023-05-24,212,631,84.70158935546874,71746.35388671875,2,5,0,21,51348,3
100114,Groceries,76.92658996582031,2023-05-25,75,0,83.8831787109375,6291.2384033203125,3,5,0,21,51423,3
100114,Groceries,76.92658996582031,2023-05-26,42,0,83.8831787109375,3523.093505859375,4,5,0,21,51465,3
100114,Groceries,76.92658996582031,2023-05-27,51,0,83.8831787109375,4278.0421142578125,5,5,1,21,51516,3
100114,Groceries,76.92658996582031,2023-05-28,128,0,83.8831787109375,10737.046875,6,5,1,21,51644,3
100114,Groceries,76.92658996582031,2023-05-29,187,460,84.09329315185548,54429.30163879395,0,5,0,22,51831,3
100114,Groceries,76.92658996582031,2023-05-30,67,0,84.01658630371094,5629.111282348633,1,5,0,22,51898,3
100114,Groceries,76.92658996582031,2023-05-31,77,0,84.01658630371094,6469.277145385742,2,5,0,22,51975,3
100114,Groceries,76.92658996582031,2023-06-01,152,0,84.01658630371094,12770.521118164062,3,6,0,22,52127,3
100114,Groceries,76.92658996582031,2023-06-02,146,0,84.01658630371094,12266.421600341797,4,6,0,22,52273,3
100114,Groceries,76.92658996582031,2023-06-03,84,459,66.54232650756836,34286.610853271486,5,6,1,22,52357,3
100114,Groceries,76.92658996582031,2023-06-04,128,0,71.46465301513672,9147.4755859375,6,6,1,22,52485,3
100114,Groceries,76.92658996582031,2023-06-05,148,659,89.98125854492187,75598.47252929688,0,6,0,23,52633,3
100114,Groceries,76.92658996582031,2023-06-06,239,0,84.14251708984375,20110.061584472656,1,6,0,23,52872,3
100114,Groceries,76.92658996582031,2023-06-07,167,0,84.14251708984375,14051.800354003906,2,6,0,23,53039,3
100114,Groceries,76.92658996582031,2023-06-08,136,775,94.43140884399415,88096.4732055664,3,6,0,23,53175,3
100114,Groceries,76.92658996582031,2023-06-09,73,0,91.19281768798828,6657.0756912231445,4,6,0,23,53248,3
100114,Groceries,76.92658996582031,2023-06-10,150,0,91.19281768798828,13678.922653198242,5,6,1,23,53398,3
100114,Groceries,76.92658996582031,2023-06-11,122,0,91.19281768798828,11125.52375793457,6,6,1,23,53520,3
100114,Groceries,76.92658996582031,2023-06-12,111,0,91.19281768798828,10122.4027633667,0,6,0,24,53631,3
100114,Groceries,76.92658996582031,2023-06-13,106,0,91.19281768798828,9666.438674926758,1,6,0,24,53737,3
100114,Groceries,76.92658996582031,2023-06-14,288,825,101.75364395141602,115086.38891601562,2,6,0,24,54025,3
100114,Groceries,76.92658996582031,2023-06-15,126,0,98.33728790283203,12390.498275756836,3,6,0,24,54151,3
100114,Groceries,76.92658996582031,2023-06-16,65,0,98.33728790283203,6391.923713684082,4,6,0,24,54216,3
100114,Groceries,76.92658996582031,2023-06-17,141,0,98.33728790283203,13865.557594299316,5,6,1,24,54357,3
100114,Groceries,76.92658996582031,2023-06-18,155,0,98.33728790283203,15242.279624938965,6,6,1,24,54512,3
100114,Groceries,76.92658996582031,2023-06-19,127,0,98.33728790283203,12488.835563659668,0,6,0,25,54639,3
100114,Groceries,76.92658996582031,2023-06-20,186,0,98.33728790283203,18290.735549926758,1,6,0,25,54825,3
100114,Groceries,76.92658996582031,2023-06-21,105,0,98.33728790283203,10325.415229797363,2,6,0,25,54930,3
100114,Groceries,76.92658996582031,2023-06-22,160,411,85.04280044555665,47429.23614257813,3,6,0,25,55090,3
100114,Groceries,76.92658996582031,2023-06-23,156,0,89.54560089111328,13969.113739013672,4,6,0,25,55246,3
100114,Groceries,76.92658996582031,2023-06-24,82,0,89.54560089111328,7342.739273071289,5,6,1,25,55328,3
100114,Groceries,76.92658996582031,2023-06-25,162,739,86.94117050170898,77992.8892425537,6,6,1,25,55490,3
100114,Groceries,76.92658996582031,2023-06-26,155,0,87.53234100341797,13567.512855529785,0,6,0,26,55645,3
100114,Groceries,76.92658996582031,2023-06-27,67,0,87.53234100341797,5864.666847229004,1,6,0,26,55712,3
100114,Groceries,76.92658996582031,2023-06-28,171,0,87.53234100341797,14968.030311584473,2,6,0,26,55883,3
100114,Groceries,76.92658996582031,2023-06-29,140,594,91.59856521606446,67865.05826049804,3,6,0,26,56023,3
100114,Groceries,76.92658996582031,2023-06-30,175,0,90.2071304321289,15786.247825622559,4,6,0,26,56198,3
100114,Groceries,76.92658996582031,2023-07-01,100,0,90.2071304321289,9020.71304321289,5,7,1,26,56298,3
100114,Groceries,76.92658996582031,2023-07-02,162,0,90.2071304321289,14613.555130004883,6,7,1,26,56460,3
100114,Groceries,76.92658996582031,2023-07-03,160,0,90.2071304321289,14433.140869140625,0,7,0,27,56620,3
100114,Groceries,76.92658996582031,2023-07-04,137,396,85.21976928710937,44937.86678466797,1,7,0,27,56757,3
100114,Groceries,76.92658996582031,2023-07-05,112,0,87.08953857421875,9754.0283203125,2,7,0,27,56869,3
100114,Groceries,76.92658996582031,2023-07-06,194,688,92.0238850402832,81923.90739562988,3,7,0,27,57063,3
100114,Groceries,76.92658996582031,2023-07-07,252,0,90.4877700805664,22802.918060302734,4,7,0,27,57315,3
100114,Groceries,76.92658996582031,2023-07-08,90,0,90.4877700805664,8143.899307250977,5,7,1,27,57405,3
100114,Groceries,76.92658996582031,2023-07-09,140,0,90.4877700805664,12668.287811279297,6,7,1,27,57545,3
100114,Groceries,76.92658996582031,2023-07-10,95,0,90.4877700805664,8596.338157653809,0,7,0,28,57640,3
100114,Groceries,76.92658996582031,2023-07-11,128,0,90.4877700805664,11582.4345703125,1,7,0,28,57768,3
100114,Groceries,76.92658996582031,2023-07-12,233,765,102.46406173706055,103608.25276947021,2,7,0,28,58001,3
100114,Groceries,76.92658996582031,2023-07-13,143,0,99.9281234741211,14289.721656799316,3,7,0,28,58144,3
100114,Groceries,76.92658996582031,2023-07-14,35,0,99.9281234741211,3497.4843215942383,4,7,0,28,58179,3
100114,Groceries,76.92658996582031,2023-07-15,157,0,99.9281234741211,15688.715385437012,5,7,1,28,58336,3
100114,Groceries,76.92658996582031,2023-07-16,140,0,99.9281234741211,13989.937286376953,6,7,1,28,58476,3
100114,Groceries,76.92658996582031,2023-07-17,72,0,99.9281234741211,7194.824890136719,0,7,0,29,58548,3
100114,Groceries,76.92658996582031,2023-07-18,98,0,99.9281234741211,9792.956100463867,1,7,0,29,58646,3
100114,Groceries,76.92658996582031,2023-07-19,74,398,79.40137985229492,35665.84421813965,2,7,0,29,58720,3
100114,Groceries,76.92658996582031,2023-07-20,93,0,84.99275970458984,7904.3266525268555,3,7,0,29,58813,3
100114,Groceries,76.92658996582031,2023-07-21,131,426,76.2203289794922,41463.426192626954,4,7,0,29,58944,3
100114,Groceries,76.92658996582031,2023-07-22,108,0,79.58065795898438,8594.711059570312,5,7,1,29,59052,3
100114,Groceries,76.92658996582031,2023-07-23,72,0,79.58065795898438,5729.807373046875,6,7,1,29,59124,3
100114,Groceries,76.92658996582031,2023-07-24,83,0,79.58065795898438,6605.194610595703,0,7,0,30,59207,3
100114,Groceries,76.92658996582031,2023-07-25,121,0,79.58065795898438,9629.25961303711,1,7,0,30,59328,3
100114,Groceries,76.92658996582031,2023-07-26,233,571,79.0559407043457,63511.6483682251,2,7,0,30,59561,3
100114,Groceries,76.92658996582031,2023-07-27,77,0,79.2018814086914,6098.544868469238,3,7,0,30,59638,3
100114,Groceries,76.92658996582031,2023-07-28,130,776,79.75721343994141,72371.65549438477,4,7,0,30,59768,3
100114,Groceries,76.92658996582031,2023-07-29,146,0,79.58442687988281,11619.32632446289,5,7,1,30,59914,3
100114,Groceries,76.92658996582031,2023-07-30,91,0,79.58442687988281,7242.182846069336,6,7,1,30,60005,3
100114,Groceries,76.92658996582031,2023-07-31,191,0,79.58442687988281,15200.625534057617,0,7,0,31,60196,3
100114,Groceries,76.92658996582031,2023-08-01,133,0,79.58442687988281,10584.728775024414,1,8,0,31,60329,3
100114,Groceries,76.92658996582031,2023-08-02,133,0,79.58442687988281,10584.728775024414,2,8,0,31,60462,3
100114,Groceries,76.92658996582031,2023-08-03,79,0,79.58442687988281,6287.169723510742,3,8,0,31,60541,3
100114,Groceries,76.92658996582031,2023-08-04,181,465,91.24844131469726,60210.73575592041,4,8,0,31,60722,3
100114,Groceries,76.92658996582031,2023-08-05,115,0,86.79688262939453,9981.641502380371,5,8,1,31,60837,3
100114,Groceries,76.92658996582031,2023-08-06,169,871,84.54369216918946,87452.50795318604,6,8,1,31,61006,3
100114,Groceries,76.92658996582031,2023-08-07,115,0,85.2173843383789,9799.999198913574,0,8,0,32,61121,3
100114,Groceries,76.92658996582031,2023-08-08,215,0,85.2173843383789,18321.737632751465,1,8,0,32,61336,3
100114,Groceries,76.92658996582031,2023-08-09,13,0,85.2173843383789,1107.8259963989258,2,8,0,32,61349,3
100114,Groceries,76.92658996582031,2023-08-10,95,0,85.2173843383789,8095.651512145996,3,8,0,32,61444,3
100114,Groceries,76.92658996582031,2023-08-11,235,0,85.2173843383789,20026.085319519043,4,8,0,32,61679,3
100114,Groceries,76.92658996582031,2023-08-12,109,0,85.2173843383789,9288.6948928833,5,8,1,32,61788,3
100114,Groceries,76.92658996582031,2023-08-13,111,0,85.2173843383789,9459.129661560059,6,8,1,32,61899,3
100114,Groceries,76.92658996582031,2023-08-14,163,483,89.01063568115234,57942.26723205567,0,8,0,33,62062,3
100114,Groceries,76.92658996582031,2023-08-15,121,0,87.63127136230469,10603.383834838867,1,8,0,33,62183,3
100114,Groceries,76.92658996582031,2023-08-16,205,640,84.7393426513672,71139.58048706055,2,8,0,33,62388,3
100114,Groceries,76.92658996582031,2023-08-17,218,0,85.80868530273438,18706.293395996094,3,8,0,33,62606,3
100114,Groceries,76.92658996582031,2023-08-18,113,0,85.80868530273438,9696.381439208984,4,8,0,33,62719,3
100114,Groceries,76.92658996582031,2023-08-19,134,0,85.80868530273438,11498.363830566406,5,8,1,33,62853,3
100114,Groceries,76.92658996582031,2023-08-20,123,0,85.80868530273438,10554.468292236328,6,8,1,33,62976,3
100114,Groceries,76.92658996582031,2023-08-21,136,0,85.80868530273438,11669.981201171875,0,8,0,34,63112,3
100114,Groceries,76.92658996582031,2023-08-22,77,0,85.80868530273438,6607.268768310547,1,8,0,34,63189,3
100114,Groceries,76.92658996582031,2023-08-23,148,550,87.54884719848633,61290.45877075195,2,8,0,34,63337,3
100114,Groceries,76.92658996582031,2023-08-24,111,0,87.09769439697266,9667.844078063965,3,8,0,34,63448,3
100114,Groceries,76.92658996582031,2023-08-25,116,0,87.09769439697266,10103.332550048828,4,8,0,34,63564,3
100114,Groceries,76.92658996582031,2023-08-26,43,0,87.09769439697266,3745.200859069824,5,8,1,34,63607,3
100114,Groceries,76.92658996582031,2023-08-27,121,0,87.09769439697266,10538.821022033691,6,8,1,34,63728,3
100114,Groceries,76.92658996582031,2023-08-28,47,0,87.09769439697266,4093.591636657715,0,8,0,35,63775,3
100114,Groceries,76.92658996582031,2023-08-29,106,330,83.38438491821289,36067.88960266113,1,8,0,35,63881,3
100114,Groceries,76.92658996582031,2023-08-30,120,0,84.66876983642578,10160.252380371094,2,8,0,35,64001,3
100114,Groceries,76.92658996582031,2023-08-31,123,424,77.62321563720704,41721.48104675293,3,8,0,35,64124,3
100114,Groceries,76.92658996582031,2023-09-01,91,0,80.07643127441406,7286.95524597168,4,9,0,35,64215,3
100114,Groceries,76.92658996582031,2023-09-02,120,0,80.07643127441406,9609.171752929688,5,9,1,35,64335,3
100114,Groceries,76.92658996582031,2023-09-03,99,0,80.07643127441406,7927.566696166992,6,9,1,35,64434,3
100114,Groceries,76.92658996582031,2023-09-04,152,598,83.95889556884765,63437.96425292969,0,9,0,36,64586,3
100114,Groceries,76.92658996582031,2023-09-05,144,0,82.90779113769531,11938.721923828125,1,9,0,36,64730,3
100114,Groceries,76.92658996582031,2023-09-06,13,0,82.90779113769531,1077.801284790039,2,9,0,36,64743,3
100114,Groceries,76.92658996582031,2023-09-07,89,0,82.90779113769531,7378.793411254883,3,9,0,36,64832,3
100114,Groceries,76.92658996582031,2023-09-08,119,0,82.90779113769531,9866.027145385742,4,9,0,36,64951,3
100114,Groceries,76.92658996582031,2023-09-09,69,0,82.90779113769531,5720.637588500977,5,9,1,36,65020,3
100114,Groceries,76.92658996582031,2023-09-10,45,0,82.90779113769531,3730.850601196289,6,9,1,36,65065,3
100114,Groceries,76.92658996582031,2023-09-11,336,757,86.63435348510743,95026.3155419922,0,9,0,37,65401,3
100114,Groceries,76.92658996582031,2023-09-12,75,0,85.83870697021484,6437.903022766113,1,9,0,37,65476,3
100114,Groceries,76.92658996582031,2023-09-14,83,0,85.83870697021484,7124.612678527832,3,9,0,37,65559,3
100114,Groceries,76.92658996582031,2023-09-15,162,0,85.83870697021484,13905.870529174805,4,9,0,37,65721,3
100114,Groceries,76.92658996582031,2023-09-16,33,0,85.83870697021484,2832.67733001709,5,9,1,37,65754,3
100114,Groceries,76.92658996582031,2023-09-17,85,0,85.83870697021484,7296.290092468262,6,9,1,37,65839,3
100114,Groceries,76.92658996582031,2023-09-18,107,302,64.92608352661134,24944.831874694824,0,9,0,38,65946,3
100114,Groceries,76.92658996582031,2023-09-19,32,0,73.18216705322266,2341.829345703125,1,9,0,38,65978,3
100114,Groceries,76.92658996582031,2023-09-20,122,0,73.18216705322266,8928.224380493164,2,9,0,38,66100,3
100114,Groceries,76.92658996582031,2023-09-21,53,0,73.18216705322266,3878.654853820801,3,9,0,38,66153,3
100114,Groceries,76.92658996582031,2023-09-22,147,430,75.29129669189453,43626.66122741699,4,9,0,38,66300,3
100114,Groceries,76.92658996582031,2023-09-23,81,0,74.64259338378906,6046.050064086914,5,9,1,38,66381,3
100114,Groceries,76.92658996582031,2023-09-24,109,0,74.64259338378906,8136.042678833008,6,9,1,38,66490,3
100114,Groceries,76.92658996582031,2023-09-25,40,0,74.64259338378906,2985.7037353515625,0,9,0,39,66530,3
100114,Groceries,76.92658996582031,2023-09-26,79,0,74.64259338378906,5896.764877319336,1,9,0,39,66609,3
100114,Groceries,76.92658996582031,2023-09-27,114,423,68.05196838378906,35940.74879150391,2,9,0,39,66723,3
100114,Groceries,76.92658996582031,2023-09-28,118,0,70.00393676757812,8260.464538574219,3,9,0,39,66841,3
100114,Groceries,76.92658996582031,2023-09-29,61,0,70.00393676757812,4270.240142822266,4,9,0,39,66902,3
100114,Groceries,76.92658996582031,2023-09-30,133,493,74.45907577514649,47140.91415618897,5,9,1,39,67035,3
100114,Groceries,76.92658996582031,2023-10-01,55,0,72.98815155029297,4014.3483352661133,6,10,1,39,67090,3
100114,Groceries,76.92658996582031,2023-10-02,115,0,72.98815155029297,8393.637428283691,0,10,0,40,67205,3
100114,Groceries,76.92658996582031,2023-10-03,90,0,72.98815155029297,6568.933639526367,1,10,0,40,67295,3
100114,Groceries,76.92658996582031,2023-10-04,96,0,72.98815155029297,7006.862548828125,2,10,0,40,67391,3
100114,Groceries,76.92658996582031,2023-10-05,30,0,72.98815155029297,2189.644546508789,3,10,0,40,67421,3
100114,Groceries,76.92658996582031,2023-10-06,38,0,72.98815155029297,2773.549758911133,4,10,0,40,67459,3
100114,Groceries,76.92658996582031,2023-10-07,52,0,72.98815155029297,3795.3838806152344,5,10,1,40,67511,3
100114,Groceries,76.92658996582031,2023-10-08,91,0,72.98815155029297,6641.92179107666,6,10,1,40,67602,3
100114,Groceries,76.92658996582031,2023-10-09,222,532,74.70362213134766,56437.00822631836,0,10,0,41,67824,3
100114,Groceries,76.92658996582031,2023-10-10,31,0,74.34724426269531,2304.7645721435547,1,10,0,41,67855,3
100114,Groceries,76.92658996582031,2023-10-11,26,0,74.34724426269531,1933.0283508300781,2,10,0,41,67881,3
100114,Groceries,76.92658996582031,2023-10-12,53,0,74.34724426269531,3940.4039459228516,3,10,0,41,67934,3
100114,Groceries,76.92658996582031,2023-10-13,54,0,74.34724426269531,4014.751190185547,4,10,0,41,67988,3
100114,Groceries,76.92658996582031,2023-10-14,43,0,74.34724426269531,3196.9315032958984,5,10,1,41,68031,3
100114,Groceries,76.92658996582031,2023-10-15,106,324,60.63537445068359,24964.599383544923,6,10,1,41,68137,3
100114,Groceries,76.92658996582031,2023-10-16,36,0,65.72074890136719,2365.9469604492188,0,10,0,42,68173,3
100114,Groceries,76.92658996582031,2023-10-17,72,0,65.72074890136719,4731.8939208984375,1,10,0,42,68245,3
100114,Groceries,76.92658996582031,2023-10-18,118,0,65.72074890136719,7755.048370361328,2,10,0,42,68363,3
100114,Groceries,76.92658996582031,2023-10-19,146,399,65.3638801574707,35594.503005981445,3,10,0,42,68509,3
100114,Groceries,76.92658996582031,2023-10-20,68,0,65.4777603149414,4452.487701416016,4,10,0,42,68577,3
100114,Groceries,76.92658996582031,2023-10-21,79,0,65.4777603149414,5172.743064880371,5,10,1,42,68656,3
100114,Groceries,76.92658996582031,2023-10-22,45,0,65.4777603149414,2946.4992141723633,6,10,1,42,68701,3
100114,Groceries,76.92658996582031,2023-10-23,52,0,65.4777603149414,3404.843536376953,0,10,0,43,68753,3
100114,Groceries,76.92658996582031,2023-10-24,26,0,65.4777603149414,1702.4217681884766,1,10,0,43,68779,3
100114,Groceries,76.92658996582031,2023-10-25,78,0,65.4777603149414,5107.26530456543,2,10,0,43,68857,3
100114,Groceries,76.92658996582031,2023-10-26,119,427,73.52770889282226,40756.6747164917,3,10,0,43,68976,3
100114,Groceries,76.92658996582031,2023-10-27,14,0,71.54541778564453,1001.6358489990234,4,10,0,43,68990,3
100114,Groceries,76.92658996582031,2023-10-28,146,452,77.68007019042969,47180.94049560547,5,10,1,43,69136,3
100114,Groceries,76.92658996582031,2023-10-29,71,0,75.30014038085938,5346.309967041016,6,10,1,43,69207,3
100114,Groceries,76.92658996582031,2023-10-30,134,0,75.30014038085938,10090.218811035156,0,10,0,44,69341,3
100114,Groceries,76.92658996582031,2023-10-31,128,0,75.30014038085938,9638.41796875,1,10,0,44,69469,3
100114,Groceries,76.92658996582031,2023-11-01,113,0,75.30014038085938,8508.91586303711,2,11,0,44,69582,3
100114,Groceries,76.92658996582031,2023-11-02,215,618,79.72263961791992,66871.34503570557,3,11,0,44,69797,3
100114,Groceries,76.92658996582031,2023-11-03,81,0,78.57527923583984,6364.597618103027,4,11,0,44,69878,3
100114,Groceries,76.92658996582031,2023-11-04,54,0,78.57527923583984,4243.065078735352,5,11,1,44,69932,3
100114,Groceries,76.92658996582031,2023-11-05,94,0,78.57527923583984,7386.076248168945,6,11,1,44,70026,3
100114,Groceries,76.92658996582031,2023-11-06,94,0,78.57527923583984,7386.076248168945,0,11,0,45,70120,3
100114,Groceries,76.92658996582031,2023-11-07,76,0,78.57527923583984,5971.721221923828,1,11,0,45,70196,3
100114,Groceries,76.92658996582031,2023-11-08,75,0,78.57527923583984,5893.145942687988,2,11,0,45,70271,3
100114,Groceries,76.92658996582031,2023-11-09,70,0,78.57527923583984,5500.269546508789,3,11,0,45,70341,3
100114,Groceries,76.92658996582031,2023-11-10,121,348,67.34042526245116,30828.922913513183,4,11,0,45,70462,3
100114,Groceries,76.92658996582031,2023-11-11,148,594,75.1079067993164,56333.100412597654,5,11,1,45,70610,3
100114,Groceries,76.92658996582031,2023-11-12,23,0,73.75581359863281,1696.3837127685547,6,11,1,45,70633,3
100114,Groceries,76.92658996582031,2023-11-13,126,0,73.75581359863281,9293.232513427734,0,11,0,46,70759,3
100114,Groceries,76.92658996582031,2023-11-14,116,0,73.75581359863281,8555.674377441406,1,11,0,46,70875,3
100114,Groceries,76.92658996582031,2023-11-15,126,0,73.75581359863281,9293.232513427734,2,11,0,46,71001,3
100114,Groceries,76.92658996582031,2023-11-16,79,0,73.75581359863281,5826.709274291992,3,11,0,46,71080,3
100114,Groceries,76.92658996582031,2023-11-17,65,0,73.75581359863281,4794.127883911133,4,11,0,46,71145,3
100114,Groceries,76.92658996582031,2023-11-18,151,364,79.60720504760742,41460.51592437744,5,11,1,46,71296,3
100114,Groceries,76.92658996582031,2023-11-19,124,0,77.43441009521484,9601.86685180664,6,11,1,46,71420,3
100114,Groceries,76.92658996582031,2023-11-20,129,0,77.43441009521484,9989.038902282715,0,11,0,47,71549,3
100114,Groceries,76.92658996582031,2023-11-21,80,0,77.43441009521484,6194.7528076171875,1,11,0,47,71629,3
100114,Groceries,76.92658996582031,2023-11-22,71,0,77.43441009521484,5497.843116760254,2,11,0,47,71700,3
100114,Groceries,76.92658996582031,2023-11-23,88,454,82.91748931884766,45359.438120117185,3,11,0,47,71788,3
100114,Groceries,76.92658996582031,2023-11-24,132,0,81.77497863769531,10794.297180175781,4,11,0,47,71920,3
100114,Groceries,76.92658996582031,2023-11-25,19,610,85.9684146118164,54766.539755249025,5,11,1,47,71939,3
100114,Groceries,76.92658996582031,2023-11-26,116,0,84.79682922363281,9836.432189941406,6,11,1,47,72055,3
100114,Groceries,76.92658996582031,2023-11-27,182,0,84.79682922363281,15433.022918701172,0,11,0,48,72237,3
100114,Groceries,76.92658996582031,2023-11-28,69,0,84.79682922363281,5850.981216430664,1,11,0,48,72306,3
100114,Groceries,76.92658996582031,2023-11-29,65,0,84.79682922363281,5511.793899536133,2,11,0,48,72371,3
100114,Groceries,76.92658996582031,2023-11-30,123,0,84.79682922363281,10430.009994506836,3,11,0,48,72494,3
100114,Groceries,76.92658996582031,2023-12-01,91,0,84.79682922363281,7716.511459350586,4,12,0,48,72585,3
100114,Groceries,76.92658996582031,2023-12-02,87,0,84.79682922363281,7377.324142456055,5,12,1,48,72672,3
100114,Groceries,76.92658996582031,2023-12-03,128,364,66.83433853149414,31557.510664062498,6,12,1,48,72800,3
100114,Groceries,76.92658996582031,2023-12-04,4,0,72.44867706298828,289.7947082519531,0,12,0,49,72804,3
100114,Groceries,76.92658996582031,2023-12-05,53,0,72.44867706298828,3839.779884338379,1,12,0,49,72857,3
100114,Groceries,76.92658996582031,2023-12-06,64,0,72.44867706298828,4636.71533203125,2,12,0,49,72921,3
100114,Groceries,76.92658996582031,2023-12-07,62,0,72.44867706298828,4491.817977905273,3,12,0,49,72983,3
100114,Groceries,76.92658996582031,2023-12-08,122,475,80.66490615844727,48991.82710266113,4,12,0,49,73105,3
100114,Groceries,76.92658996582031,2023-12-09,91,0,78.29981231689453,7125.282920837402,5,12,1,49,73196,3
100114,Groceries,76.92658996582031,2023-12-10,171,616,84.2747297668457,67238.80758026123,6,12,1,49,73367,3
100114,Groceries,76.92658996582031,2023-12-11,58,0,82.2194595336914,4768.728652954102,0,12,0,50,73425,3
100114,Groceries,76.92658996582031,2023-12-12,77,0,82.2194595336914,6330.898384094238,1,12,0,50,73502,3
100114,Groceries,76.92658996582031,2023-12-13,150,0,82.2194595336914,12332.918930053711,2,12,0,50,73652,3
100114,Groceries,76.92658996582031,2023-12-14,213,0,82.2194595336914,17512.74488067627,3,12,0,50,73865,3
100114,Groceries,76.92658996582031,2023-12-15,71,0,82.2194595336914,5837.58162689209,4,12,0,50,73936,3
100114,Groceries,76.92658996582031,2023-12-16,97,0,82.2194595336914,7975.287574768066,5,12,1,50,74033,3
100114,Groceries,76.92658996582031,2023-12-17,89,0,82.2194595336914,7317.531898498535,6,12,1,50,74122,3
100114,Groceries,76.92658996582031,2023-12-18,134,395,78.13023193359375,41012.41215820312,0,12,0,51,74256,3
100114,Groceries,76.92658996582031,2023-12-19,105,0,79.3504638671875,8331.798706054688,1,12,0,51,74361,3
100114,Groceries,76.92658996582031,2023-12-20,97,0,79.3504638671875,7696.9949951171875,2,12,0,51,74458,3
100114,Groceries,76.92658996582031,2023-12-21,130,559,77.98617691040039,53579.6759967041,3,12,0,51,74588,3
100114,Groceries,76.92658996582031,2023-12-22,51,0,78.34235382080078,3995.46004486084,4,12,0,51,74639,3
100114,Groceries,76.92658996582031,2023-12-23,98,0,78.34235382080078,7677.550674438477,5,12,1,51,74737,3
100114,Groceries,76.92658996582031,2023-12-24,142,0,78.34235382080078,11124.614242553711,6,12,1,51,74879,3
100114,Groceries,76.92658996582031,2023-12-25,81,0,78.34235382080078,6345.730659484863,0,12,0,52,74960,3
100114,Groceries,76.92658996582031,2023-12-26,84,0,78.34235382080078,6580.757720947266,1,12,0,52,75044,3
100114,Groceries,76.92658996582031,2023-12-27,51,0,78.34235382080078,3995.46004486084,2,12,0,52,75095,3
100114,Groceries,76.92658996582031,2023-12-28,69,0,78.34235382080078,5405.622413635254,3,12,0,52,75164,3
100114,Groceries,76.92658996582031,2023-12-29,150,334,79.47369827270508,38521.62948181153,4,12,0,52,75314,3
100114,Groceries,76.92658996582031,2023-12-30,63,0,79.16739654541016,4987.54598236084,5,12,1,52,75377,3
100114,Groceries,76.92658996582031,2023-12-31,35,0,79.16739654541016,2770.8588790893555,6,12,1,52,75412,3
100114,Groceries,76.92658996582031,2024-01-01,44,0,79.16739654541016,3483.365447998047,0,1,0,1,75456,3
100114,Groceries,76.92658996582031,2024-01-02,64,377,78.47291244506836,34546.17279296875,1,1,0,1,75520,3
100114,Groceries,76.92658996582031,2024-01-03,53,0,78.66582489013672,4169.288719177246,2,1,0,1,75573,3
100114,Groceries,76.92658996582031,2024-01-04,44,0,78.66582489013672,3461.2962951660156,3,1,0,1,75617,3
100114,Groceries,76.92658996582031,2024-01-05,85,0,78.66582489013672,6686.595115661621,4,1,0,1,75702,3
100114,Groceries,76.92658996582031,2024-01-06,76,0,78.66582489013672,5978.602691650391,5,1,1,1,75778,3
100114,Groceries,76.92658996582031,2024-01-07,98,336,73.5092724609375,31486.69740234375,6,1,1,1,75876,3
100114,Groceries,76.92658996582031,2024-01-08,71,0,75.258544921875,5343.356689453125,0,1,0,2,75947,3
100114,Groceries,76.92658996582031,2024-01-09,97,0,75.258544921875,7300.078857421875,1,1,0,2,76044,3
100114,Groceries,76.92658996582031,2024-01-10,128,325,73.94993087768555,33398.8623046875,2,1,0,2,76172,3
100114,Groceries,76.92658996582031,2024-01-11,47,0,74.4598617553711,3499.6135025024414,3,1,0,2,76219,3
100114,Groceries,76.92658996582031,2024-01-12,155,426,79.40730804443359,46670.24549377441,4,1,0,2,76374,3
100114,Groceries,76.92658996582031,2024-01-13,97,0,77.43461608886719,7511.157760620117,5,1,1,2,76471,3
100114,Groceries,76.92658996582031,2024-01-14,89,0,77.43461608886719,6891.68083190918,6,1,1,2,76560,3
100114,Groceries,76.92658996582031,2024-01-15,117,0,77.43461608886719,9059.850082397461,0,1,0,3,76677,3
100114,Groceries,76.92658996582031,2024-01-16,81,0,77.43461608886719,6272.203903198242,1,1,0,3,76758,3
100114,Groceries,76.92658996582031,2024-01-17,54,0,77.43461608886719,4181.469268798828,2,1,0,3,76812,3
100114,Groceries,76.92658996582031,2024-01-18,111,592,72.22950454711915,50147.47000946045,3,1,0,3,76923,3
100114,Groceries,76.92658996582031,2024-01-19,68,0,73.53900909423828,5000.652618408203,4,1,0,3,76991,3
100114,Groceries,76.92658996582031,2024-01-20,199,0,73.53900909423828,14634.262809753418,5,1,1,3,77190,3
100114,Groceries,76.92658996582031,2024-01-21,88,0,73.53900909423828,6471.432800292969,6,1,1,3,77278,3
100114,Groceries,76.92658996582031,2024-01-22,162,515,82.91011444091797,57245.58707885742,0,1,0,4,77440,3
100114,Groceries,76.92658996582031,2024-01-23,72,0,79.75022888183594,5742.0164794921875,1,1,0,4,77512,3
100114,Groceries,76.92658996582031,2024-01-24,112,0,79.75022888183594,8932.025634765625,2,1,0,4,77624,3
100114,Groceries,76.92658996582031,2024-01-25,57,0,79.75022888183594,4545.763046264648,3,1,0,4,77681,3
100114,Groceries,76.92658996582031,2024-01-26,118,0,79.75022888183594,9410.52700805664,4,1,0,4,77799,3
100114,Groceries,76.92658996582031,2024-01-27,176,459,75.33329498291016,47385.73983398437,5,1,1,4,77975,3
100114,Groceries,76.92658996582031,2024-01-28,55,0,76.92658996582031,4230.962448120117,6,1,1,4,78030,3
100114,Groceries,76.92658996582031,2024-01-29,86,0,76.92658996582031,6615.686737060547,0,1,0,5,78116,3
100114,Groceries,76.92658996582031,2024-01-30,73,0,76.92658996582031,5615.641067504883,1,1,0,5,78189,3
100115,Toys,14.766850471496582,2022-01-01,55,193,14.390000171661377,3568.7200188827514,5,1,1,52,55,4
100115,Toys,14.766850471496582,2022-01-02,117,109,14.95210548400879,3377.4326832580564,6,1,1,52,172,4
100115,Toys,14.766850471496582,2022-01-03,92,80,15.905113067626953,2729.3808044433595,0,1,0,1,264,4
100115,Toys,14.766850471496582,2022-01-04,81,74,15.123767261505126,2344.9802963638303,1,1,0,1,345,4
100115,Toys,14.766850471496582,2022-01-05,40,0,15.237534523010254,609.5013809204102,2,1,0,1,385,4
100115,Toys,14.766850471496582,2022-01-06,71,91,16.32486099243164,2650.730260925293,3,1,0,1,456,4
100115,Toys,14.766850471496582,2022-01-07,91,95,16.186115379333494,3010.8329990386965,4,1,0,1,547,4
100115,Toys,14.766850471496582,2022-01-08,95,137,16.329271736145017,3790.5216298675537,5,1,1,1,642,4
100115,Toys,14.766850471496582,2022-01-09,65,104,16.129274520874024,2723.535687713623,6,1,1,1,707,4
100115,Toys,14.766850471496582,2022-01-10,74,109,15.657306632995606,2856.9813816833494,0,1,0,2,781,4
100115,Toys,14.766850471496582,2022-01-11,100,0,15.894613265991211,1589.461326599121,1,1,0,2,881,4
100115,Toys,14.766850471496582,2022-01-12,84,85,13.19600051879883,2229.0580871582033,2,1,0,2,965,4
100115,Toys,14.766850471496582,2022-01-13,105,113,13.186409034729003,2871.785897293091,3,1,0,2,1070,4
100115,Toys,14.766850471496582,2022-01-14,68,79,15.13341251373291,2232.1641018676755,4,1,0,2,1138,4
100115,Toys,14.766850471496582,2022-01-15,112,154,17.090972366333006,4579.337810058594,5,1,1,2,1250,4
100115,Toys,14.766850471496582,2022-01-16,112,121,15.305418796539307,3562.4238104248047,6,1,1,2,1362,4
100115,Toys,14.766850471496582,2022-01-17,182,191,17.799292907714843,6645.172618408204,0,1,0,3,1544,4
100115,Toys,14.766850471496582,2022-01-18,78,0,17.128585815429688,1336.0296936035156,1,1,0,3,1622,4
100115,Toys,14.766850471496582,2022-01-19,57,105,16.81107864379883,2718.0629653930664,2,1,0,3,1679,4
100115,Toys,14.766850471496582,2022-01-20,68,0,16.922157287597656,1150.7066955566406,3,1,0,3,1747,4
100115,Toys,14.766850471496582,2022-01-21,93,103,16.874746017456054,3307.302759246826,4,1,0,3,1840,4
100115,Toys,14.766850471496582,2022-01-22,103,128,15.125968990325926,3481.449612007141,5,1,1,3,1943,4
100115,Toys,14.766850471496582,2022-01-23,59,99,14.79041431427002,2323.6688890838623,6,1,1,3,2002,4
100115,Toys,14.766850471496582,2022-01-24,103,95,15.059009685516358,2981.9159952163695,0,1,0,4,2105,4
100115,Toys,14.766850471496582,2022-01-25,42,0,15.088019371032715,633.696813583374,1,1,0,4,2147,4
100115,Toys,14.766850471496582,2022-01-26,57,62,15.069184093475343,1793.186986656189,2,1,0,4,2204,4
100115,Toys,14.766850471496582,2022-01-27,75,112,15.515168628692628,2907.065294303894,3,1,0,4,2279,4
100115,Toys,14.766850471496582,2022-01-28,82,0,15.360337257385254,1259.5476551055908,4,1,0,4,2361,4
100115,Toys,14.766850471496582,2022-01-29,78,126,17.066682205200195,3500.9624240112303,5,1,1,4,2439,4
100115,Toys,14.766850471496582,2022-01-30,112,87,15.675079231262206,3129.7177478027343,6,1,1,4,2551,4
100115,Toys,14.766850471496582,2022-01-31,92,86,16.184935913085937,2880.7082080078126,0,1,0,5,2643,4
100115,Toys,14.766850471496582,2022-02-01,65,63,14.184739990234375,1817.3361987304688,1,2,0,5,2708,4
100115,Toys,14.766850471496582,2022-02-02,93,137,17.790372962951658,4122.569371109008,2,2,0,5,2801,4
100115,Toys,14.766850471496582,2022-02-03,72,101,14.896685485839843,2551.4127099609377,3,2,0,5,2873,4
100115,Toys,14.766850471496582,2022-02-04,84,0,15.783370971679688,1325.8031616210938,4,2,0,5,2957,4
100115,Toys,14.766850471496582,2022-02-05,67,75,14.199734039306641,2011.8843612670898,5,2,1,5,3024,4
100115,Toys,14.766850471496582,2022-02-06,90,102,15.456593952178956,2970.226911392212,6,2,1,5,3114,4
100115,Toys,14.766850471496582,2022-02-07,88,121,13.019384078979492,2699.2915979003906,0,2,0,6,3202,4
100115,Toys,14.766850471496582,2022-02-08,97,92,12.442981681823731,2354.338446273804,1,2,0,6,3299,4
100115,Toys,14.766850471496582,2022-02-09,61,79,13.685299758911132,1921.7865705871582,2,2,0,6,3360,4
100115,Toys,14.766850471496582,2022-02-10,44,0,13.360599517822266,587.8663787841797,3,2,0,6,3404,4
100115,Toys,14.766850471496582,2022-02-11,104,200,17.985628814697264,5559.250793457031,4,2,0,6,3508,4
100115,Toys,14.766850471496582,2022-02-12,56,0,17.03125762939453,953.7504272460938,5,2,1,6,3564,4
100115,Toys,14.766850471496582,2022-02-13,75,74,14.425185985565186,2150.637897834778,6,2,1,6,3639,4
100115,Toys,14.766850471496582,2022-02-14,143,209,16.522888412475588,5829.726085968017,0,2,0,7,3782,4
100115,Toys,14.766850471496582,2022-02-15,41,0,16.315776824951172,668.946849822998,1,2,0,7,3823,4
100115,Toys,14.766850471496582,2022-02-16,99,153,15.802072582244872,3972.2903712844845,2,2,0,7,3922,4
100115,Toys,14.766850471496582,2022-02-17,83,0,15.984145164489746,1326.684048652649,3,2,0,7,4005,4
100115,Toys,14.766850471496582,2022-02-18,134,96,15.615013103485108,3597.3435117340086,4,2,0,7,4139,4
100115,Toys,14.766850471496582,2022-02-19,101,132,16.561099662780762,3865.522131881714,5,2,1,7,4240,4
100115,Toys,14.766850471496582,2022-02-20,132,135,16.137285385131836,4308.4533416748045,6,2,1,7,4372,4
100115,Toys,14.766850471496582,2022-02-21,29,0,16.204570770263672,469.9325523376465,0,2,0,8,4401,4
100115,Toys,14.766850471496582,2022-02-22,106,155,17.69119659423828,4635.963677978516,1,2,0,8,4507,4
100115,Toys,14.766850471496582,2022-02-23,77,0,17.312393188476562,1333.0542755126953,2,2,0,8,4584,4
100115,Toys,14.766850471496582,2022-02-24,78,173,16.178578720092773,4041.0082803344726,3,2,0,8,4662,4
100115,Toys,14.766850471496582,2022-02-25,64,0,16.387157440185547,1048.778076171875,4,2,0,8,4726,4
100115,Toys,14.766850471496582,2022-02-26,58,61,15.73005958557129,1870.9469119262694,5,2,1,8,4784,4
100115,Toys,14.766850471496582,2022-02-27,62,92,14.770424861907959,2260.2326828765868,6,2,1,8,4846,4
100115,Toys,14.766850471496582,2022-02-28,73,92,15.682138023376464,2591.122151412964,0,2,0,9,4919,4
100115,Toys,14.766850471496582,2022-03-01,101,142,15.63065752029419,3800.272819099426,1,3,0,9,5020,4
100115,Toys,14.766850471496582,2022-03-02,121,0,15.581315040588379,1885.3391199111938,2,3,0,9,5141,4
100115,Toys,14.766850471496582,2022-03-03,81,172,21.24967674255371,5474.477632293701,3,3,0,9,5222,4
100115,Toys,14.766850471496582,2022-03-04,82,0,20.169353485107422,1653.8869857788086,4,3,0,9,5304,4
100115,Toys,14.766850471496582,2022-03-05,90,135,18.53787082672119,4152.666748809814,5,3,1,9,5394,4
100115,Toys,14.766850471496582,2022-03-06,135,181,18.508711166381836,5843.292014923096,6,3,1,9,5529,4
100115,Toys,14.766850471496582,2022-03-07,135,144,16.71720527648926,4657.4654246520995,0,3,0,10,5664,4
100115,Toys,14.766850471496582,2022-03-08,104,0,17.454410552978516,1815.2586975097656,1,3,0,10,5768,4
100115,Toys,14.766850471496582,2022-03-09,70,106,16.907758712768555,2970.0862197875977,2,3,0,10,5838,4
100115,Toys,14.766850471496582,2022-03-10,84,131,14.716349945068359,3128.9367907714845,3,3,0,10,5922,4
100115,Toys,14.766850471496582,2022-03-11,99,128,16.612704429626465,3784.34547706604,4,3,0,10,6021,4
100115,Toys,14.766850471496582,2022-03-12,172,159,15.558894672393798,5152.969767303466,5,3,1,10,6193,4
100115,Toys,14.766850471496582,2022-03-13,158,164,17.00944290161133,5479.683956909179,6,3,1,10,6351,4
100115,Toys,14.766850471496582,2022-03-14,180,142,18.81630168914795,6024.5086080932615,0,3,0,11,6531,4
100115,Toys,14.766850471496582,2022-03-15,88,80,15.109974975585938,2549.435595703125,1,3,0,11,6619,4
100115,Toys,14.766850471496582,2022-03-16,145,200,16.235134086608888,5597.538885116577,2,3,0,11,6764,4
100115,Toys,14.766850471496582,2022-03-17,138,227,17.05055488586426,6243.873148498536,3,3,0,11,6902,4
100115,Toys,14.766850471496582,2022-03-18,80,0,16.821109771728516,1345.6887817382812,4,3,0,11,6982,4
100115,Toys,14.766850471496582,2022-03-19,83,0,16.821109771728516,1396.1521110534668,5,3,1,11,7065,4
100115,Toys,14.766850471496582,2022-03-20,91,141,17.355093727111814,4034.6270583343507,6,3,1,11,7156,4
100115,Toys,14.766850471496582,2022-03-21,123,133,17.297334594726564,4428.544310302734,0,3,0,12,7279,4
100115,Toys,14.766850471496582,2022-03-22,82,123,15.014511966705323,3038.429962539673,1,3,0,12,7361,4
100115,Toys,14.766850471496582,2022-03-23,158,0,15.979023933410645,2524.685781478882,2,3,0,12,7519,4
100115,Toys,14.766850471496582,2022-03-24,69,175,18.615784072875975,4588.278202056885,3,3,0,12,7588,4
100115,Toys,14.766850471496582,2022-03-25,106,0,18.181568145751953,1927.246223449707,4,3,0,12,7694,4
100115,Toys,14.766850471496582,2022-03-26,69,142,18.790896492004393,3973.5737158966062,5,3,1,12,7763,4
100115,Toys,14.766850471496582,2022-03-27,137,122,18.24646656036377,4728.181837539672,6,3,1,12,7900,4
100115,Toys,14.766850471496582,2022-03-28,112,106,16.909490394592286,3689.6258483886722,0,3,0,13,8012,4
100115,Toys,14.766850471496582,2022-03-29,81,125,17.67334663391113,3643.6421546936035,1,3,0,13,8093,4
100115,Toys,14.766850471496582,2022-03-30,138,180,17.45703514099121,5549.361698913574,2,3,0,13,8231,4
100115,Toys,14.766850471496582,2022-03-31,116,0,17.504070281982422,2030.472152709961,3,3,0,13,8347,4
100115,Toys,14.766850471496582,2022-04-01,91,186,18.762636070251467,5220.749764785767,4,4,0,13,8438,4
100115,Toys,14.766850471496582,2022-04-02,127,136,17.33096389770508,4553.71483001709,5,4,1,13,8565,4
100115,Toys,14.766850471496582,2022-04-03,195,144,18.893385925292968,6382.590510864257,6,4,1,13,8760,4
100115,Toys,14.766850471496582,2022-04-04,73,0,18.456771850585938,1347.3443450927734,0,4,0,14,8833,4
100115,Toys,14.766850471496582,2022-04-05,71,119,16.141896896362304,3041.4293592834474,1,4,0,14,8904,4
100115,Toys,14.766850471496582,2022-04-06,119,140,16.563033714294434,4289.132024002076,2,4,0,14,9023,4
100115,Toys,14.766850471496582,2022-04-07,95,117,15.798540115356445,3342.7226219177246,3,4,0,14,9118,4
100115,Toys,14.766850471496582,2022-04-08,41,0,16.09708023071289,659.9802894592285,4,4,0,14,9159,4
100115,Toys,14.766850471496582,2022-04-09,121,100,16.484110298156736,3639.9246921539307,5,4,1,14,9280,4
100115,Toys,14.766850471496582,2022-04-10,100,158,17.178104820251463,4443.660964050293,6,4,1,14,9380,4
100115,Toys,14.766850471496582,2022-04-11,154,168,19.327854194641112,6234.0990919494625,0,4,0,15,9534,4
100115,Toys,14.766850471496582,2022-04-12,79,106,16.928024978637694,3111.757946624756,1,4,0,15,9613,4
100115,Toys,14.766850471496582,2022-04-13,69,0,17.66604995727539,1218.957447052002,2,4,0,15,9682,4
100115,Toys,14.766850471496582,2022-04-14,107,146,17.959576988220213,4547.299475479126,3,4,0,15,9789,4
100115,Toys,14.766850471496582,2022-04-15,91,0,17.86915397644043,1626.093011856079,4,4,0,15,9880,4
100115,Toys,14.766850471496582,2022-04-16,78,86,16.192969284057618,2651.463208312988,5,4,1,15,9958,4
100115,Toys,14.766850471496582,2022-04-17,86,139,16.395668182373047,3685.014927368164,6,4,1,15,10044,4
100115,Toys,14.766850471496582,2022-04-18,139,171,17.734864044189454,5509.492204284668,0,4,0,16,10183,4
100115,Toys,14.766850471496582,2022-04-19,140,148,15.466791877746582,4448.861725769043,1,4,0,16,10323,4
100115,Toys,14.766850471496582,2022-04-20,179,232,20.6351847076416,8547.036125335693,2,4,0,16,10502,4
100115,Toys,14.766850471496582,2022-04-21,163,0,19.390369415283203,3160.630214691162,3,4,0,16,10665,4
100115,Toys,14.766850471496582,2022-04-22,64,50,16.04561122894287,1848.3182373046875,4,4,0,16,10729,4
100115,Toys,14.766850471496582,2022-04-23,43,50,14.568653373718263,1347.8241901397705,5,4,1,16,10772,4
100115,Toys,14.766850471496582,2022-04-24,13,50,12.4260400390625,738.217041015625,6,4,1,16,10785,4
100115,Toys,14.766850471496582,2022-04-25,84,95,13.101690731048585,2343.204042816162,0,4,0,17,10869,4
100115,Toys,14.766850471496582,2022-04-26,15,0,13.283381462097168,199.25072193145752,1,4,0,17,10884,4
100115,Toys,14.766850471496582,2022-04-27,47,50,11.310935306549073,1094.2779188156128,2,4,0,17,10931,4
100115,Toys,14.766850471496582,2022-04-28,16,0,12.271870613098145,196.3499298095703,3,4,0,17,10947,4
100115,Toys,14.766850471496582,2022-04-29,39,50,12.325732517242432,1097.2571363449097,4,4,0,17,10986,4
100115,Toys,14.766850471496582,2022-04-30,58,53,13.363617115020752,1480.8795853424072,5,4,1,17,11044,4
100115,Toys,14.766850471496582,2022-05-01,38,50,12.794190769195556,1125.4784984588623,6,5,1,17,11082,4
100115,Toys,14.766850471496582,2022-05-02,35,50,12.522793827056883,1062.145567893982,0,5,0,18,11117,4
100115,Toys,14.766850471496582,2022-05-03,32,0,12.67558765411377,405.6188049316406,1,5,0,18,11149,4
100115,Toys,14.766850471496582,2022-05-04,18,50,11.694826126098633,781.0137405395508,2,5,0,18,11167,4
100115,Toys,14.766850471496582,2022-05-05,34,0,12.139652252197266,412.74817657470703,3,5,0,18,11201,4
100115,Toys,14.766850471496582,2022-05-06,35,50,11.241800708770752,949.5260496139526,4,5,0,18,11236,4
100115,Toys,14.766850471496582,2022-05-07,21,0,11.643601417541504,244.51562976837158,5,5,1,18,11257,4
100115,Toys,14.766850471496582,2022-05-08,36,50,11.872080192565917,1022.3697738647461,6,5,1,18,11293,4
100115,Toys,14.766850471496582,2022-05-09,23,50,11.730540733337403,855.7748737335205,0,5,0,19,11316,4
100115,Toys,14.766850471496582,2022-05-10,21,0,11.751081466674805,246.7727108001709,1,5,0,19,11337,4
100115,Toys,14.766850471496582,2022-05-11,29,50,12.321905899047852,979.2705421447754,2,5,0,19,11366,4
100115,Toys,14.766850471496582,2022-05-12,27,0,12.043811798095703,325.182918548584,3,5,0,19,11393,4
100115,Toys,14.766850471496582,2022-05-13,15,0,12.043811798095703,180.65717697143555,4,5,0,19,11408,4
100115,Toys,14.766850471496582,2022-05-14,27,50,12.665572967529297,981.330940246582,5,5,1,19,11435,4
100115,Toys,14.766850471496582,2022-05-15,9,0,12.401145935058594,111.61031341552734,6,5,1,19,11444,4
100115,Toys,14.766850471496582,2022-05-16,44,50,11.52848154067993,1081.226375579834,0,5,0,20,11488,4
100115,Toys,14.766850471496582,2022-05-17,73,125,12.47341209411621,2477.358165740967,1,5,0,20,11561,4
100115,Toys,14.766850471496582,2022-05-18,46,0,12.326824188232422,567.0339126586914,2,5,0,20,11607,4
100115,Toys,14.766850471496582,2022-05-19,50,52,11.77869213104248,1200.889213104248,3,5,0,20,11657,4
100115,Toys,14.766850471496582,2022-05-20,59,50,13.63056978225708,1478.5372343063354,4,5,0,20,11716,4
100115,Toys,14.766850471496582,2022-05-21,54,50,12.25676893234253,1275.8110446929932,5,5,1,20,11770,4
100115,Toys,14.766850471496582,2022-05-22,10,0,12.533537864685059,125.33537864685059,6,5,1,20,11780,4
100115,Toys,14.766850471496582,2022-05-23,35,50,11.670773048400878,986.3041133880615,0,5,0,21,11815,4
100115,Toys,14.766850471496582,2022-05-24,14,0,12.051546096801758,168.7216453552246,1,5,0,21,11829,4
100115,Toys,14.766850471496582,2022-05-25,23,50,11.330475692749022,818.4718818664551,2,5,0,21,11852,4
100115,Toys,14.766850471496582,2022-05-26,107,132,13.008476448059081,3118.8139598846437,3,5,0,21,11959,4
100115,Toys,14.766850471496582,2022-05-27,107,136,16.36529438018799,4012.2829973602293,4,5,0,21,12066,4
100115,Toys,14.766850471496582,2022-05-28,155,107,15.895773754119872,4149.129863777161,5,5,1,21,12221,4
100115,Toys,14.766850471496582,2022-05-29,82,89,16.36996253967285,2801.4338565063476,6,5,1,21,12303,4
100115,Toys,14.766850471496582,2022-05-30,95,67,14.538692626953125,2375.391599121094,0,5,0,22,12398,4
100115,Toys,14.766850471496582,2022-05-31,46,76,15.041426639556885,1832.6112508392334,1,5,0,22,12444,4
100115,Toys,14.766850471496582,2022-06-01,122,119,17.884207878112793,4307.286722259521,2,6,0,22,12566,4
100115,Toys,14.766850471496582,2022-06-02,46,0,16.948415756225586,779.627124786377,3,6,0,22,12612,4
100115,Toys,14.766850471496582,2022-06-03,73,177,19.417828483581545,4898.362958602906,4,6,0,22,12685,4
100115,Toys,14.766850471496582,2022-06-04,28,0,18.995656967163086,531.8783950805664,5,6,1,22,12713,4
100115,Toys,14.766850471496582,2022-06-05,60,0,18.995656967163086,1139.7394180297852,6,6,1,22,12773,4
100115,Toys,14.766850471496582,2022-06-06,89,73,15.481060218811034,2529.228718948364,0,6,0,23,12862,4
100115,Toys,14.766850471496582,2022-06-07,20,50,12.851320114135742,849.4528045654297,1,6,0,23,12882,4
100115,Toys,14.766850471496582,2022-06-08,75,94,14.151400814056396,2389.0901221084596,2,6,0,23,12957,4
100115,Toys,14.766850471496582,2022-06-09,87,165,15.257041702270508,3865.285256195068,3,6,0,23,13044,4
100115,Toys,14.766850471496582,2022-06-10,134,134,15.012240657806396,4023.280496292114,4,6,0,23,13178,4
100115,Toys,14.766850471496582,2022-06-11,103,0,15.004481315612793,1545.4615755081177,5,6,1,23,13281,4
100115,Toys,14.766850471496582,2022-06-12,89,107,14.04824686050415,2748.0879411697388,6,6,1,23,13370,4
100115,Toys,14.766850471496582,2022-06-13,68,64,15.041220245361327,1984.1259533691405,0,6,0,24,13438,4
100115,Toys,14.766850471496582,2022-06-14,111,163,16.95131565093994,4674.232074508667,1,6,0,24,13549,4
100115,Toys,14.766850471496582,2022-06-15,122,93,15.576501941680908,3359.8664737701415,2,6,0,24,13671,4
100115,Toys,14.766850471496582,2022-06-16,67,99,14.525971031188964,2392.8801181793215,3,6,0,24,13738,4
100115,Toys,14.766850471496582,2022-06-17,40,0,15.10194206237793,604.0776824951172,4,6,0,24,13778,4
100115,Toys,14.766850471496582,2022-06-18,105,136,14.637146587371827,3522.990783348084,5,6,1,24,13883,4
100115,Toys,14.766850471496582,2022-06-19,94,86,15.722353897094727,2826.4425326538085,6,6,1,24,13977,4
100115,Toys,14.766850471496582,2022-06-20,90,128,16.56521942138672,3629.2594958496093,0,6,0,25,14067,4
100115,Toys,14.766850471496582,2022-06-21,136,114,16.55890727996826,4135.082780151367,1,6,0,25,14203,4
100115,Toys,14.766850471496582,2022-06-22,108,158,15.478280868530273,4102.30866760254,2,6,0,25,14311,4
100115,Toys,14.766850471496582,2022-06-23,62,0,15.776561737060547,978.1468276977539,3,6,0,25,14373,4
100115,Toys,14.766850471496582,2022-06-24,153,128,16.725149192810058,4690.895652999878,4,6,0,25,14526,4
100115,Toys,14.766850471496582,2022-06-25,84,114,15.85520263671875,3133.77404296875,5,6,1,25,14610,4
100115,Toys,14.766850471496582,2022-06-26,102,91,15.132096271514893,2925.137639389038,6,6,1,25,14712,4
100115,Toys,14.766850471496582,2022-06-27,42,0,15.554192543029785,653.276086807251,0,6,0,26,14754,4
100115,Toys,14.766850471496582,2022-06-28,105,117,17.68119422912598,3933.1307881164553,1,6,0,26,14859,4
100115,Toys,14.766850471496582,2022-06-29,23,0,17.022388458251953,391.5149345397949,2,6,0,26,14882,4
100115,Toys,14.766850471496582,2022-06-30,35,50,15.491682052612305,1305.6677436828613,3,6,0,26,14917,4
100115,Toys,14.766850471496582,2022-07-01,16,0,16.23336410522461,259.73382568359375,4,7,0,26,14933,4
100115,Toys,14.766850471496582,2022-07-02,7,0,16.23336410522461,113.63354873657227,5,7,1,26,14940,4
100115,Toys,14.766850471496582,2022-07-03,47,50,12.743563594818117,1231.2849779129028,6,7,1,26,14987,4
100115,Toys,14.766850471496582,2022-07-04,23,50,12.625447063446046,899.6405649185181,0,7,0,27,15010,4
100115,Toys,14.766850471496582,2022-07-05,27,0,13.44089412689209,362.9041414260864,1,7,0,27,15037,4
100115,Toys,14.766850471496582,2022-07-06,11,0,13.44089412689209,147.849835395813,2,7,0,27,15048,4
100115,Toys,14.766850471496582,2022-07-07,10,50,11.451678791046142,652.2335758209229,3,7,0,27,15058,4
100115,Toys,14.766850471496582,2022-07-08,46,0,12.323357582092285,566.8744487762451,4,7,0,27,15104,4
100115,Toys,14.766850471496582,2022-07-09,26,50,11.383449668884278,855.6993827819824,5,7,1,27,15130,4
100115,Toys,14.766850471496582,2022-07-10,30,0,11.776899337768555,353.30698013305664,6,7,1,27,15160,4
100115,Toys,14.766850471496582,2022-07-11,11,50,11.793428325653077,719.6554231643677,0,7,0,28,15171,4
100115,Toys,14.766850471496582,2022-07-12,9,0,11.786856651306152,106.08170986175537,1,7,0,28,15180,4
100115,Toys,14.766850471496582,2022-07-13,42,52,12.268710136413574,1155.5716514587402,2,7,0,28,15222,4
100115,Toys,14.766850471496582,2022-07-14,20,0,12.037420272827148,240.74840545654297,3,7,0,28,15242,4
100115,Toys,14.766850471496582,2022-07-15,22,0,12.037420272827148,264.82324600219727,4,7,0,28,15264,4
100115,Toys,14.766850471496582,2022-07-16,43,50,11.686819934844971,1085.9165143966675,5,7,1,28,15307,4
100115,Toys,14.766850471496582,2022-07-17,4,0,11.823639869689941,47.294559478759766,6,7,1,28,15311,4
100115,Toys,14.766850471496582,2022-07-18,6,50,11.60693956375122,646.1632747650146,0,7,0,29,15317,4
100115,Toys,14.766850471496582,2022-07-19,58,61,12.178926067352295,1449.9854238128662,1,7,0,29,15375,4
100115,Toys,14.766850471496582,2022-07-20,17,0,11.94785213470459,203.11348628997803,2,7,0,29,15392,4
100115,Toys,14.766850471496582,2022-07-21,48,50,12.197216663360596,1195.5727996826172,3,7,0,29,15440,4
100115,Toys,14.766850471496582,2022-07-22,31,50,11.884492893218994,960.8485593795776,4,7,0,29,15471,4
100115,Toys,14.766850471496582,2022-07-23,23,0,11.978985786437988,275.51667308807373,5,7,1,29,15494,4
100115,Toys,14.766850471496582,2022-07-24,10,0,11.978985786437988,119.78985786437988,6,7,1,29,15504,4
100115,Toys,14.766850471496582,2022-07-25,50,50,13.51449571609497,1351.449571609497,0,7,0,30,15554,4
100115,Toys,14.766850471496582,2022-07-26,85,134,16.22697296142578,3594.035403442383,1,7,0,30,15639,4
100115,Toys,14.766850471496582,2022-07-27,76,75,15.13628900527954,2285.7059288024902,2,7,0,30,15715,4
100115,Toys,14.766850471496582,2022-07-28,130,110,15.413236484527587,3698.0414859771727,3,7,0,30,15845,4
100115,Toys,14.766850471496582,2022-07-29,113,160,17.60357353210449,4833.337618255615,4,7,0,30,15958,4
100115,Toys,14.766850471496582,2022-07-30,36,0,17.017147064208984,612.6172943115234,5,7,1,30,15994,4
100115,Toys,14.766850471496582,2022-07-31,66,77,16.51429416656494,2359.076829986572,6,7,1,30,16060,4
100115,Toys,14.766850471496582,2022-08-01,93,70,15.914535408020019,2603.3735858917235,0,8,0,31,16153,4
100115,Toys,14.766850471496582,2022-08-02,57,92,14.273862361907959,2099.7203092575073,1,8,0,31,16210,4
100115,Toys,14.766850471496582,2022-08-03,45,0,15.047724723815918,677.1476125717163,2,8,0,31,16255,4
100115,Toys,14.766850471496582,2022-08-04,102,150,15.416444187164306,3889.4346141815186,3,8,0,31,16357,4
100115,Toys,14.766850471496582,2022-08-05,69,0,15.322888374328613,1057.2792978286743,4,8,0,31,16426,4
100115,Toys,14.766850471496582,2022-08-06,81,101,15.693829917907715,2858.40044670105,5,8,1,31,16507,4
100115,Toys,14.766850471496582,2022-08-07,101,101,14.351914615631102,2899.086752357483,6,8,1,31,16608,4
100115,Toys,14.766850471496582,2022-08-08,80,119,15.400356216430664,3072.0669946289063,0,8,0,32,16688,4
100115,Toys,14.766850471496582,2022-08-09,69,0,15.210712432861328,1049.5391578674316,1,8,0,32,16757,4
100115,Toys,14.766850471496582,2022-08-10,46,50,13.394217319488526,1282.8279933929443,2,8,0,32,16803,4
100115,Toys,14.766850471496582,2022-08-11,75,85,12.970570735931396,2071.6856103897094,3,8,0,32,16878,4
100115,Toys,14.766850471496582,2022-08-12,57,79,14.493436050415038,1980.0517097473146,4,8,0,32,16935,4
100115,Toys,14.766850471496582,2022-08-13,67,101,14.720565528869628,2480.5157808685303,5,8,1,32,17002,4
100115,Toys,14.766850471496582,2022-08-14,141,154,18.22925395965576,5392.849616622925,6,8,1,32,17143,4
100115,Toys,14.766850471496582,2022-08-15,154,151,14.824475917816162,4523.728582687378,0,8,0,33,17297,4
100115,Toys,14.766850471496582,2022-08-16,63,0,15.578951835632324,981.4739656448364,1,8,0,33,17360,4
100115,Toys,14.766850471496582,2022-08-17,88,174,17.967838859558107,4749.039639282226,2,8,0,33,17448,4
100115,Toys,14.766850471496582,2022-08-18,125,164,16.575485115051272,4778.011278762818,3,8,0,33,17573,4
100115,Toys,14.766850471496582,2022-08-19,48,0,16.89097023010254,810.7665710449219,4,8,0,33,17621,4
100115,Toys,14.766850471496582,2022-08-20,105,107,16.84152618408203,3570.3604986572263,5,8,1,33,17726,4
100115,Toys,14.766850471496582,2022-08-21,122,158,18.205753288269044,5114.323802337647,6,8,1,33,17848,4
100115,Toys,14.766850471496582,2022-08-22,83,0,17.741506576538086,1472.5450458526611,0,8,0,34,17931,4
100115,Toys,14.766850471496582,2022-08-23,58,72,15.361720695495606,1981.87960067749,1,8,0,34,17989,4
100115,Toys,14.766850471496582,2022-08-24,93,98,15.459528236389161,2950.772251968384,2,8,0,34,18082,4
100115,Toys,14.766850471496582,2022-08-25,133,149,16.079790306091308,4535.624221420288,3,8,0,34,18215,4
100115,Toys,14.766850471496582,2022-08-26,98,98,14.95548402786255,2931.2748694610596,4,8,0,34,18313,4
100115,Toys,14.766850471496582,2022-08-27,122,97,14.243115291595458,3132.320131149292,5,8,1,34,18435,4
100115,Toys,14.766850471496582,2022-08-28,58,63,13.979507484436034,1689.52286819458,6,8,1,34,18493,4
100115,Toys,14.766850471496582,2022-08-29,64,124,14.76422185897827,2783.820397949219,0,8,0,35,18557,4
100115,Toys,14.766850471496582,2022-08-30,38,0,14.628443717956543,555.8808612823486,1,8,0,35,18595,4
100115,Toys,14.766850471496582,2022-08-31,129,137,16.98982219696045,4526.174126815797,2,8,0,35,18724,4
100115,Toys,14.766850471496582,2022-09-01,110,0,16.1296443939209,1774.2608833312988,3,9,0,35,18834,4
100115,Toys,14.766850471496582,2022-09-02,55,94,15.493894386291505,2302.978382492065,4,9,0,35,18889,4
100115,Toys,14.766850471496582,2022-09-03,64,77,15.008515129089355,2113.0999365234375,5,9,1,35,18953,4
100115,Toys,14.766850471496582,2022-09-04,107,90,15.402163009643555,3033.242884063721,6,9,1,35,19060,4
100115,Toys,14.766850471496582,2022-09-05,82,90,15.551081714630126,2675.337401199341,0,9,0,36,19142,4
100115,Toys,14.766850471496582,2022-09-06,98,148,14.73567476272583,3615.692253494263,1,9,0,36,19240,4
100115,Toys,14.766850471496582,2022-09-07,52,101,14.857147731781005,2271.8133641052245,2,9,0,36,19292,4
100115,Toys,14.766850471496582,2022-09-08,49,0,14.884295463562012,729.3304777145386,3,9,0,36,19341,4
100115,Toys,14.766850471496582,2022-09-09,148,163,15.14012180328369,4709.776053771973,4,9,0,36,19489,4
100115,Toys,14.766850471496582,2022-09-10,93,135,15.57588888168335,3559.455331993103,5,9,1,36,19582,4
100115,Toys,14.766850471496582,2022-09-11,175,189,17.000728759765625,6196.235065917968,6,9,1,36,19757,4
100115,Toys,14.766850471496582,2022-09-12,72,0,16.43145751953125,1183.06494140625,0,9,0,37,19829,4
100115,Toys,14.766850471496582,2022-09-13,31,0,16.43145751953125,509.37518310546875,1,9,0,37,19860,4
100115,Toys,14.766850471496582,2022-09-14,71,70,14.675615730285646,2070.0574337005614,2,9,0,37,19931,4
100115,Toys,14.766850471496582,2022-09-15,57,0,15.471231460571289,881.8601932525635,3,9,0,37,19988,4
100115,Toys,14.766850471496582,2022-09-16,52,80,13.827359981536866,1812.965438079834,4,9,0,37,20040,4
100115,Toys,14.766850471496582,2022-09-17,86,147,16.495205879211426,3874.1754112243652,5,9,1,37,20126,4
100115,Toys,14.766850471496582,2022-09-18,70,125,14.851655330657959,2872.8817462921143,6,9,1,37,20196,4
100115,Toys,14.766850471496582,2022-09-19,116,0,15.273310661315918,1771.7040367126465,0,9,0,38,20312,4
100115,Toys,14.766850471496582,2022-09-20,83,105,15.828651065826417,2979.336076927185,1,9,0,38,20395,4
100115,Toys,14.766850471496582,2022-09-21,85,71,14.558850803375243,2277.8846365737913,2,9,0,38,20480,4
100115,Toys,14.766850471496582,2022-09-22,78,115,14.992975940704346,2893.1642467498777,3,9,0,38,20558,4
100115,Toys,14.766850471496582,2022-09-23,99,162,16.864812088012695,4435.432793426513,4,9,0,38,20657,4
100115,Toys,14.766850471496582,2022-09-24,144,170,18.002317123413086,5668.527331542969,5,9,1,38,20801,4
100115,Toys,14.766850471496582,2022-09-25,88,0,17.394634246826172,1530.7278137207031,6,9,1,38,20889,4
100115,Toys,14.766850471496582,2022-09-26,95,93,16.069892654418943,3022.2396043395993,0,9,0,39,20984,4
100115,Toys,14.766850471496582,2022-09-27,78,109,16.74370719909668,3132.5083230590817,1,9,0,39,21062,4
100115,Toys,14.766850471496582,2022-09-28,98,0,16.69741439819336,1636.3466110229492,2,9,0,39,21160,4
100115,Toys,14.766850471496582,2022-09-29,53,66,15.452275657653809,1833.591219711304,3,9,0,39,21213,4
100115,Toys,14.766850471496582,2022-09-30,26,50,13.532642498016358,1004.4174098968506,4,9,0,39,21239,4
100115,Toys,14.766850471496582,2022-10-01,18,0,14.535284996032715,261.63512992858887,5,10,1,39,21257,4
100115,Toys,14.766850471496582,2022-10-02,57,84,15.269256954193114,2159.4652927780153,6,10,1,39,21314,4
100115,Toys,14.766850471496582,2022-10-03,73,86,13.948815479278565,2212.4170599746703,0,10,0,40,21387,4
100115,Toys,14.766850471496582,2022-10-04,55,74,15.609058341979981,2024.226417617798,1,10,0,40,21442,4
100115,Toys,14.766850471496582,2022-10-05,41,0,15.048116683959961,616.9727840423584,2,10,0,40,21483,4
100115,Toys,14.766850471496582,2022-10-06,85,74,14.878423957824708,2366.4220728302002,3,10,0,40,21568,4
100115,Toys,14.766850471496582,2022-10-07,78,66,13.537546501159667,1956.2172541809082,4,10,0,40,21646,4
100115,Toys,14.766850471496582,2022-10-08,77,76,13.936641159057618,2132.362738494873,5,10,1,40,21723,4
100115,Toys,14.766850471496582,2022-10-09,76,167,15.56808536529541,3809.6089755249022,6,10,1,40,21799,4
100115,Toys,14.766850471496582,2022-10-10,145,131,16.51698112487793,4551.9245262146,0,10,0,41,21944,4
100115,Toys,14.766850471496582,2022-10-11,79,118,16.885196075439453,3339.4409799194336,1,10,0,41,22023,4
100115,Toys,14.766850471496582,2022-10-12,61,0,16.550392150878906,1009.5739212036133,2,10,0,41,22084,4
100115,Toys,14.766850471496582,2022-10-13,122,88,17.237012519836426,3609.811054840088,3,10,0,41,22206,4
100115,Toys,14.766850471496582,2022-10-14,45,77,14.633075828552247,1756.6568245697022,4,10,0,41,22251,4
100115,Toys,14.766850471496582,2022-10-15,129,204,16.158173828125,5392.05884765625,5,10,1,41,22380,4
100115,Toys,14.766850471496582,2022-10-16,82,0,16.00634765625,1312.5205078125,6,10,1,41,22462,4
100115,Toys,14.766850471496582,2022-10-17,58,91,13.197310600280762,1929.1980296325685,0,10,0,42,22520,4
100115,Toys,14.766850471496582,2022-10-18,95,0,14.324621200561523,1360.8390140533447,1,10,0,42,22615,4
100115,Toys,14.766850471496582,2022-10-19,60,81,13.573110637664794,1909.5432765197754,2,10,0,42,22675,4
100115,Toys,14.766850471496582,2022-10-20,33,50,13.467953720092773,1115.494945526123,3,10,0,42,22708,4
100115,Toys,14.766850471496582,2022-10-21,66,120,15.120777397155763,2836.1826164245604,4,10,0,42,22774,4
100115,Toys,14.766850471496582,2022-10-22,44,0,14.681554794311523,645.988410949707,5,10,1,42,22818,4
100115,Toys,14.766850471496582,2022-10-23,108,105,14.904338111877442,3174.3970321655274,6,10,1,42,22926,4
100115,Toys,14.766850471496582,2022-10-24,53,56,12.659568481445312,1376.744259033203,0,10,0,43,22979,4
100115,Toys,14.766850471496582,2022-10-25,66,77,12.151910190582274,1730.6621451568603,1,10,0,43,23045,4
100115,Toys,14.766850471496582,2022-10-26,57,55,13.278260364532471,1486.6616815567018,2,10,0,43,23102,4
100115,Toys,14.766850471496582,2022-10-27,117,128,14.886556968688964,3653.6243306732176,3,10,0,43,23219,4
100115,Toys,14.766850471496582,2022-10-28,120,89,16.04949010848999,3331.6976260375977,4,10,0,43,23339,4
100115,Toys,14.766850471496582,2022-10-29,93,106,15.93623441696167,3173.8296015548704,5,10,1,43,23432,4
100115,Toys,14.766850471496582,2022-10-30,86,98,15.49055643081665,2849.1757061004637,6,10,1,43,23518,4
100115,Toys,14.766850471496582,2022-10-31,36,67,13.636655311584473,1375.8491824340822,0,10,0,44,23554,4
100115,Toys,14.766850471496582,2022-11-01,96,120,16.66988384246826,3620.377697753906,1,11,0,44,23650,4
100115,Toys,14.766850471496582,2022-11-02,79,0,15.849767684936523,1252.1316471099854,2,11,0,44,23729,4
100115,Toys,14.766850471496582,2022-11-03,69,66,15.043528175354004,2031.9068881988524,3,11,0,44,23798,4
100115,Toys,14.766850471496582,2022-11-04,66,50,14.602311477661132,1699.9851150512695,4,11,0,44,23864,4
100115,Toys,14.766850471496582,2022-11-05,77,86,15.931864490509033,2599.577131538391,5,11,1,44,23941,4
100115,Toys,14.766850471496582,2022-11-06,88,118,15.79594223022461,3255.285832519531,6,11,1,44,24029,4
100115,Toys,14.766850471496582,2022-11-07,75,69,14.805995521545409,2134.6793282318113,0,11,0,45,24104,4
100115,Toys,14.766850471496582,2022-11-08,90,99,15.945741748809814,3016.033514785767,1,11,0,45,24194,4
100115,Toys,14.766850471496582,2022-11-09,113,94,16.79706882476807,3468.767554397583,2,11,0,45,24307,4
100115,Toys,14.766850471496582,2022-11-10,102,135,15.772282772064209,3732.6756855010985,3,11,0,45,24409,4
100115,Toys,14.766850471496582,2022-11-11,49,0,15.934565544128418,780.7937116622925,4,11,0,45,24458,4
100115,Toys,14.766850471496582,2022-11-12,86,160,16.368155937194825,4033.36282119751,5,11,1,45,24544,4
100115,Toys,14.766850471496582,2022-11-13,160,125,17.710367927551268,5027.867736816406,6,11,1,45,24704,4
100115,Toys,14.766850471496582,2022-11-14,81,106,16.807363357543945,3139.792863922119,0,11,0,46,24785,4
100115,Toys,14.766850471496582,2022-11-15,90,116,16.005054779052735,3287.549860229492,1,11,0,46,24875,4
100115,Toys,14.766850471496582,2022-11-16,74,129,17.58665470123291,3597.2248957824704,2,11,0,46,24949,4
100115,Toys,14.766850471496582,2022-11-17,62,0,17.09330940246582,1059.7851829528809,3,11,0,46,25011,4
100115,Toys,14.766850471496582,2022-11-18,92,110,15.285429000854492,3073.5189361572266,4,11,0,46,25103,4
100115,Toys,14.766850471496582,2022-11-19,101,151,14.428181076049805,3604.4925773620607,5,11,1,46,25204,4
100115,Toys,14.766850471496582,2022-11-20,59,0,15.05636215209961,888.325366973877,6,11,1,46,25263,4
100115,Toys,14.766850471496582,2022-11-21,88,123,15.861847972869873,3358.6852432250976,0,11,0,47,25351,4
100115,Toys,14.766850471496582,2022-11-22,108,0,15.523695945739746,1676.5591621398926,1,11,0,47,25459,4
100115,Toys,14.766850471496582,2022-11-23,91,85,15.44141586303711,2717.877687072754,2,11,0,47,25550,4
100115,Toys,14.766850471496582,2022-11-24,99,123,15.812523441314697,3512.7196413803103,3,11,0,47,25649,4
100115,Toys,14.766850471496582,2022-11-25,123,147,17.008483238220215,4601.446876602173,4,11,0,47,25772,4
100115,Toys,14.766850471496582,2022-11-26,33,0,16.62696647644043,548.6898937225342,5,11,1,47,25805,4
100115,Toys,14.766850471496582,2022-11-27,95,116,14.869161148071289,3125.230618133545,6,11,1,47,25900,4
100115,Toys,14.766850471496582,2022-11-28,49,0,15.448322296142578,756.9677925109863,0,11,0,48,25949,4
100115,Toys,14.766850471496582,2022-11-29,86,98,16.10096683502197,2964.9662956237794,1,11,0,48,26035,4
100115,Toys,14.766850471496582,2022-11-30,98,94,16.47398277282715,3162.2206234741216,2,11,0,48,26133,4
100115,Toys,14.766850471496582,2022-12-01,94,192,17.49973594665527,5028.470357971191,3,12,0,48,26227,4
100115,Toys,14.766850471496582,2022-12-02,70,0,17.259471893310547,1208.1630325317383,4,12,0,48,26297,4
100115,Toys,14.766850471496582,2022-12-03,78,74,16.24044765472412,2470.389834136963,5,12,1,48,26375,4
100115,Toys,14.766850471496582,2022-12-04,116,166,17.238918724060056,4868.4291439819335,6,12,1,48,26491,4
100115,Toys,14.766850471496582,2022-12-05,119,109,16.966960983276365,3869.0367140197754,0,12,0,49,26610,4
100115,Toys,14.766850471496582,2022-12-06,90,0,17.023921966552734,1532.152976989746,1,12,0,49,26700,4
100115,Toys,14.766850471496582,2022-12-07,59,60,14.70776039123535,1749.3857261657713,2,12,0,49,26759,4
100115,Toys,14.766850471496582,2022-12-08,69,95,14.546222343444825,2378.6586833953857,3,12,0,49,26828,4
100115,Toys,14.766850471496582,2022-12-09,81,136,18.003878631591796,3952.2783383178707,4,12,0,49,26909,4
100115,Toys,14.766850471496582,2022-12-10,51,0,17.177757263183594,876.0656204223633,5,12,1,49,26960,4
100115,Toys,14.766850471496582,2022-12-11,99,131,14.338604240417482,3272.9636396026613,6,12,1,49,27059,4
100115,Toys,14.766850471496582,2022-12-12,104,91,15.471653995513915,3015.0440310668946,0,12,0,50,27163,4
100115,Toys,14.766850471496582,2022-12-13,75,101,15.89075403213501,2802.213104820252,1,12,0,50,27238,4
100115,Toys,14.766850471496582,2022-12-14,99,173,16.661888694763185,4553.353961563111,2,12,0,50,27337,4
100115,Toys,14.766850471496582,2022-12-15,80,0,16.373777389526367,1309.9021911621094,3,12,0,50,27417,4
100115,Toys,14.766850471496582,2022-12-16,99,101,16.79786907196045,3359.9180762481687,4,12,0,50,27516,4
100115,Toys,14.766850471496582,2022-12-17,97,113,16.76625171661377,3521.772833023071,5,12,1,50,27613,4
100115,Toys,14.766850471496582,2022-12-18,80,0,16.71250343322754,1337.0002746582031,6,12,1,50,27693,4
100115,Toys,14.766850471496582,2022-12-19,64,78,15.339708633422852,2171.942705078125,0,12,0,51,27757,4
100115,Toys,14.766850471496582,2022-12-20,66,127,15.908773155212401,3072.298056488037,1,12,0,51,27823,4
100115,Toys,14.766850471496582,2022-12-21,129,96,14.809978885650635,3347.7545524978636,2,12,0,51,27952,4
100115,Toys,14.766850471496582,2022-12-22,40,0,15.27995777130127,611.1983108520508,3,12,0,51,27992,4
100115,Toys,14.766850471496582,2022-12-23,78,90,15.786775798797606,2654.0170246124267,4,12,0,51,28070,4
100115,Toys,14.766850471496582,2022-12-24,90,136,14.117034549713136,3173.1062189483646,5,12,1,51,28160,4
100115,Toys,14.766850471496582,2022-12-25,75,105,16.558534202575686,3004.880130386353,6,12,1,51,28235,4
100115,Toys,14.766850471496582,2022-12-26,166,176,17.415370559692384,5961.403025817871,0,12,0,52,28401,4
100115,Toys,14.766850471496582,2022-12-27,29,0,16.880741119384766,489.5414924621582,1,12,0,52,28430,4
100115,Toys,14.766850471496582,2022-12-28,81,84,15.700690460205077,2588.961854553223,2,12,0,52,28511,4
100115,Toys,14.766850471496582,2022-12-29,70,0,16.251380920410156,1137.596664428711,3,12,0,52,28581,4
100115,Toys,14.766850471496582,2022-12-30,80,90,16.70914821624756,2841.9637145996094,4,12,0,52,28661,4
100115,Toys,14.766850471496582,2022-12-31,90,146,18.212599563598634,4319.867921447754,5,12,1,52,28751,4
100115,Toys,14.766850471496582,2023-01-01,103,76,15.794772529602051,2854.1231410980226,6,1,1,52,28854,4
100115,Toys,14.766850471496582,2023-01-02,119,93,16.46616928100586,3494.1082888793944,0,1,0,1,28973,4
100115,Toys,14.766850471496582,2023-01-03,80,93,17.603084297180175,3049.713487548828,1,1,0,1,29053,4
100115,Toys,14.766850471496582,2023-01-04,90,111,15.94648338317871,3196.287008972168,2,1,0,1,29143,4
100115,Toys,14.766850471496582,2023-01-05,45,70,14.365068035125732,1628.106123161316,3,1,0,1,29188,4
100115,Toys,14.766850471496582,2023-01-06,114,119,15.658229846954345,3649.026405105591,4,1,0,1,29302,4
100115,Toys,14.766850471496582,2023-01-07,25,0,15.526459693908691,388.1614923477173,5,1,1,1,29327,4
100115,Toys,14.766850471496582,2023-01-08,132,193,15.72851194381714,5114.907153167725,6,1,1,1,29459,4
100115,Toys,14.766850471496582,2023-01-09,15,0,15.677023887634277,235.15535831451416,0,1,0,2,29474,4
100115,Toys,14.766850471496582,2023-01-10,143,160,15.340340480804443,4646.0773775100715,1,1,0,2,29617,4
100115,Toys,14.766850471496582,2023-01-11,45,0,15.460680961608887,695.7306432723999,2,1,0,2,29662,4
100115,Toys,14.766850471496582,2023-01-12,67,102,15.01067892074585,2530.130975379944,3,1,0,2,29729,4
100115,Toys,14.766850471496582,2023-01-13,85,0,15.2013578414917,1292.1154165267944,4,1,0,2,29814,4
100115,Toys,14.766850471496582,2023-01-14,100,182,17.627190780639648,5013.738156127929,5,1,1,2,29914,4
100115,Toys,14.766850471496582,2023-01-15,104,138,16.120839347839357,3887.954584350586,6,1,1,2,30018,4
100115,Toys,14.766850471496582,2023-01-16,87,0,16.51167869567871,1436.5160465240479,0,1,0,3,30105,4
100115,Toys,14.766850471496582,2023-01-17,81,90,13.251179523468018,2253.701082801819,1,1,0,3,30186,4
100115,Toys,14.766850471496582,2023-01-18,122,177,15.250897731781006,4569.869046554566,2,1,0,3,30308,4
100115,Toys,14.766850471496582,2023-01-19,107,0,15.071795463562012,1612.6821146011353,3,1,0,3,30415,4
100115,Toys,14.766850471496582,2023-01-20,86,101,13.16068021774292,2452.4869974517824,4,1,0,3,30501,4
100115,Toys,14.766850471496582,2023-01-21,62,92,14.557298946380616,2250.605069351196,5,1,1,3,30563,4
100115,Toys,14.766850471496582,2023-01-22,68,98,15.503629684448242,2588.493637084961,6,1,1,3,30631,4
100115,Toys,14.766850471496582,2023-01-23,156,134,14.652963886260986,4252.284732513428,0,1,0,4,30787,4
100115,Toys,14.766850471496582,2023-01-24,106,85,14.4300758934021,2759.506089401245,1,1,0,4,30893,4
100115,Toys,14.766850471496582,2023-01-25,69,101,16.06583993911743,2748.6059115982052,2,1,0,4,30962,4
100115,Toys,14.766850471496582,2023-01-26,120,89,16.261615085601807,3388.1876205444337,3,1,0,4,31082,4
100115,Toys,14.766850471496582,2023-01-27,64,63,14.521056098937988,1844.8551806640626,4,1,0,4,31146,4
100115,Toys,14.766850471496582,2023-01-28,68,98,16.443493919372557,2743.6151730346683,5,1,1,4,31214,4
100115,Toys,14.766850471496582,2023-01-29,30,0,15.976987838745117,479.3096351623535,6,1,1,4,31244,4
100115,Toys,14.766850471496582,2023-01-30,26,0,15.976987838745117,415.40168380737305,0,1,0,5,31270,4
100115,Toys,14.766850471496582,2023-01-31,10,0,15.976987838745117,159.76987838745117,1,1,0,5,31280,4
100115,Toys,14.766850471496582,2023-02-01,24,50,13.34557970046997,956.7478256225586,2,2,0,5,31304,4
100115,Toys,14.766850471496582,2023-02-02,22,0,14.531159400939941,319.6855068206787,3,2,0,5,31326,4
100115,Toys,14.766850471496582,2023-02-03,17,0,14.531159400939941,247.029709815979,4,2,0,5,31343,4
100115,Toys,14.766850471496582,2023-02-04,38,50,12.833235092163086,1121.0058670043945,5,2,1,5,31381,4
100115,Toys,14.766850471496582,2023-02-05,9,0,13.526470184326172,121.73823165893555,6,2,1,5,31390,4
100115,Toys,14.766850471496582,2023-02-06,36,50,13.098958454132081,1124.0050086975098,0,2,0,6,31426,4
100115,Toys,14.766850471496582,2023-02-07,28,50,13.094708805084228,1019.5236930847168,1,2,0,6,31454,4
100115,Toys,14.766850471496582,2023-02-08,43,0,13.179417610168457,566.7149572372437,2,2,0,6,31497,4
100115,Toys,14.766850471496582,2023-02-09,36,50,12.555704860687257,1076.3507499694824,3,2,0,6,31533,4
100115,Toys,14.766850471496582,2023-02-10,25,50,12.973881149291993,974.9440574645996,4,2,0,6,31558,4
100115,Toys,14.766850471496582,2023-02-11,40,0,12.897762298583984,515.9104919433594,5,2,1,6,31598,4
100115,Toys,14.766850471496582,2023-02-12,13,50,10.007792892456056,588.7626152038574,6,2,1,6,31611,4
100115,Toys,14.766850471496582,2023-02-13,37,0,11.13558578491211,412.01667404174805,0,2,0,7,31648,4
100115,Toys,14.766850471496582,2023-02-14,29,50,11.289813327789307,893.1591730117798,1,2,0,7,31677,4
100115,Toys,14.766850471496582,2023-02-15,35,50,12.305623435974121,1053.3936405181885,2,2,0,7,31712,4
100115,Toys,14.766850471496582,2023-02-16,12,0,11.811246871948242,141.7349624633789,3,2,0,7,31724,4
100115,Toys,14.766850471496582,2023-02-17,44,50,11.408513412475585,1071.2691802978516,4,2,0,7,31768,4
100115,Toys,14.766850471496582,2023-02-18,26,0,11.597026824951172,301.52269744873047,5,2,1,7,31794,4
100115,Toys,14.766850471496582,2023-02-19,58,55,12.916088542938233,1458.0062709808349,6,2,1,7,31852,4
100115,Toys,14.766850471496582,2023-02-20,26,50,11.370398025512696,854.3006973266602,0,2,0,8,31878,4
100115,Toys,14.766850471496582,2023-02-21,27,50,11.88223346710205,916.0306072235107,1,2,0,8,31905,4
100115,Toys,14.766850471496582,2023-02-22,52,50,12.564383602142334,1280.7958946228027,2,2,0,8,31957,4
100115,Toys,14.766850471496582,2023-02-23,24,0,12.178767204284668,292.29041290283203,3,2,0,8,31981,4
100115,Toys,14.766850471496582,2023-02-24,30,50,12.145419063568117,971.3251438140869,4,2,0,8,32011,4
100115,Toys,14.766850471496582,2023-02-25,59,55,13.535431365966797,1540.3409011840822,5,2,1,8,32070,4
100115,Toys,14.766850471496582,2023-02-26,54,50,12.780552501678468,1329.3396701812744,6,2,1,8,32124,4
100115,Toys,14.766850471496582,2023-02-27,19,0,12.821105003356934,243.60099506378174,0,2,0,9,32143,4
100115,Toys,14.766850471496582,2023-02-28,29,50,13.077043743133544,1035.4585371017456,1,2,0,9,32172,4
100115,Toys,14.766850471496582,2023-03-01,100,192,16.168028869628905,4781.965773925781,2,3,0,9,32272,4
100115,Toys,14.766850471496582,2023-03-02,113,157,14.450520420074463,3884.0176149368285,3,3,0,9,32385,4
100115,Toys,14.766850471496582,2023-03-03,236,286,20.322035751342774,10688.00087463379,4,3,0,9,32621,4
100115,Toys,14.766850471496582,2023-03-04,67,0,18.724071502685547,1254.5127906799316,5,3,1,9,32688,4
100115,Toys,14.766850471496582,2023-03-05,112,0,18.724071502685547,2097.0960083007812,6,3,1,9,32800,4
100115,Toys,14.766850471496582,2023-03-06,35,0,18.724071502685547,655.3425025939941,0,3,0,10,32835,4
100115,Toys,14.766850471496582,2023-03-07,72,144,16.054012069702146,3429.2177380371095,1,3,0,10,32907,4
100115,Toys,14.766850471496582,2023-03-08,68,0,16.588024139404297,1127.9856414794922,2,3,0,10,32975,4
100115,Toys,14.766850471496582,2023-03-09,49,55,13.423167171478273,1388.2503828048707,3,3,0,10,33024,4
100115,Toys,14.766850471496582,2023-03-10,82,98,16.2944983291626,2940.4577259826665,4,3,0,10,33106,4
100115,Toys,14.766850471496582,2023-03-11,98,179,20.70260238647461,5819.460067749023,5,3,1,10,33204,4
100115,Toys,14.766850471496582,2023-03-12,101,141,15.019846305847167,3562.808953781128,6,3,1,10,33305,4
100115,Toys,14.766850471496582,2023-03-13,87,0,16.819692611694336,1463.3132572174072,0,3,0,11,33392,4
100115,Toys,14.766850471496582,2023-03-14,132,133,17.00765911102295,4507.092005310058,1,3,0,11,33524,4
100115,Toys,14.766850471496582,2023-03-15,127,143,18.216498908996584,4924.910722885132,2,3,0,11,33651,4
100115,Toys,14.766850471496582,2023-03-16,149,157,18.060386962890625,5527.115314941406,3,3,0,11,33800,4
100115,Toys,14.766850471496582,2023-03-17,86,115,16.35112449645996,3267.403413391113,4,3,0,11,33886,4
100115,Toys,14.766850471496582,2023-03-18,132,142,16.960485191345214,4646.968090515136,5,3,1,11,34018,4
100115,Toys,14.766850471496582,2023-03-19,107,164,18.013708305358886,4903.733577346802,6,3,1,11,34125,4
100115,Toys,14.766850471496582,2023-03-20,75,0,17.627416610717773,1322.056245803833,0,3,0,12,34200,4
100115,Toys,14.766850471496582,2023-03-21,88,0,17.627416610717773,1551.212661743164,1,3,0,12,34288,4
100115,Toys,14.766850471496582,2023-03-22,90,143,18.38795581817627,4294.042047271729,2,3,0,12,34378,4
100115,Toys,14.766850471496582,2023-03-23,118,159,19.55997585296631,5435.3343013000485,3,3,0,12,34496,4
100115,Toys,14.766850471496582,2023-03-24,184,144,18.960108108520508,6221.719783935547,4,3,0,12,34680,4
100115,Toys,14.766850471496582,2023-03-25,144,224,21.68439010620117,8031.504350585938,5,3,1,12,34824,4
100115,Toys,14.766850471496582,2023-03-26,107,0,21.038780212402344,2251.149482727051,6,3,1,12,34931,4
100115,Toys,14.766850471496582,2023-03-27,76,71,16.20403553009033,2392.9134005737305,0,3,0,13,35007,4
100115,Toys,14.766850471496582,2023-03-28,112,178,16.243282546997072,4676.675290527344,1,3,0,13,35119,4
100115,Toys,14.766850471496582,2023-03-29,126,113,16.856131744384765,4028.0451995849608,2,3,0,13,35245,4
100115,Toys,14.766850471496582,2023-03-30,115,0,16.81226348876953,1933.410301208496,3,3,0,13,35360,4
100115,Toys,14.766850471496582,2023-03-31,50,158,18.62267547607422,3900.227547607422,4,3,0,13,35410,4
100115,Toys,14.766850471496582,2023-04-01,67,0,18.375350952148438,1231.1485137939453,5,4,1,13,35477,4
100115,Toys,14.766850471496582,2023-04-02,55,90,14.508472423553467,2058.2819665908814,6,4,1,13,35532,4
100115,Toys,14.766850471496582,2023-04-03,74,88,16.5711568069458,2688.9912074279787,0,4,0,14,35606,4
100115,Toys,14.766850471496582,2023-04-04,94,79,15.828913154602052,2741.3856730651855,1,4,0,14,35700,4
100115,Toys,14.766850471496582,2023-04-05,51,71,15.395862865447999,1872.3780122756957,2,4,0,14,35751,4
100115,Toys,14.766850471496582,2023-04-06,81,140,13.848772392272949,3023.481127548218,3,4,0,14,35832,4
100115,Toys,14.766850471496582,2023-04-07,40,0,14.477544784545898,579.1017913818359,4,4,0,14,35872,4
100115,Toys,14.766850471496582,2023-04-08,54,0,14.477544784545898,781.7874183654785,5,4,1,14,35926,4
100115,Toys,14.766850471496582,2023-04-09,110,138,15.397761898040772,3825.9876175689697,6,4,1,14,36036,4
100115,Toys,14.766850471496582,2023-04-10,103,105,16.305889377593992,3392.5532117843627,0,4,0,15,36139,4
100115,Toys,14.766850471496582,2023-04-11,56,0,15.841778755187988,887.1396102905273,1,4,0,15,36195,4
100115,Toys,14.766850471496582,2023-04-12,9,0,15.841778755187988,142.5760087966919,2,4,0,15,36204,4
100115,Toys,14.766850471496582,2023-04-13,25,50,12.837533855438233,930.6266927719116,3,4,0,15,36229,4
100115,Toys,14.766850471496582,2023-04-14,47,52,11.59179859161377,1141.3790676116942,4,4,0,15,36276,4
100115,Toys,14.766850471496582,2023-04-15,13,0,12.833597183227539,166.836763381958,5,4,1,15,36289,4
100115,Toys,14.766850471496582,2023-04-16,20,0,12.833597183227539,256.6719436645508,6,4,1,15,36309,4
100115,Toys,14.766850471496582,2023-04-17,23,50,10.568274555206298,745.8806295394897,0,4,0,16,36332,4
100115,Toys,14.766850471496582,2023-04-18,60,65,13.103806037902832,1641.4067245483398,1,4,0,16,36392,4
100115,Toys,14.766850471496582,2023-04-19,33,59,12.269422149658203,1126.9818618774414,2,4,0,16,36425,4
100115,Toys,14.766850471496582,2023-04-20,26,0,12.338844299316406,320.80995178222656,3,4,0,16,36451,4
100115,Toys,14.766850471496582,2023-04-21,22,0,12.338844299316406,271.45457458496094,4,4,0,16,36473,4
100115,Toys,14.766850471496582,2023-04-22,33,50,11.912217006683349,985.4463224411011,5,4,1,16,36506,4
100115,Toys,14.766850471496582,2023-04-23,31,0,12.1044340133667,375.2374544143677,6,4,1,16,36537,4
100115,Toys,14.766850471496582,2023-04-24,37,50,12.73483669281006,1111.2479152679443,0,4,0,17,36574,4
100115,Toys,14.766850471496582,2023-04-25,4,0,12.479673385620117,49.91869354248047,1,4,0,17,36578,4
100115,Toys,14.766850471496582,2023-04-26,6,0,12.479673385620117,74.8780403137207,2,4,0,17,36584,4
100115,Toys,14.766850471496582,2023-04-27,15,50,11.490647830963134,732.519434928894,3,4,0,17,36599,4
100115,Toys,14.766850471496582,2023-04-28,27,0,11.90129566192627,321.3349828720093,4,4,0,17,36626,4
100115,Toys,14.766850471496582,2023-04-29,36,50,12.510939254760743,1079.7076263427734,5,4,1,17,36662,4
100115,Toys,14.766850471496582,2023-04-30,26,50,12.058408126831054,914.3172225952148,6,4,1,17,36688,4
100115,Toys,14.766850471496582,2023-05-01,9,0,12.14681625366211,109.32134628295898,0,5,0,18,36697,4
100115,Toys,14.766850471496582,2023-05-02,108,97,12.767892951965333,2614.9748776245115,1,5,0,18,36805,4
100115,Toys,14.766850471496582,2023-05-03,44,50,12.046058559417725,1130.8531532287598,2,5,0,18,36849,4
100115,Toys,14.766850471496582,2023-05-04,19,0,12.29211711883545,233.55022525787354,3,5,0,18,36868,4
100115,Toys,14.766850471496582,2023-05-05,58,83,14.101909618377686,2003.5715157318116,4,5,0,18,36926,4
100115,Toys,14.766850471496582,2023-05-06,17,0,13.493819236755371,229.3949270248413,5,5,1,18,36943,4
100115,Toys,14.766850471496582,2023-05-07,24,0,13.493819236755371,323.8516616821289,6,5,1,18,36967,4
100115,Toys,14.766850471496582,2023-05-08,58,50,13.569405364990235,1465.2510223388672,0,5,0,19,37025,4
100115,Toys,14.766850471496582,2023-05-09,44,50,12.637857341766358,1185.9314460754395,1,5,0,19,37069,4
100115,Toys,14.766850471496582,2023-05-10,28,50,11.805332584381103,910.5786247253418,2,5,0,19,37097,4
100115,Toys,14.766850471496582,2023-05-11,54,56,12.83270315170288,1412.0919403839112,3,5,0,19,37151,4
100115,Toys,14.766850471496582,2023-05-12,21,50,11.733523406982421,821.3779830932617,4,5,0,19,37172,4
100115,Toys,14.766850471496582,2023-05-13,119,115,15.278757858276368,3570.9443702697754,5,5,1,19,37291,4
100115,Toys,14.766850471496582,2023-05-14,107,127,14.88031904220581,3486.1882750320437,6,5,1,19,37398,4
100115,Toys,14.766850471496582,2023-05-15,29,0,14.670638084411621,425.448504447937,0,5,0,20,37427,4
100115,Toys,14.766850471496582,2023-05-16,73,110,13.794786338806151,2513.908805465698,1,5,0,20,37500,4
100115,Toys,14.766850471496582,2023-05-17,70,0,14.079572677612305,985.5700874328613,2,5,0,20,37570,4
100115,Toys,14.766850471496582,2023-05-18,73,139,16.339903144836427,3495.085859146118,3,5,0,20,37643,4
100115,Toys,14.766850471496582,2023-05-19,110,125,16.20148292541504,3809.1262435913086,4,5,0,20,37753,4
100115,Toys,14.766850471496582,2023-05-20,22,0,16.082965850830078,353.8252487182617,5,5,1,20,37775,4
100115,Toys,14.766850471496582,2023-05-21,110,138,16.69272548675537,4145.319607086181,6,5,1,20,37885,4
100115,Toys,14.766850471496582,2023-05-22,47,0,16.495450973510742,775.2861957550049,0,5,0,21,37932,4
100115,Toys,14.766850471496582,2023-05-23,81,87,15.601840019226074,2618.998083114624,1,5,0,21,38013,4
100115,Toys,14.766850471496582,2023-05-24,81,78,16.02788808822632,2548.3378702926634,2,5,0,21,38094,4
100115,Toys,14.766850471496582,2023-05-25,116,115,15.901580390930175,3673.296650695801,3,5,0,21,38210,4
100115,Toys,14.766850471496582,2023-05-26,99,118,18.03979228973389,3927.7488733673094,4,5,0,21,38309,4
100115,Toys,14.766850471496582,2023-05-27,134,105,14.874235229492188,3582.9050415039064,5,5,1,21,38443,4
100115,Toys,14.766850471496582,2023-05-28,105,149,16.180805931091307,4113.849245529174,6,5,1,21,38548,4
100115,Toys,14.766850471496582,2023-05-29,131,143,17.997260284423827,4939.082194519043,0,5,0,22,38679,4
100115,Toys,14.766850471496582,2023-05-30,79,0,17.344520568847656,1370.2171249389648,1,5,0,22,38758,4
100115,Toys,14.766850471496582,2023-05-31,82,138,19.244751777648926,4258.219291534424,2,5,0,22,38840,4
100115,Toys,14.766850471496582,2023-06-01,71,108,16.831201820373536,2984.2506584930416,3,6,0,22,38911,4
100115,Toys,14.766850471496582,2023-06-02,70,0,17.60240364074707,1232.168254852295,4,6,0,22,38981,4
100115,Toys,14.766850471496582,2023-06-03,78,84,15.672334518432617,2534.464184875488,5,6,1,22,39059,4
100115,Toys,14.766850471496582,2023-06-04,71,67,14.580837726593018,2015.4789571762085,6,6,1,22,39130,4
100115,Toys,14.766850471496582,2023-06-05,107,114,16.585178833007813,3667.948270263672,0,6,0,23,39237,4
100115,Toys,14.766850471496582,2023-06-06,88,66,14.980113105773926,2319.479906616211,1,6,0,23,39325,4
100115,Toys,14.766850471496582,2023-06-07,92,77,13.977990455627442,2371.100243835449,2,6,0,23,39417,4
100115,Toys,14.766850471496582,2023-06-08,77,102,15.683716411590577,2815.0423273849487,3,6,0,23,39494,4
100115,Toys,14.766850471496582,2023-06-09,102,127,15.86912286758423,3637.551064987183,4,6,0,23,39596,4
100115,Toys,14.766850471496582,2023-06-10,127,154,16.286899185180665,4581.022393035888,5,6,1,23,39723,4
100115,Toys,14.766850471496582,2023-06-11,63,0,16.123798370361328,1015.7992973327637,6,6,1,23,39786,4
100115,Toys,14.766850471496582,2023-06-12,91,130,16.891076011657717,3740.685834121704,0,6,0,24,39877,4
100115,Toys,14.766850471496582,2023-06-13,102,120,15.735959243774413,3487.3356857299805,1,6,0,24,39979,4
100115,Toys,14.766850471496582,2023-06-14,148,160,15.531045608520508,4781.509500122071,2,6,0,24,40127,4
100115,Toys,14.766850471496582,2023-06-15,119,119,18.03296504974365,4291.84568183899,3,6,0,24,40246,4
100115,Toys,14.766850471496582,2023-06-16,83,0,17.095930099487305,1418.9621982574463,4,6,0,24,40329,4
100115,Toys,14.766850471496582,2023-06-17,77,62,15.356390686035155,2144.534165649414,5,6,1,24,40406,4
100115,Toys,14.766850471496582,2023-06-18,62,153,18.878820114135742,4102.733694152832,6,6,1,24,40468,4
100115,Toys,14.766850471496582,2023-06-19,131,249,17.92992416381836,6800.40013092041,0,6,0,25,40599,4
100115,Toys,14.766850471496582,2023-06-20,68,0,18.03984832763672,1226.7096862792969,1,6,0,25,40667,4
100115,Toys,14.766850471496582,2023-06-21,75,0,18.03984832763672,1352.988624572754,2,6,0,25,40742,4
100115,Toys,14.766850471496582,2023-06-22,113,110,16.475421142578124,3675.7451782226562,3,6,0,25,40855,4
100115,Toys,14.766850471496582,2023-06-23,125,161,17.26899532318115,4941.128830795287,4,6,0,25,40980,4
100115,Toys,14.766850471496582,2023-06-24,103,96,15.712211265563965,3131.505520706177,5,6,1,25,41083,4
100115,Toys,14.766850471496582,2023-06-25,77,0,16.39442253112793,1262.3705348968506,6,6,1,25,41160,4
100115,Toys,14.766850471496582,2023-06-26,77,151,19.27480381011963,4437.959786758423,0,6,0,26,41237,4
100115,Toys,14.766850471496582,2023-06-27,49,0,18.689607620239258,915.7907733917236,1,6,0,26,41286,4
100115,Toys,14.766850471496582,2023-06-28,78,117,14.539771690368653,2786.12438369751,2,6,0,26,41364,4
100115,Toys,14.766850471496582,2023-06-29,75,0,15.799543380737305,1184.9657535552979,3,6,0,26,41439,4
100115,Toys,14.766850471496582,2023-06-30,48,50,13.31702522277832,1303.0944213867188,4,6,0,26,41487,4
100115,Toys,14.766850471496582,2023-07-01,48,75,14.339074897766114,1764.0011901855469,5,7,1,26,41535,4
100115,Toys,14.766850471496582,2023-07-02,88,140,14.010476913452148,3190.203936767578,6,7,1,26,41623,4
100115,Toys,14.766850471496582,2023-07-03,125,178,16.89927707672119,5163.979269180298,0,7,0,27,41748,4
100115,Toys,14.766850471496582,2023-07-04,155,150,15.59387273788452,4757.100548744202,1,7,0,27,41903,4
100115,Toys,14.766850471496582,2023-07-05,72,0,15.787745475769043,1136.717674255371,2,7,0,27,41975,4
100115,Toys,14.766850471496582,2023-07-06,47,0,15.787745475769043,742.024037361145,3,7,0,27,42022,4
100115,Toys,14.766850471496582,2023-07-07,76,101,13.677029895782471,2406.4085441589355,4,7,0,27,42098,4
100115,Toys,14.766850471496582,2023-07-08,80,130,14.680649662017823,3088.9039459228516,5,7,1,27,42178,4
100115,Toys,14.766850471496582,2023-07-09,130,135,15.877807903289796,4209.980054855347,6,7,1,27,42308,4
100115,Toys,14.766850471496582,2023-07-10,156,177,19.122937088012698,6391.816371459961,0,7,0,28,42464,4
100115,Toys,14.766850471496582,2023-07-11,52,0,17.98587417602539,935.2654571533203,1,7,0,28,42516,4
100115,Toys,14.766850471496582,2023-07-12,108,115,16.975696144104006,3783.090367126465,2,7,0,28,42624,4
100115,Toys,14.766850471496582,2023-07-13,70,94,16.785273818969728,2747.3783346557616,3,7,0,28,42694,4
100115,Toys,14.766850471496582,2023-07-14,72,0,17.010547637939453,1224.7594299316406,4,7,0,28,42766,4
100115,Toys,14.766850471496582,2023-07-15,56,85,15.567295951843262,2181.1471466064454,5,7,1,28,42822,4
100115,Toys,14.766850471496582,2023-07-16,68,64,12.903019275665283,1709.0906214904785,6,7,1,28,42890,4
100115,Toys,14.766850471496582,2023-07-17,59,50,13.609679679870606,1487.0522022247314,0,7,0,29,42949,4
100115,Toys,14.766850471496582,2023-07-18,95,106,16.42557249069214,3310.058773231506,1,7,0,29,43044,4
100115,Toys,14.766850471496582,2023-07-19,57,84,13.933403015136719,1946.157943725586,2,7,0,29,43101,4
100115,Toys,14.766850471496582,2023-07-20,131,113,15.895296993255615,3869.727812232971,3,7,0,29,43232,4
100115,Toys,14.766850471496582,2023-07-21,103,106,14.785821228027345,3089.559172973633,4,7,0,29,43335,4
100115,Toys,14.766850471496582,2023-07-22,59,89,15.344132175445557,2275.007596702576,5,7,1,29,43394,4
100115,Toys,14.766850471496582,2023-07-23,89,0,15.208264350891113,1353.535527229309,6,7,1,29,43483,4
100115,Toys,14.766850471496582,2023-07-24,64,107,16.510259895324708,2836.1432666015626,0,7,0,30,43547,4
100115,Toys,14.766850471496582,2023-07-25,58,78,14.703231258392334,1987.3748259735107,1,7,0,30,43605,4
100115,Toys,14.766850471496582,2023-07-26,35,0,15.316462516784668,536.0761880874634,2,7,0,30,43640,4
100115,Toys,14.766850471496582,2023-07-27,51,62,15.045436706542969,1698.8645440673827,3,7,0,30,43691,4
100115,Toys,14.766850471496582,2023-07-28,103,150,17.915869293212893,4565.8090744018555,4,7,0,30,43794,4
100115,Toys,14.766850471496582,2023-07-29,108,139,18.669205513000488,4627.128390808106,5,7,1,30,43902,4
100115,Toys,14.766850471496582,2023-07-30,114,163,18.77859401702881,5212.519435882568,6,7,1,30,44016,4
100115,Toys,14.766850471496582,2023-07-31,23,0,18.557188034057617,426.8153247833252,0,7,0,31,44039,4
100115,Toys,14.766850471496582,2023-08-01,207,223,21.034649047851563,9057.464705810547,1,8,0,31,44246,4
100115,Toys,14.766850471496582,2023-08-02,57,0,20.249298095703125,1154.2099914550781,2,8,0,31,44303,4
100115,Toys,14.766850471496582,2023-08-03,88,123,17.44848361968994,3642.13311706543,3,8,0,31,44391,4
100115,Toys,14.766850471496582,2023-08-04,131,202,19.637618179321287,6564.345962982177,4,8,0,31,44522,4
100115,Toys,14.766850471496582,2023-08-05,63,0,19.285236358642578,1214.9698905944824,5,8,1,31,44585,4
100115,Toys,14.766850471496582,2023-08-06,69,0,19.285236358642578,1330.681308746338,6,8,1,31,44654,4
100115,Toys,14.766850471496582,2023-08-07,54,69,16.47515132904053,2005.216343536377,0,8,0,32,44708,4
100115,Toys,14.766850471496582,2023-08-08,53,0,17.890302658081055,948.1860408782959,1,8,0,32,44761,4
100115,Toys,14.766850471496582,2023-08-09,43,67,15.34157096862793,1661.1351033020019,2,8,0,32,44804,4
100115,Toys,14.766850471496582,2023-08-10,109,177,16.115900650024415,4603.306341705323,3,8,0,32,44913,4
100115,Toys,14.766850471496582,2023-08-11,56,0,16.201801300048828,907.3008728027344,4,8,0,32,44969,4
100115,Toys,14.766850471496582,2023-08-12,28,0,16.201801300048828,453.6504364013672,5,8,1,32,44997,4
100115,Toys,14.766850471496582,2023-08-13,73,117,13.707573013305664,2569.345659942627,6,8,1,32,45070,4
100115,Toys,14.766850471496582,2023-08-14,95,91,15.550759925842286,2890.524385910034,0,8,0,33,45165,4
100115,Toys,14.766850471496582,2023-08-15,37,0,15.07151985168457,557.6462345123291,1,8,0,33,45202,4
100115,Toys,14.766850471496582,2023-08-16,113,155,14.98351095199585,4014.593475151062,2,8,0,33,45315,4
100115,Toys,14.766850471496582,2023-08-17,77,0,15.0070219039917,1155.5406866073608,3,8,0,33,45392,4
100115,Toys,14.766850471496582,2023-08-18,78,237,18.21648880004883,5810.302252807617,4,8,0,33,45470,4
100115,Toys,14.766850471496582,2023-08-19,158,0,17.762977600097656,2806.5504608154297,5,8,1,33,45628,4
100115,Toys,14.766850471496582,2023-08-20,79,117,15.44503849029541,3004.9960814666747,6,8,1,33,45707,4
100115,Toys,14.766850471496582,2023-08-21,63,118,16.968848838806153,3088.474953689575,0,8,0,34,45770,4
100115,Toys,14.766850471496582,2023-08-22,33,0,16.657697677612305,549.704023361206,1,8,0,34,45803,4
100115,Toys,14.766850471496582,2023-08-23,76,112,14.280338344573973,2651.9314283752437,2,8,0,34,45879,4
100115,Toys,14.766850471496582,2023-08-24,28,0,15.19067668914795,425.3389472961426,3,8,0,34,45907,4
100115,Toys,14.766850471496582,2023-08-25,67,98,15.6382027053833,2586.2491625213625,4,8,0,34,45974,4
100115,Toys,14.766850471496582,2023-08-26,56,0,15.446405410766602,864.9987030029297,5,8,1,34,46030,4
100115,Toys,14.766850471496582,2023-08-27,85,106,16.357284278869628,3131.2283274078372,6,8,1,34,46115,4
100115,Toys,14.766850471496582,2023-08-28,143,175,19.214675254821778,6139.877122879028,0,8,0,35,46258,4
100115,Toys,14.766850471496582,2023-08-29,127,124,17.391464958190916,4366.372099380493,1,8,0,35,46385,4
100115,Toys,14.766850471496582,2023-08-30,72,0,17.762929916381836,1278.9309539794922,2,8,0,35,46457,4
100115,Toys,14.766850471496582,2023-08-31,63,85,15.082683486938476,2210.398119354248,3,8,0,35,46520,4
100115,Toys,14.766850471496582,2023-09-01,49,69,14.758101291656494,1729.0939265823365,4,9,0,35,46569,4
100115,Toys,14.766850471496582,2023-09-02,71,70,12.931181049346923,1824.5277090072632,5,9,1,35,46640,4
100115,Toys,14.766850471496582,2023-09-03,106,132,18.396050033569338,4416.582607116699,6,9,1,35,46746,4
100115,Toys,14.766850471496582,2023-09-04,40,0,16.922100067138672,676.8840026855469,0,9,0,36,46786,4
100115,Toys,14.766850471496582,2023-09-05,67,87,16.266580696105958,2499.5218132781984,1,9,0,36,46853,4
100115,Toys,14.766850471496582,2023-09-06,142,192,18.39683540344238,6170.201254577637,2,9,0,36,46995,4
100115,Toys,14.766850471496582,2023-09-07,78,0,17.883670806884766,1394.9263229370117,3,9,0,36,47073,4
100115,Toys,14.766850471496582,2023-09-08,79,91,15.494540596008301,2622.7374141693117,4,9,0,36,47152,4
100115,Toys,14.766850471496582,2023-09-09,119,113,16.00081912994385,3713.154952926636,5,9,1,36,47271,4
100115,Toys,14.766850471496582,2023-09-10,125,184,18.673195152282716,5807.588788070679,6,9,1,36,47396,4
100115,Toys,14.766850471496582,2023-09-11,59,0,18.03639030456543,1064.1470279693604,0,9,0,37,47455,4
100115,Toys,14.766850471496582,2023-09-12,80,84,16.61597812652588,2722.5965002441408,1,9,0,37,47535,4
100115,Toys,14.766850471496582,2023-09-13,72,85,15.767505950927735,2467.340856933594,2,9,0,37,47607,4
100115,Toys,14.766850471496582,2023-09-14,142,223,19.87870059967041,7323.870970306396,3,9,0,37,47749,4
100115,Toys,14.766850471496582,2023-09-15,51,0,19.03740119934082,970.9074611663818,4,9,0,37,47800,4
100115,Toys,14.766850471496582,2023-09-16,80,0,19.03740119934082,1522.9920959472656,5,9,1,37,47880,4
100115,Toys,14.766850471496582,2023-09-17,91,86,15.657755126953125,2777.3114331054685,6,9,1,37,47971,4
100115,Toys,14.766850471496582,2023-09-18,68,119,15.111503314971923,2802.314450836182,0,9,0,38,48039,4
100115,Toys,14.766850471496582,2023-09-19,110,105,15.298754901885985,3289.776078414917,1,9,0,38,48149,4
100115,Toys,14.766850471496582,2023-09-20,73,94,15.911274967193604,2661.5661452102663,2,9,0,38,48222,4
100115,Toys,14.766850471496582,2023-09-21,131,137,16.96555419921875,4549.495200195313,3,9,0,38,48353,4
100115,Toys,14.766850471496582,2023-09-22,119,135,15.191147899627685,3850.693200111389,4,9,0,38,48472,4
100115,Toys,14.766850471496582,2023-09-23,176,206,16.504036903381348,6311.920989990234,5,9,1,38,48648,4
100115,Toys,14.766850471496582,2023-09-24,76,0,16.258073806762695,1235.6136093139648,6,9,1,38,48724,4
100115,Toys,14.766850471496582,2023-09-25,104,110,15.632394981384277,3343.9381561279297,0,9,0,39,48828,4
100115,Toys,14.766850471496582,2023-09-26,130,115,17.428827171325686,4261.345064544677,1,9,0,39,48958,4
100115,Toys,14.766850471496582,2023-09-27,98,108,14.009162063598634,2875.695764465332,2,9,0,39,49056,4
100115,Toys,14.766850471496582,2023-09-28,104,92,13.101368808746338,2577.4847122192386,3,9,0,39,49160,4
100115,Toys,14.766850471496582,2023-09-29,100,95,15.43854154586792,3007.5583091735843,4,9,0,39,49260,4
100115,Toys,14.766850471496582,2023-09-30,64,75,13.612929859161376,1886.3350219726562,5,9,1,39,49324,4
100115,Toys,14.766850471496582,2023-10-01,103,102,12.699520778656005,2603.9512804031374,6,10,1,39,49427,4
100115,Toys,14.766850471496582,2023-10-02,47,66,14.421898002624513,1640.4684122467042,0,10,0,40,49474,4
100115,Toys,14.766850471496582,2023-10-03,124,134,16.13596185684204,4171.018540496826,1,10,0,40,49598,4
100115,Toys,14.766850471496582,2023-10-04,103,106,15.453309535980225,3229.8817644119263,2,10,0,40,49701,4
100115,Toys,14.766850471496582,2023-10-05,55,0,15.40661907196045,847.3640489578247,3,10,0,40,49756,4
100115,Toys,14.766850471496582,2023-10-06,83,99,15.035396175384522,2734.4357651138307,4,10,0,40,49839,4
100115,Toys,14.766850471496582,2023-10-07,46,85,14.513769149780273,1891.0167617797852,5,10,1,40,49885,4
100115,Toys,14.766850471496582,2023-10-08,7,0,14.777538299560547,103.44276809692383,6,10,1,40,49892,4
100115,Toys,14.766850471496582,2023-10-09,79,103,14.793359661102295,2692.5508264541627,0,10,0,41,49971,4
100115,Toys,14.766850471496582,2023-10-10,66,0,14.78671932220459,975.9234752655029,1,10,0,41,50037,4
100115,Toys,14.766850471496582,2023-10-11,38,0,14.78671932220459,561.8953342437744,2,10,0,41,50075,4
100115,Toys,14.766850471496582,2023-10-12,19,50,12.296653881072999,816.9528474807739,3,10,0,41,50094,4
100115,Toys,14.766850471496582,2023-10-13,33,50,13.597769374847413,1131.0327787399292,4,10,0,41,50127,4
100115,Toys,14.766850471496582,2023-10-14,30,0,13.455538749694824,403.6661624908447,5,10,1,41,50157,4
100115,Toys,14.766850471496582,2023-10-15,41,50,11.786503200531005,1065.5832624435425,6,10,1,41,50198,4
100115,Toys,14.766850471496582,2023-10-16,8,0,12.563006401062012,100.5040512084961,0,10,0,42,50206,4
100115,Toys,14.766850471496582,2023-10-17,50,69,14.000333099365236,1676.6733099365233,1,10,0,42,50256,4
100115,Toys,14.766850471496582,2023-10-18,31,0,13.440666198730469,416.66065216064453,2,10,0,42,50287,4
100115,Toys,14.766850471496582,2023-10-19,20,50,12.790676956176757,886.9270782470703,3,10,0,42,50307,4
100115,Toys,14.766850471496582,2023-10-20,34,0,13.071353912353516,444.42603302001953,4,10,0,42,50341,4
100115,Toys,14.766850471496582,2023-10-21,4,0,13.071353912353516,52.28541564941406,5,10,1,42,50345,4
100115,Toys,14.766850471496582,2023-10-22,11,50,10.123271312713623,570.9819688796997,6,10,1,42,50356,4
100115,Toys,14.766850471496582,2023-10-23,23,0,11.316542625427246,260.28048038482666,0,10,0,43,50379,4
100115,Toys,14.766850471496582,2023-10-24,29,50,10.213543395996094,796.2955169677734,1,10,0,43,50408,4
100115,Toys,14.766850471496582,2023-10-25,31,0,10.717086791992188,332.2296905517578,2,10,0,43,50439,4
100115,Toys,14.766850471496582,2023-10-26,74,139,13.17357847213745,2839.5396138763426,3,10,0,43,50513,4
100115,Toys,14.766850471496582,2023-10-27,60,0,12.657156944274902,759.4294166564941,4,10,0,43,50573,4
100115,Toys,14.766850471496582,2023-10-28,79,170,17.337540969848632,4397.351473236084,5,10,1,43,50652,4
100115,Toys,14.766850471496582,2023-10-29,117,0,16.455081939697266,1925.24458694458,6,10,1,43,50769,4
100115,Toys,14.766850471496582,2023-10-30,53,132,18.23278202056885,3396.544894180298,0,10,0,44,50822,4
100115,Toys,14.766850471496582,2023-10-31,33,0,17.935564041137695,591.873613357544,1,10,0,44,50855,4
100115,Toys,14.766850471496582,2023-11-01,50,65,13.798508529663085,1560.0008529663087,2,11,0,44,50905,4
100115,Toys,14.766850471496582,2023-11-02,78,70,13.442499866485596,1997.1899791717528,3,11,0,44,50983,4
100115,Toys,14.766850471496582,2023-11-03,35,0,14.404999732971191,504.1749906539917,4,11,0,44,51018,4
100115,Toys,14.766850471496582,2023-11-04,71,101,15.107340354919433,2603.9423303985595,5,11,1,44,51089,4
100115,Toys,14.766850471496582,2023-11-05,78,86,15.059953861236572,2470.2328023529053,6,11,1,44,51167,4
100115,Toys,14.766850471496582,2023-11-06,65,94,14.958768100738524,2377.899853096008,0,11,0,45,51232,4
100115,Toys,14.766850471496582,2023-11-07,138,143,18.502668571472167,5204.986525726318,1,11,0,45,51370,4
100115,Toys,14.766850471496582,2023-11-08,143,129,18.213847885131834,4949.880495147705,2,11,0,45,51513,4
100115,Toys,14.766850471496582,2023-11-09,90,107,16.52865016937256,3247.3270304870607,3,11,0,45,51603,4
100115,Toys,14.766850471496582,2023-11-10,51,0,17.047300338745117,869.412317276001,4,11,0,45,51654,4
100115,Toys,14.766850471496582,2023-11-11,95,123,14.750008277893066,3197.5815727996824,5,11,1,45,51749,4
100115,Toys,14.766850471496582,2023-11-12,96,92,16.225330142974855,3049.023387451172,6,11,1,45,51845,4
100115,Toys,14.766850471496582,2023-11-13,48,69,15.480102558135986,1807.1798455810547,0,11,0,46,51893,4
100115,Toys,14.766850471496582,2023-11-14,84,101,16.507321166992188,3059.679956054688,1,11,0,46,51977,4
100115,Toys,14.766850471496582,2023-11-15,83,0,16.164642333984375,1341.6653137207031,2,11,0,46,52060,4
100115,Toys,14.766850471496582,2023-11-16,74,96,15.934127864837645,2707.3909239959717,3,11,0,46,52134,4
100115,Toys,14.766850471496582,2023-11-17,77,55,15.446929187774657,2044.6470949172972,4,11,0,46,52211,4
100115,Toys,14.766850471496582,2023-11-18,74,99,15.252732696533204,2635.654439086914,5,11,1,46,52285,4
100115,Toys,14.766850471496582,2023-11-19,99,187,19.97690746307373,5798.147677688599,6,11,1,46,52384,4
100115,Toys,14.766850471496582,2023-11-20,44,0,19.01381492614746,836.6078567504883,0,11,0,47,52428,4
100115,Toys,14.766850471496582,2023-11-21,143,149,16.48877712249756,4809.810257034302,1,11,0,47,52571,4
100115,Toys,14.766850471496582,2023-11-22,47,0,17.307554244995117,813.4550495147705,2,11,0,47,52618,4
100115,Toys,14.766850471496582,2023-11-23,102,143,16.92149082183838,4141.6041276550295,3,11,0,47,52720,4
100115,Toys,14.766850471496582,2023-11-24,131,152,16.9222310256958,4788.3145287323005,4,11,0,47,52851,4
100115,Toys,14.766850471496582,2023-11-25,60,0,16.9544620513916,1017.2677230834961,5,11,1,47,52911,4
100115,Toys,14.766850471496582,2023-11-26,104,163,17.611168632507322,4711.553075561524,6,11,1,47,53015,4
100115,Toys,14.766850471496582,2023-11-27,118,123,14.805036544799805,3562.738624572754,0,11,0,48,53133,4
100115,Toys,14.766850471496582,2023-11-28,56,0,15.86007308959961,888.1640930175781,1,11,0,48,53189,4
100115,Toys,14.766850471496582,2023-11-29,89,147,16.02461067199707,3784.4406996154785,2,11,0,48,53278,4
100115,Toys,14.766850471496582,2023-11-30,33,0,15.97922134399414,527.3143043518066,3,11,0,48,53311,4
100115,Toys,14.766850471496582,2023-12-01,60,71,15.027387886047364,1963.4465463256836,4,12,0,48,53371,4
100115,Toys,14.766850471496582,2023-12-02,148,171,15.452706546783446,4929.1211378479,5,12,1,48,53519,4
100115,Toys,14.766850471496582,2023-12-03,101,0,15.465413093566895,1562.0067224502563,6,12,1,48,53620,4
100115,Toys,14.766850471496582,2023-12-04,70,130,16.08794771194458,3225.512679672241,0,12,0,49,53690,4
100115,Toys,14.766850471496582,2023-12-05,54,0,15.95589542388916,861.6183528900146,1,12,0,49,53744,4
100115,Toys,14.766850471496582,2023-12-06,76,59,13.041659545898437,1780.0322509765624,2,12,0,49,53820,4
100115,Toys,14.766850471496582,2023-12-07,44,53,13.959892215728761,1353.3905149841307,3,12,0,49,53864,4
100115,Toys,14.766850471496582,2023-12-08,68,70,15.253280353546142,2105.7461280822754,4,12,0,49,53932,4
100115,Toys,14.766850471496582,2023-12-09,60,76,13.992462978363037,1898.6155574035645,5,12,1,49,53992,4
100115,Toys,14.766850471496582,2023-12-10,60,82,14.015724983215332,1988.3469979858398,6,12,1,49,54052,4
100115,Toys,14.766850471496582,2023-12-11,90,88,14.049685134887696,2500.883324279785,0,12,0,50,54142,4
100115,Toys,14.766850471496582,2023-12-12,106,112,15.583608303070069,3400.1449602508546,1,12,0,50,54248,4
100115,Toys,14.766850471496582,2023-12-13,35,0,15.097216606140137,528.4025812149048,2,12,0,50,54283,4
100115,Toys,14.766850471496582,2023-12-14,63,92,14.033744678497314,2166.1318294906614,3,12,0,50,54346,4
100115,Toys,14.766850471496582,2023-12-15,38,50,13.867159900665282,1217.3441524505615,4,12,0,50,54384,4
100115,Toys,14.766850471496582,2023-12-16,116,115,15.037102508544923,3473.257781982422,5,12,1,50,54500,4
100115,Toys,14.766850471496582,2023-12-17,59,68,12.642627086639404,1596.9499962234497,6,12,1,50,54559,4
100115,Toys,14.766850471496582,2023-12-18,73,118,15.544881210327148,2999.4526567077637,0,12,0,51,54632,4
100115,Toys,14.766850471496582,2023-12-19,115,132,17.15978458404541,4253.770454330444,1,12,0,51,54747,4
100115,Toys,14.766850471496582,2023-12-20,25,0,16.25956916809082,406.4892292022705,2,12,0,51,54772,4
100115,Toys,14.766850471496582,2023-12-21,110,100,15.3903226852417,3235.870990753174,3,12,0,51,54882,4
100115,Toys,14.766850471496582,2023-12-22,95,151,17.463962211608887,4327.832820205689,4,12,0,51,54977,4
100115,Toys,14.766850471496582,2023-12-23,92,0,16.897924423217773,1554.6090469360352,5,12,1,51,55069,4
100115,Toys,14.766850471496582,2023-12-24,84,89,16.756207084655763,2898.542790222168,6,12,1,51,55153,4
100115,Toys,14.766850471496582,2023-12-25,108,89,15.46709629058838,3057.41279876709,0,12,0,52,55261,4
100115,Toys,14.766850471496582,2023-12-26,79,92,17.063441009521483,2922.7436795043945,1,12,0,52,55340,4
100115,Toys,14.766850471496582,2023-12-27,61,56,14.03778573989868,1649.159860267639,2,12,0,52,55401,4
100115,Toys,14.766850471496582,2023-12-28,35,0,15.385571479797363,538.4950017929077,3,12,0,52,55436,4
100115,Toys,14.766850471496582,2023-12-29,45,50,14.327076969146727,1358.7869272232056,4,12,0,52,55481,4
100115,Toys,14.766850471496582,2023-12-30,29,50,13.558497791290282,1059.6028718948364,5,12,1,52,55510,4
100115,Toys,14.766850471496582,2023-12-31,72,74,14.272481842041016,2083.917385253906,6,12,1,52,55582,4
100115,Toys,14.766850471496582,2024-01-01,14,0,14.204963684082031,198.86949157714844,0,1,0,1,55596,4
100115,Toys,14.766850471496582,2024-01-02,21,0,14.204963684082031,298.30423736572266,1,1,0,1,55617,4
100115,Toys,14.766850471496582,2024-01-03,29,50,11.744548435211183,906.7238092422485,2,1,0,1,55646,4
100115,Toys,14.766850471496582,2024-01-04,7,0,12.749096870422363,89.24367809295654,3,1,0,1,55653,4
100115,Toys,14.766850471496582,2024-01-05,44,70,13.777304248809815,1580.5627738952637,4,1,0,1,55697,4
100115,Toys,14.766850471496582,2024-01-06,44,50,13.43758581161499,1263.2675514221191,5,1,1,1,55741,4
100115,Toys,14.766850471496582,2024-01-07,6,0,13.41517162322998,80.49102973937988,6,1,1,1,55747,4
100115,Toys,14.766850471496582,2024-01-08,18,0,13.41517162322998,241.47308921813965,0,1,0,2,55765,4
100115,Toys,14.766850471496582,2024-01-09,91,128,13.743814029693603,3013.0841534042356,1,1,0,2,55856,4
100115,Toys,14.766850471496582,2024-01-10,62,104,15.752104187011719,2648.360919189453,2,1,0,2,55918,4
100115,Toys,14.766850471496582,2024-01-11,75,0,14.954208374023438,1121.5656280517578,3,1,0,2,55993,4
100115,Toys,14.766850471496582,2024-01-12,95,129,14.769664630889892,3306.7162798690797,4,1,0,2,56088,4
100115,Toys,14.766850471496582,2024-01-13,114,142,16.054268569946288,4120.6932339477535,5,1,1,2,56202,4
100115,Toys,14.766850471496582,2024-01-14,89,128,17.118720016479493,3736.26216293335,6,1,1,2,56291,4
100115,Toys,14.766850471496582,2024-01-15,102,0,16.567440032958984,1689.8788833618164,0,1,0,3,56393,4
100115,Toys,14.766850471496582,2024-01-16,94,88,16.925382995605467,3079.672003173828,1,1,0,3,56487,4
100115,Toys,14.766850471496582,2024-01-17,81,102,15.762809371948242,2878.025118255615,2,1,0,3,56568,4
100115,Toys,14.766850471496582,2024-01-18,69,83,14.732401943206787,2231.8714681625365,3,1,0,3,56637,4
100115,Toys,14.766850471496582,2024-01-19,84,66,15.720293254852294,2354.0892668151855,4,1,0,3,56721,4
100115,Toys,14.766850471496582,2024-01-20,105,174,16.344411392211914,4573.586392364502,5,1,1,3,56826,4
100115,Toys,14.766850471496582,2024-01-21,167,143,16.93327259063721,5242.193045272827,6,1,1,3,56993,4
100115,Toys,14.766850471496582,2024-01-22,54,0,16.636545181274414,898.3734397888184,0,1,0,4,57047,4
100115,Toys,14.766850471496582,2024-01-23,96,110,17.16074863433838,3537.3437377929686,1,1,0,4,57143,4
100115,Toys,14.766850471496582,2024-01-24,96,90,16.11591209411621,2999.5751220703123,2,1,0,4,57239,4
100115,Toys,14.766850471496582,2024-01-25,104,149,19.342232627868654,4927.2343865966795,3,1,0,4,57343,4
100115,Toys,14.766850471496582,2024-01-26,149,156,15.832648010253905,4822.7091070556635,4,1,0,4,57492,4
100115,Toys,14.766850471496582,2024-01-27,123,122,15.462493286132812,3788.803348388672,5,1,1,4,57615,4
100115,Toys,14.766850471496582,2024-01-28,89,0,15.954986572265625,1419.9938049316406,6,1,1,4,57704,4
100115,Toys,14.766850471496582,2024-01-29,58,72,15.677279396057129,2036.824409942627,0,1,0,5,57762,4
100115,Toys,14.766850471496582,2024-01-30,63,90,14.323425235748292,2179.5115797042845,1,1,0,5,57825,4
100116,Groceries,45.46712112426758,2022-01-01,78,475,38.79000045776367,21450.870071411133,5,1,1,52,78,3
100116,Groceries,45.46712112426758,2022-01-02,25,0,38.790000915527344,969.7500228881836,6,1,1,52,103,3
100116,Groceries,45.46712112426758,2022-01-03,0,553,45.61,25222.329999999998,0,1,0,1,103,3
100116,Groceries,45.46712112426758,2022-01-04,100,0,42.86725616455078,4286.725616455078,1,1,0,1,203,3
100116,Groceries,45.46712112426758,2022-01-05,140,0,42.86725616455078,6001.415863037109,2,1,0,1,343,3
100116,Groceries,45.46712112426758,2022-01-06,71,0,42.86725616455078,3043.5751876831055,3,1,0,1,414,3
100116,Groceries,45.46712112426758,2022-01-07,148,0,42.86725616455078,6344.353912353516,4,1,0,1,562,3
100116,Groceries,45.46712112426758,2022-01-08,161,508,38.31226867675781,25133.910513916016,5,1,1,1,723,3
100116,Groceries,45.46712112426758,2022-01-09,131,0,39.744537353515625,5206.534393310547,6,1,1,1,854,3
100116,Groceries,45.46712112426758,2022-01-10,75,0,39.744537353515625,2980.840301513672,0,1,0,2,929,3
100116,Groceries,45.46712112426758,2022-01-11,85,0,39.744537353515625,3378.285675048828,1,1,0,2,1014,3
100116,Groceries,45.46712112426758,2022-01-12,84,0,39.744537353515625,3338.5411376953125,2,1,0,2,1098,3
100116,Groceries,45.46712112426758,2022-01-13,60,0,39.744537353515625,2384.6722412109375,3,1,0,2,1158,3
100116,Groceries,45.46712112426758,2022-01-14,184,567,45.7329084777832,34918.80031982422,4,1,0,2,1342,3
100116,Groceries,45.46712112426758,2022-01-15,64,0,44.235816955566406,2831.09228515625,5,1,1,2,1406,3
100116,Groceries,45.46712112426758,2022-01-16,72,0,44.235816955566406,3184.9788208007812,6,1,1,2,1478,3
100116,Groceries,45.46712112426758,2022-01-17,67,0,44.235816955566406,2963.799736022949,0,1,0,3,1545,3
100116,Groceries,45.46712112426758,2022-01-18,103,0,44.235816955566406,4556.28914642334,1,1,0,3,1648,3
100116,Groceries,45.46712112426758,2022-01-19,76,0,44.235816955566406,3361.922088623047,2,1,0,3,1724,3
100116,Groceries,45.46712112426758,2022-01-20,88,0,44.235816955566406,3892.7518920898438,3,1,0,3,1812,3
100116,Groceries,45.46712112426758,2022-01-21,118,248,40.72000213623047,14734.52050415039,4,1,0,3,1930,3
100116,Groceries,45.46712112426758,2022-01-22,173,640,47.87169853210449,39596.04769210816,5,1,1,3,2103,3
100116,Groceries,45.46712112426758,2022-01-24,69,0,46.423397064208984,3203.21439743042,0,1,0,4,2172,3
100116,Groceries,45.46712112426758,2022-01-25,76,0,46.423397064208984,3528.178176879883,1,1,0,4,2248,3
100116,Groceries,45.46712112426758,2022-01-26,126,0,46.423397064208984,5849.348030090332,2,1,0,4,2374,3
100116,Groceries,45.46712112426758,2022-01-27,208,485,42.46065040588379,28998.470568847657,3,1,0,4,2582,3
100116,Groceries,45.46712112426758,2022-01-28,161,0,44.00130081176758,7084.20943069458,4,1,0,4,2743,3
100116,Groceries,45.46712112426758,2022-01-29,134,0,44.00130081176758,5896.1743087768555,5,1,1,4,2877,3
100116,Groceries,45.46712112426758,2022-01-30,55,0,44.00130081176758,2420.071544647217,6,1,1,4,2932,3
100116,Groceries,45.46712112426758,2022-01-31,70,0,44.00130081176758,3080.0910568237305,0,1,0,5,3002,3
100116,Groceries,45.46712112426758,2022-02-01,213,556,41.159356384277345,31360.21581970215,1,2,0,5,3215,3
100116,Groceries,45.46712112426758,2022-02-02,129,0,42.00871276855469,5419.123947143555,2,2,0,5,3344,3
100116,Groceries,45.46712112426758,2022-02-03,132,0,42.00871276855469,5545.150085449219,3,2,0,5,3476,3
100116,Groceries,45.46712112426758,2022-02-04,179,447,44.0046575164795,27752.02739089966,4,2,0,5,3655,3
100116,Groceries,45.46712112426758,2022-02-05,80,0,43.239315032958984,3459.1452026367188,5,2,1,5,3735,3
100116,Groceries,45.46712112426758,2022-02-06,143,0,43.239315032958984,6183.222049713135,6,2,1,5,3878,3
100116,Groceries,45.46712112426758,2022-02-07,86,0,43.239315032958984,3718.5810928344727,0,2,0,6,3964,3
100116,Groceries,45.46712112426758,2022-02-08,45,0,43.239315032958984,1945.7691764831543,1,2,0,6,4009,3
100116,Groceries,45.46712112426758,2022-02-09,171,649,41.42287704467773,33735.94394927978,2,2,0,6,4180,3
100116,Groceries,45.46712112426758,2022-02-10,102,0,41.90575408935547,4274.386917114258,3,2,0,6,4282,3
100116,Groceries,45.46712112426758,2022-02-11,112,0,41.90575408935547,4693.4444580078125,4,2,0,6,4394,3
100116,Groceries,45.46712112426758,2022-02-12,105,0,41.90575408935547,4400.104179382324,5,2,1,6,4499,3
100116,Groceries,45.46712112426758,2022-02-13,94,0,41.90575408935547,3939.140884399414,6,2,1,6,4593,3
100116,Groceries,45.46712112426758,2022-02-14,155,0,41.90575408935547,6495.391883850098,0,2,0,7,4748,3
100116,Groceries,45.46712112426758,2022-02-15,56,0,41.90575408935547,2346.7222290039062,1,2,0,7,4804,3
100116,Groceries,45.46712112426758,2022-02-16,174,538,46.919642486572265,33829.15558532715,2,2,0,7,4978,3
100116,Groceries,45.46712112426758,2022-02-17,63,0,45.75928497314453,2882.8349533081055,3,2,0,7,5041,3
100116,Groceries,45.46712112426758,2022-02-18,87,0,45.75928497314453,3981.057792663574,4,2,0,7,5128,3
100116,Groceries,45.46712112426758,2022-02-19,128,0,45.75928497314453,5857.1884765625,5,2,1,7,5256,3
100116,Groceries,45.46712112426758,2022-02-20,64,0,45.75928497314453,2928.59423828125,6,2,1,7,5320,3
100116,Groceries,45.46712112426758,2022-02-21,78,0,45.75928497314453,3569.2242279052734,0,2,0,8,5398,3
100116,Groceries,45.46712112426758,2022-02-22,163,473,37.0603564453125,22975.076201171876,1,2,0,8,5561,3
100116,Groceries,45.46712112426758,2022-02-23,105,0,38.980712890625,4092.974853515625,2,2,0,8,5666,3
100116,Groceries,45.46712112426758,2022-02-25,127,0,38.980712890625,4950.550537109375,4,2,0,8,5793,3
100116,Groceries,45.46712112426758,2022-02-26,76,0,38.980712890625,2962.5341796875,5,2,1,8,5869,3
100116,Groceries,45.46712112426758,2022-02-27,179,426,35.377163772583,21188.994630584715,6,2,1,8,6048,3
100116,Groceries,45.46712112426758,2022-02-28,60,0,36.244327545166016,2174.659652709961,0,2,0,9,6108,3
100116,Groceries,45.46712112426758,2022-03-01,31,0,36.244327545166016,1123.5741539001465,1,3,0,9,6139,3
100116,Groceries,45.46712112426758,2022-03-02,93,430,44.70674407958984,24326.32439880371,2,3,0,9,6232,3
100116,Groceries,45.46712112426758,2022-03-03,112,0,41.90348815917969,4693.190673828125,3,3,0,9,6344,3
100116,Groceries,45.46712112426758,2022-03-04,62,0,41.90348815917969,2598.0162658691406,4,3,0,9,6406,3
100116,Groceries,45.46712112426758,2022-03-05,88,0,41.90348815917969,3687.5069580078125,5,3,1,9,6494,3
100116,Groceries,45.46712112426758,2022-03-06,81,0,41.90348815917969,3394.1825408935547,6,3,1,9,6575,3
100116,Groceries,45.46712112426758,2022-03-07,112,508,38.27210472106934,23308.11145751953,0,3,0,10,6687,3
100116,Groceries,45.46712112426758,2022-03-08,140,0,39.33420944213867,5506.789321899414,1,3,0,10,6827,3
100116,Groceries,45.46712112426758,2022-03-09,81,0,39.33420944213867,3186.0709648132324,2,3,0,10,6908,3
100116,Groceries,45.46712112426758,2022-03-10,54,0,39.33420944213867,2124.0473098754883,3,3,0,10,6962,3
100116,Groceries,45.46712112426758,2022-03-11,69,0,39.33420944213867,2714.0604515075684,4,3,0,10,7031,3
100116,Groceries,45.46712112426758,2022-03-12,159,534,41.18327331542969,28752.53091430664,5,3,1,10,7190,3
100116,Groceries,45.46712112426758,2022-03-13,113,0,40.616546630859375,4589.669769287109,6,3,1,10,7303,3
100116,Groceries,45.46712112426758,2022-03-14,173,0,40.616546630859375,7026.662567138672,0,3,0,11,7476,3
100116,Groceries,45.46712112426758,2022-03-15,107,0,40.616546630859375,4345.970489501953,1,3,0,11,7583,3
100116,Groceries,45.46712112426758,2022-03-16,129,503,39.02492774963379,24478.651359405518,2,3,0,11,7712,3
100116,Groceries,45.46712112426758,2022-03-17,140,0,39.51985549926758,5532.779769897461,3,3,0,11,7852,3
100116,Groceries,45.46712112426758,2022-03-18,124,0,39.51985549926758,4900.46208190918,4,3,0,11,7976,3
100116,Groceries,45.46712112426758,2022-03-19,60,0,39.51985549926758,2371.1913299560547,5,3,1,11,8036,3
100116,Groceries,45.46712112426758,2022-03-20,172,455,44.19397705078125,28181.10810546875,6,3,1,11,8208,3
100116,Groceries,45.46712112426758,2022-03-21,67,0,42.5279541015625,2849.3729248046875,0,3,0,12,8275,3
100116,Groceries,45.46712112426758,2022-03-22,56,0,42.5279541015625,2381.5654296875,1,3,0,12,8331,3
100116,Groceries,45.46712112426758,2022-03-23,66,0,42.5279541015625,2806.844970703125,2,3,0,12,8397,3
100116,Groceries,45.46712112426758,2022-03-24,60,0,42.5279541015625,2551.67724609375,3,3,0,12,8457,3
100116,Groceries,45.46712112426758,2022-03-25,218,539,44.94523620605469,34281.872985839844,4,3,0,12,8675,3
100116,Groceries,45.46712112426758,2022-03-26,62,0,44.140472412109375,2736.7092895507812,5,3,1,12,8737,3
100116,Groceries,45.46712112426758,2022-03-27,162,0,44.140472412109375,7150.756530761719,6,3,1,12,8899,3
100116,Groceries,45.46712112426758,2022-03-28,133,0,44.140472412109375,5870.682830810547,0,3,0,13,9032,3
100116,Groceries,45.46712112426758,2022-03-29,125,645,49.272379379272465,38687.29484481811,1,3,0,13,9157,3
100116,Groceries,45.46712112426758,2022-03-30,97,0,47.83475875854492,4639.971599578857,2,3,0,13,9254,3
100116,Groceries,45.46712112426758,2022-03-31,103,0,47.83475875854492,4926.980152130127,3,3,0,13,9357,3
100116,Groceries,45.46712112426758,2022-04-01,93,0,47.83475875854492,4448.632564544678,4,4,0,13,9450,3
100116,Groceries,45.46712112426758,2022-04-02,87,0,47.83475875854492,4161.624011993408,5,4,1,13,9537,3
100116,Groceries,45.46712112426758,2022-04-03,98,0,47.83475875854492,4687.806358337402,6,4,1,13,9635,3
100116,Groceries,45.46712112426758,2022-04-04,84,0,47.83475875854492,4018.1197357177734,0,4,0,14,9719,3
100116,Groceries,45.46712112426758,2022-04-05,140,459,45.07968910217285,26709.352948608397,1,4,0,14,9859,3
100116,Groceries,45.46712112426758,2022-04-06,103,0,45.9993782043457,4737.935955047607,2,4,0,14,9962,3
100116,Groceries,45.46712112426758,2022-04-07,74,0,45.9993782043457,3403.953987121582,3,4,0,14,10036,3
100116,Groceries,45.46712112426758,2022-04-08,27,0,45.9993782043457,1241.983211517334,4,4,0,14,10063,3
100116,Groceries,45.46712112426758,2022-04-09,120,0,45.9993782043457,5519.925384521484,5,4,1,14,10183,3
100116,Groceries,45.46712112426758,2022-04-10,74,0,45.9993782043457,3403.953987121582,6,4,1,14,10257,3
100116,Groceries,45.46712112426758,2022-04-11,51,0,45.9993782043457,2345.968288421631,0,4,0,15,10308,3
100116,Groceries,45.46712112426758,2022-04-12,118,285,41.36812683105469,16387.767932128907,1,4,0,15,10426,3
100116,Groceries,45.46712112426758,2022-04-13,158,0,43.066253662109375,6804.468078613281,2,4,0,15,10584,3
100116,Groceries,45.46712112426758,2022-04-14,54,428,43.94945297241211,21277.34092102051,3,4,0,15,10638,3
100116,Groceries,45.46712112426758,2022-04-15,219,0,43.69890594482422,9570.060401916504,4,4,0,15,10857,3
100116,Groceries,45.46712112426758,2022-04-16,66,0,43.69890594482422,2884.1277923583984,5,4,1,15,10923,3
100116,Groceries,45.46712112426758,2022-04-17,74,0,43.69890594482422,3233.719039916992,6,4,1,15,10997,3
100116,Groceries,45.46712112426758,2022-04-18,10,0,43.69890594482422,436.9890594482422,0,4,0,16,11007,3
100116,Groceries,45.46712112426758,2022-04-19,127,574,43.358488693237305,30359.216128082277,1,4,0,16,11134,3
100116,Groceries,45.46712112426758,2022-04-20,135,0,43.43697738647461,5863.991947174072,2,4,0,16,11269,3
100116,Groceries,45.46712112426758,2022-04-21,58,0,43.43697738647461,2519.3446884155273,3,4,0,16,11327,3
100116,Groceries,45.46712112426758,2022-04-22,147,0,43.43697738647461,6385.235675811768,4,4,0,16,11474,3
100116,Groceries,45.46712112426758,2022-04-23,66,0,43.43697738647461,2866.840507507324,5,4,1,16,11540,3
100116,Groceries,45.46712112426758,2022-04-24,49,0,43.43697738647461,2128.411891937256,6,4,1,16,11589,3
100116,Groceries,45.46712112426758,2022-04-25,46,0,43.43697738647461,1998.100959777832,0,4,0,17,11635,3
100116,Groceries,45.46712112426758,2022-04-26,36,0,43.43697738647461,1563.731185913086,1,4,0,17,11671,3
100116,Groceries,45.46712112426758,2022-04-27,26,0,43.43697738647461,1129.3614120483398,2,4,0,17,11697,3
100116,Groceries,45.46712112426758,2022-04-28,75,227,34.828055953979494,10080.608393096923,3,4,0,17,11772,3
100116,Groceries,45.46712112426758,2022-04-29,57,0,37.706111907958984,2149.248378753662,4,4,0,17,11829,3
100116,Groceries,45.46712112426758,2022-04-30,58,0,37.706111907958984,2186.954490661621,5,4,1,17,11887,3
100116,Groceries,45.46712112426758,2022-05-01,66,0,37.706111907958984,2488.603385925293,6,5,1,17,11953,3
100116,Groceries,45.46712112426758,2022-05-02,58,277,33.51706512451172,10985.769554443359,0,5,0,18,12011,3
100116,Groceries,45.46712112426758,2022-05-03,93,0,34.62413024902344,3220.0441131591797,1,5,0,18,12104,3
100116,Groceries,45.46712112426758,2022-05-04,37,0,34.62413024902344,1281.0928192138672,2,5,0,18,12141,3
100116,Groceries,45.46712112426758,2022-05-05,44,0,34.62413024902344,1523.4617309570312,3,5,0,18,12185,3
100116,Groceries,45.46712112426758,2022-05-06,70,292,38.15075370788574,14041.285519104003,4,5,0,18,12255,3
100116,Groceries,45.46712112426758,2022-05-07,120,0,37.111507415771484,4453.380889892578,5,5,1,18,12375,3
100116,Groceries,45.46712112426758,2022-05-08,54,378,34.499959793090824,14638.315657653808,6,5,1,18,12429,3
100116,Groceries,45.46712112426758,2022-05-09,50,0,35.31991958618164,1765.995979309082,0,5,0,19,12479,3
100116,Groceries,45.46712112426758,2022-05-10,124,0,35.31991958618164,4379.670028686523,1,5,0,19,12603,3
100116,Groceries,45.46712112426758,2022-05-11,88,0,35.31991958618164,3108.1529235839844,2,5,0,19,12691,3
100116,Groceries,45.46712112426758,2022-05-12,63,0,35.31991958618164,2225.1549339294434,3,5,0,19,12754,3
100116,Groceries,45.46712112426758,2022-05-13,53,0,35.31991958618164,1871.955738067627,4,5,0,19,12807,3
100116,Groceries,45.46712112426758,2022-05-14,46,0,35.31991958618164,1624.7163009643555,5,5,1,19,12853,3
100116,Groceries,45.46712112426758,2022-05-15,53,0,35.31991958618164,1871.955738067627,6,5,1,19,12906,3
100116,Groceries,45.46712112426758,2022-05-16,77,237,33.605947189331054,10472.915867156982,0,5,0,20,12983,3
100116,Groceries,45.46712112426758,2022-05-17,109,369,36.26130722045899,17514.564974060057,1,5,0,20,13092,3
100116,Groceries,45.46712112426758,2022-05-18,7,0,35.56261444091797,248.93830108642578,2,5,0,20,13099,3
100116,Groceries,45.46712112426758,2022-05-19,94,0,35.56261444091797,3342.885757446289,3,5,0,20,13193,3
100116,Groceries,45.46712112426758,2022-05-20,54,0,35.56261444091797,1920.3811798095703,4,5,0,20,13247,3
100116,Groceries,45.46712112426758,2022-05-21,62,0,35.56261444091797,2204.882095336914,5,5,1,20,13309,3
100116,Groceries,45.46712112426758,2022-05-22,35,0,35.56261444091797,1244.691505432129,6,5,1,20,13344,3
100116,Groceries,45.46712112426758,2022-05-23,90,0,35.56261444091797,3200.635299682617,0,5,0,21,13434,3
100116,Groceries,45.46712112426758,2022-05-24,135,333,35.47526321411133,16597.421067810057,1,5,0,21,13569,3
100116,Groceries,45.46712112426758,2022-05-25,53,0,35.500526428222656,1881.5279006958008,2,5,0,21,13622,3
100116,Groceries,45.46712112426758,2022-05-26,83,591,43.89476493835449,30695.170979766845,3,5,0,21,13705,3
100116,Groceries,45.46712112426758,2022-05-27,62,0,41.709529876708984,2585.990852355957,4,5,0,21,13767,3
100116,Groceries,45.46712112426758,2022-05-28,162,0,41.709529876708984,6756.9438400268555,5,5,1,21,13929,3
100116,Groceries,45.46712112426758,2022-05-29,226,0,41.709529876708984,9426.35375213623,6,5,1,21,14155,3
100116,Groceries,45.46712112426758,2022-05-30,137,0,41.709529876708984,5714.205593109131,0,5,0,22,14292,3
100116,Groceries,45.46712112426758,2022-05-31,124,339,41.60478034973144,19255.535526733398,1,5,0,22,14416,3
100116,Groceries,45.46712112426758,2022-06-01,164,0,41.63956069946289,6828.887954711914,2,6,0,22,14580,3
100116,Groceries,45.46712112426758,2022-06-02,49,717,48.23539764404297,37886.58896911621,3,6,0,22,14629,3
100116,Groceries,45.46712112426758,2022-06-03,109,0,46.83079528808594,5104.556686401367,4,6,0,22,14738,3
100116,Groceries,45.46712112426758,2022-06-04,143,0,46.83079528808594,6696.803726196289,5,6,1,22,14881,3
100116,Groceries,45.46712112426758,2022-06-05,151,0,46.83079528808594,7071.450088500977,6,6,1,22,15032,3
100116,Groceries,45.46712112426758,2022-06-06,266,864,43.79310081481934,48988.00963348389,0,6,0,23,15298,3
100116,Groceries,45.46712112426758,2022-06-07,97,0,44.62620162963867,4328.741558074951,1,6,0,23,15395,3
100116,Groceries,45.46712112426758,2022-06-08,123,0,44.62620162963867,5489.022800445557,2,6,0,23,15518,3
100116,Groceries,45.46712112426758,2022-06-09,147,0,44.62620162963867,6560.051639556885,3,6,0,23,15665,3
100116,Groceries,45.46712112426758,2022-06-10,62,0,44.62620162963867,2766.8245010375977,4,6,0,23,15727,3
100116,Groceries,45.46712112426758,2022-06-11,142,0,44.62620162963867,6336.920631408691,5,6,1,23,15869,3
100116,Groceries,45.46712112426758,2022-06-12,110,0,44.62620162963867,4908.882179260254,6,6,1,23,15979,3
100116,Groceries,45.46712112426758,2022-06-13,38,0,44.62620162963867,1695.7956619262695,0,6,0,24,16017,3
100116,Groceries,45.46712112426758,2022-06-14,101,587,46.74825675964355,32484.407865447996,1,6,0,24,16118,3
100116,Groceries,45.46712112426758,2022-06-15,243,0,46.08651351928711,11199.022785186768,2,6,0,24,16361,3
100116,Groceries,45.46712112426758,2022-06-16,126,0,46.08651351928711,5806.900703430176,3,6,0,24,16487,3
100116,Groceries,45.46712112426758,2022-06-17,176,0,46.08651351928711,8111.226379394531,4,6,0,24,16663,3
100116,Groceries,45.46712112426758,2022-06-18,71,0,46.08651351928711,3272.1424598693848,5,6,1,24,16734,3
100116,Groceries,45.46712112426758,2022-06-19,184,434,45.66380180358887,28186.779063720704,6,6,1,24,16918,3
100116,Groceries,45.46712112426758,2022-06-20,195,730,43.76690132141113,40148.99151535034,0,6,0,25,17113,3
100116,Groceries,45.46712112426758,2022-06-21,23,0,44.393802642822266,1021.0574607849121,1,6,0,25,17136,3
100116,Groceries,45.46712112426758,2022-06-22,218,0,44.393802642822266,9677.848976135254,2,6,0,25,17354,3
100116,Groceries,45.46712112426758,2022-06-23,281,0,44.393802642822266,12474.658542633057,3,6,0,25,17635,3
100116,Groceries,45.46712112426758,2022-06-24,178,0,44.393802642822266,7902.096870422363,4,6,0,25,17813,3
100116,Groceries,45.46712112426758,2022-06-25,217,508,47.3969312286377,34645.93815322876,5,6,1,25,18030,3
100116,Groceries,45.46712112426758,2022-06-26,165,0,46.42386245727539,7659.937305450439,6,6,1,25,18195,3
100116,Groceries,45.46712112426758,2022-06-27,105,0,46.42386245727539,4874.505558013916,0,6,0,26,18300,3
100116,Groceries,45.46712112426758,2022-06-28,37,0,46.42386245727539,1717.6829109191895,1,6,0,26,18337,3
100116,Groceries,45.46712112426758,2022-06-29,107,0,46.42386245727539,4967.353282928467,2,6,0,26,18444,3
100116,Groceries,45.46712112426758,2022-06-30,76,280,43.250221252441406,15142.033630371094,3,6,0,26,18520,3
100116,Groceries,45.46712112426758,2022-07-01,40,0,44.50044250488281,1780.0177001953125,4,7,0,26,18560,3
100116,Groceries,45.46712112426758,2022-07-02,122,0,44.50044250488281,5429.053985595703,5,7,1,26,18682,3
100116,Groceries,45.46712112426758,2022-07-03,140,368,38.15567131042481,18868.787966918942,6,7,1,26,18822,3
100116,Groceries,45.46712112426758,2022-07-04,152,0,40.41134262084961,6142.524078369141,0,7,0,27,18974,3
100116,Groceries,45.46712112426758,2022-07-05,64,0,40.41134262084961,2586.325927734375,1,7,0,27,19038,3
100116,Groceries,45.46712112426758,2022-07-06,74,0,40.41134262084961,2990.439353942871,2,7,0,27,19112,3
100116,Groceries,45.46712112426758,2022-07-07,90,0,40.41134262084961,3637.020835876465,3,7,0,27,19202,3
100116,Groceries,45.46712112426758,2022-07-08,92,387,39.47207557678223,18838.66190612793,4,7,0,27,19294,3
100116,Groceries,45.46712112426758,2022-07-09,59,0,39.70415115356445,2342.5449180603027,5,7,1,27,19353,3
100116,Groceries,45.46712112426758,2022-07-10,95,0,39.70415115356445,3771.894359588623,6,7,1,27,19448,3
100116,Groceries,45.46712112426758,2022-07-11,158,383,38.022229766845705,20441.27460632324,0,7,0,28,19606,3
100116,Groceries,45.46712112426758,2022-07-12,120,0,38.594459533691406,4631.335144042969,1,7,0,28,19726,3
100116,Groceries,45.46712112426758,2022-07-13,99,0,38.594459533691406,3820.851493835449,2,7,0,28,19825,3
100116,Groceries,45.46712112426758,2022-07-14,108,0,38.594459533691406,4168.201629638672,3,7,0,28,19933,3
100116,Groceries,45.46712112426758,2022-07-15,79,315,35.06910095214844,13553.117950439453,4,7,0,28,20012,3
100116,Groceries,45.46712112426758,2022-07-16,34,0,36.188201904296875,1230.3988647460938,5,7,1,28,20046,3
100116,Groceries,45.46712112426758,2022-07-17,94,0,36.188201904296875,3401.6909790039062,6,7,1,28,20140,3
100116,Groceries,45.46712112426758,2022-07-18,85,0,36.188201904296875,3075.9971618652344,0,7,0,29,20225,3
100116,Groceries,45.46712112426758,2022-07-19,178,430,40.50109489440918,24916.709782409667,1,7,0,29,20403,3
100116,Groceries,45.46712112426758,2022-07-20,98,0,39.34218978881836,3855.534599304199,2,7,0,29,20501,3
100116,Groceries,45.46712112426758,2022-07-21,40,0,39.34218978881836,1573.6875915527344,3,7,0,29,20541,3
100116,Groceries,45.46712112426758,2022-07-22,66,0,39.34218978881836,2596.5845260620117,4,7,0,29,20607,3
100116,Groceries,45.46712112426758,2022-07-23,27,0,39.34218978881836,1062.2391242980957,5,7,1,29,20634,3
100116,Groceries,45.46712112426758,2022-07-24,42,0,39.34218978881836,1652.371971130371,6,7,1,29,20676,3
100116,Groceries,45.46712112426758,2022-07-25,123,338,38.06731971740723,17465.760650482178,0,7,0,30,20799,3
100116,Groceries,45.46712112426758,2022-07-26,172,573,43.795246810913085,33287.0049029541,1,7,0,30,20971,3
100116,Groceries,45.46712112426758,2022-07-28,175,0,42.15049362182617,7376.33638381958,3,7,0,30,21146,3
100116,Groceries,45.46712112426758,2022-07-29,126,0,42.15049362182617,5310.962196350098,4,7,0,30,21272,3
100116,Groceries,45.46712112426758,2022-07-30,141,0,42.15049362182617,5943.21960067749,5,7,1,30,21413,3
100116,Groceries,45.46712112426758,2022-07-31,92,0,42.15049362182617,3877.845413208008,6,7,1,30,21505,3
100116,Groceries,45.46712112426758,2022-08-01,112,356,38.109089355468754,17493.676015625002,0,8,0,31,21617,3
100116,Groceries,45.46712112426758,2022-08-02,56,0,39.5081787109375,2212.4580078125,1,8,0,31,21673,3
100116,Groceries,45.46712112426758,2022-08-03,196,729,52.61845458984375,50623.67419921875,2,8,0,31,21869,3
100116,Groceries,45.46712112426758,2022-08-04,275,0,48.9569091796875,13463.150024414062,3,8,0,31,22144,3
100116,Groceries,45.46712112426758,2022-08-05,94,0,48.9569091796875,4601.949462890625,4,8,0,31,22238,3
100116,Groceries,45.46712112426758,2022-08-06,186,929,56.45662704467773,64519.375260620116,5,8,1,31,22424,3
100116,Groceries,45.46712112426758,2022-08-07,204,0,54.34325408935547,11086.023834228516,6,8,1,31,22628,3
100116,Groceries,45.46712112426758,2022-08-08,339,0,54.34325408935547,18422.363136291504,0,8,0,32,22967,3
100116,Groceries,45.46712112426758,2022-08-09,111,0,54.34325408935547,6032.101203918457,1,8,0,32,23078,3
100116,Groceries,45.46712112426758,2022-08-10,169,0,54.34325408935547,9184.009941101074,2,8,0,32,23247,3
100116,Groceries,45.46712112426758,2022-08-11,176,668,54.446306457519526,45969.259873046874,3,8,0,32,23423,3
100116,Groceries,45.46712112426758,2022-08-12,163,0,54.41261291503906,8869.255905151367,4,8,0,32,23586,3
100116,Groceries,45.46712112426758,2022-08-13,198,0,54.41261291503906,10773.697357177734,5,8,1,32,23784,3
100116,Groceries,45.46712112426758,2022-08-14,107,0,54.41261291503906,5822.14958190918,6,8,1,32,23891,3
100116,Groceries,45.46712112426758,2022-08-15,171,0,54.41261291503906,9304.55680847168,0,8,0,33,24062,3
100116,Groceries,45.46712112426758,2022-08-16,92,0,54.41261291503906,5005.960388183594,1,8,0,33,24154,3
100116,Groceries,45.46712112426758,2022-08-17,285,805,53.77867050170899,58551.84218597412,2,8,0,33,24439,3
100116,Groceries,45.46712112426758,2022-08-18,125,0,53.90734100341797,6738.417625427246,3,8,0,33,24564,3
100116,Groceries,45.46712112426758,2022-08-20,216,0,53.90734100341797,11643.985656738281,5,8,1,33,24780,3
100116,Groceries,45.46712112426758,2022-08-21,140,0,53.90734100341797,7547.027740478516,6,8,1,33,24920,3
100116,Groceries,45.46712112426758,2022-08-22,120,405,46.626560821533204,23738.92459716797,0,8,0,34,25040,3
100116,Groceries,45.46712112426758,2022-08-23,122,0,49.223121643066406,6005.220840454102,1,8,0,34,25162,3
100116,Groceries,45.46712112426758,2022-08-24,207,578,50.42423049926758,39737.27142669678,2,8,0,34,25369,3
100116,Groceries,45.46712112426758,2022-08-25,240,0,50.008460998535156,12002.030639648438,3,8,0,34,25609,3
100116,Groceries,45.46712112426758,2022-08-26,83,0,50.008460998535156,4150.702262878418,4,8,0,34,25692,3
100116,Groceries,45.46712112426758,2022-08-27,70,0,50.008460998535156,3500.592269897461,5,8,1,34,25762,3
100116,Groceries,45.46712112426758,2022-08-28,186,606,40.36681030273438,30644.65343261719,6,8,1,34,25948,3
100116,Groceries,45.46712112426758,2022-08-29,83,0,43.52362060546875,3612.4605102539062,0,8,0,35,26031,3
100116,Groceries,45.46712112426758,2022-08-30,85,0,43.52362060546875,3699.5077514648438,1,8,0,35,26116,3
100116,Groceries,45.46712112426758,2022-08-31,117,0,43.52362060546875,5092.263610839844,2,8,0,35,26233,3
100116,Groceries,45.46712112426758,2022-09-01,89,0,43.52362060546875,3873.6022338867188,3,9,0,35,26322,3
100116,Groceries,45.46712112426758,2022-09-02,163,0,43.52362060546875,7094.350158691406,4,9,0,35,26485,3
100116,Groceries,45.46712112426758,2022-09-03,100,0,43.52362060546875,4352.362060546875,5,9,1,35,26585,3
100116,Groceries,45.46712112426758,2022-09-04,120,504,41.678386535644535,25815.93276855469,6,9,1,35,26705,3
100116,Groceries,45.46712112426758,2022-09-05,104,0,42.17677307128906,4386.3843994140625,0,9,0,36,26809,3
100116,Groceries,45.46712112426758,2022-09-06,128,0,42.17677307128906,5398.626953125,1,9,0,36,26937,3
100116,Groceries,45.46712112426758,2022-09-07,94,0,42.17677307128906,3964.616668701172,2,9,0,36,27031,3
100116,Groceries,45.46712112426758,2022-09-08,96,0,42.17677307128906,4048.97021484375,3,9,0,36,27127,3
100116,Groceries,45.46712112426758,2022-09-09,65,0,42.17677307128906,2741.490249633789,4,9,0,36,27192,3
100116,Groceries,45.46712112426758,2022-09-10,159,395,40.354231185913086,22246.685517120364,5,9,1,36,27351,3
100116,Groceries,45.46712112426758,2022-09-11,76,0,40.81846237182617,3102.203140258789,6,9,1,36,27427,3
100116,Groceries,45.46712112426758,2022-09-12,35,0,40.81846237182617,1428.646183013916,0,9,0,37,27462,3
100116,Groceries,45.46712112426758,2022-09-13,125,447,41.85298248291016,24041.98562072754,1,9,0,37,27587,3
100116,Groceries,45.46712112426758,2022-09-14,98,0,41.53596496582031,4070.5245666503906,2,9,0,37,27685,3
100116,Groceries,45.46712112426758,2022-09-15,172,0,41.53596496582031,7144.185974121094,3,9,0,37,27857,3
100116,Groceries,45.46712112426758,2022-09-16,56,0,41.53596496582031,2326.0140380859375,4,9,0,37,27913,3
100116,Groceries,45.46712112426758,2022-09-17,59,0,41.53596496582031,2450.6219329833984,5,9,1,37,27972,3
100116,Groceries,45.46712112426758,2022-09-18,80,0,41.53596496582031,3322.877197265625,6,9,1,37,28052,3
100116,Groceries,45.46712112426758,2022-09-19,178,481,37.29941459655762,24313.851596374512,0,9,0,38,28230,3
100116,Groceries,45.46712112426758,2022-09-20,74,0,38.178829193115234,2825.2333602905273,1,9,0,38,28304,3
100116,Groceries,45.46712112426758,2022-09-22,59,0,38.178829193115234,2252.550922393799,3,9,0,38,28363,3
100116,Groceries,45.46712112426758,2022-09-23,119,0,38.178829193115234,4543.280673980713,4,9,0,38,28482,3
100116,Groceries,45.46712112426758,2022-09-24,40,0,38.178829193115234,1527.1531677246094,5,9,1,38,28522,3
100116,Groceries,45.46712112426758,2022-09-25,113,297,38.34041244506836,15728.69321258545,6,9,1,38,28635,3
100116,Groceries,45.46712112426758,2022-09-26,97,0,38.29082489013672,3714.2100143432617,0,9,0,39,28732,3
100116,Groceries,45.46712112426758,2022-09-27,53,0,38.29082489013672,2029.413719177246,1,9,0,39,28785,3
100116,Groceries,45.46712112426758,2022-09-28,176,517,40.75102844238281,28427.66201171875,2,9,0,39,28961,3
100116,Groceries,45.46712112426758,2022-09-29,93,0,40.202056884765625,3738.791290283203,3,9,0,39,29054,3
100116,Groceries,45.46712112426758,2022-09-30,28,0,40.202056884765625,1125.6575927734375,4,9,0,39,29082,3
100116,Groceries,45.46712112426758,2022-10-01,81,0,40.202056884765625,3256.3666076660156,5,10,1,39,29163,3
100116,Groceries,45.46712112426758,2022-10-02,98,0,40.202056884765625,3939.8015747070312,6,10,1,39,29261,3
100116,Groceries,45.46712112426758,2022-10-03,260,620,42.671134567260744,37740.989974975586,0,10,0,40,29521,3
100116,Groceries,45.46712112426758,2022-10-04,78,0,42.142269134521484,3287.096992492676,1,10,0,40,29599,3
100116,Groceries,45.46712112426758,2022-10-06,103,0,42.142269134521484,4340.653720855713,3,10,0,40,29702,3
100116,Groceries,45.46712112426758,2022-10-07,111,493,37.11073822021484,21753.743884887695,4,10,0,40,29813,3
100116,Groceries,45.46712112426758,2022-10-08,93,0,38.84147644042969,3612.257308959961,5,10,1,40,29906,3
100116,Groceries,45.46712112426758,2022-10-09,38,0,38.84147644042969,1475.9761047363281,6,10,1,40,29944,3
100116,Groceries,45.46712112426758,2022-10-10,145,0,38.84147644042969,5632.014083862305,0,10,0,41,30089,3
100116,Groceries,45.46712112426758,2022-10-11,45,0,38.84147644042969,1747.866439819336,1,10,0,41,30134,3
100116,Groceries,45.46712112426758,2022-10-12,170,0,38.84147644042969,6603.050994873047,2,10,0,41,30304,3
100116,Groceries,45.46712112426758,2022-10-13,125,484,39.573071975708004,24177.877993927003,3,10,0,41,30429,3
100116,Groceries,45.46712112426758,2022-10-14,79,0,39.356143951416016,3109.1353721618652,4,10,0,41,30508,3
100116,Groceries,45.46712112426758,2022-10-15,75,0,39.356143951416016,2951.710796356201,5,10,1,41,30583,3
100116,Groceries,45.46712112426758,2022-10-16,82,0,39.356143951416016,3227.2038040161133,6,10,1,41,30665,3
100116,Groceries,45.46712112426758,2022-10-17,73,0,39.356143951416016,2872.998508453369,0,10,0,42,30738,3
100116,Groceries,45.46712112426758,2022-10-18,185,459,37.0632022857666,23659.58484573364,1,10,0,42,30923,3
100116,Groceries,45.46712112426758,2022-10-19,106,0,37.8264045715332,4009.5988845825195,2,10,0,42,31029,3
100116,Groceries,45.46712112426758,2022-10-20,133,0,37.8264045715332,5030.911808013916,3,10,0,42,31162,3
100116,Groceries,45.46712112426758,2022-10-21,216,565,39.401538314819334,30939.584552001954,4,10,0,42,31378,3
100116,Groceries,45.46712112426758,2022-10-22,204,0,38.92307662963867,7940.307632446289,5,10,1,42,31582,3
100116,Groceries,45.46712112426758,2022-10-23,73,0,38.92307662963867,2841.384593963623,6,10,1,42,31655,3
100116,Groceries,45.46712112426758,2022-10-24,38,0,38.92307662963867,1479.0769119262695,0,10,0,43,31693,3
100116,Groceries,45.46712112426758,2022-10-25,128,0,38.92307662963867,4982.15380859375,1,10,0,43,31821,3
100116,Groceries,45.46712112426758,2022-10-26,60,0,38.92307662963867,2335.3845977783203,2,10,0,43,31881,3
100116,Groceries,45.46712112426758,2022-10-27,107,457,38.251653823852536,21510.353918304445,3,10,0,43,31988,3
100116,Groceries,45.46712112426758,2022-10-28,143,687,44.3229727935791,37858.13021896362,4,10,0,43,32131,3
100116,Groceries,45.46712112426758,2022-10-29,89,0,42.3559455871582,3769.67915725708,5,10,1,43,32220,3
100116,Groceries,45.46712112426758,2022-10-30,176,0,42.3559455871582,7454.646423339844,6,10,1,43,32396,3
100116,Groceries,45.46712112426758,2022-10-31,34,0,42.3559455871582,1440.102149963379,0,10,0,44,32430,3
100116,Groceries,45.46712112426758,2022-11-01,135,0,42.3559455871582,5718.052654266357,1,11,0,44,32565,3
100116,Groceries,45.46712112426758,2022-11-02,142,0,42.3559455871582,6014.544273376465,2,11,0,44,32707,3
100116,Groceries,45.46712112426758,2022-11-03,88,0,42.3559455871582,3727.323211669922,3,11,0,44,32795,3
100116,Groceries,45.46712112426758,2022-11-04,182,487,46.86662925720215,31861.103049621583,4,11,0,44,32977,3
100116,Groceries,45.46712112426758,2022-11-05,159,0,45.2032585144043,7187.318103790283,5,11,1,44,33136,3
100116,Groceries,45.46712112426758,2022-11-06,91,0,45.2032585144043,4113.496524810791,6,11,1,44,33227,3
100116,Groceries,45.46712112426758,2022-11-07,137,0,45.2032585144043,6192.846416473389,0,11,0,45,33364,3
100116,Groceries,45.46712112426758,2022-11-08,72,0,45.2032585144043,3254.6346130371094,1,11,0,45,33436,3
100116,Groceries,45.46712112426758,2022-11-09,62,0,45.2032585144043,2802.6020278930664,2,11,0,45,33498,3
100116,Groceries,45.46712112426758,2022-11-10,78,0,45.2032585144043,3525.854164123535,3,11,0,45,33576,3
100116,Groceries,45.46712112426758,2022-11-11,112,327,37.62368339538574,16034.405080566406,4,11,0,45,33688,3
100116,Groceries,45.46712112426758,2022-11-12,152,641,39.92426559448242,31667.636740722653,5,11,1,45,33840,3
100116,Groceries,45.46712112426758,2022-11-13,11,0,39.908531188964844,438.9938430786133,6,11,1,45,33851,3
100116,Groceries,45.46712112426758,2022-11-14,46,0,39.908531188964844,1835.7924346923828,0,11,0,46,33897,3
100116,Groceries,45.46712112426758,2022-11-15,179,0,39.908531188964844,7143.627082824707,1,11,0,46,34076,3
100116,Groceries,45.46712112426758,2022-11-16,213,0,39.908531188964844,8500.517143249512,2,11,0,46,34289,3
100116,Groceries,45.46712112426758,2022-11-17,20,0,39.908531188964844,798.1706237792969,3,11,0,46,34309,3
100116,Groceries,45.46712112426758,2022-11-18,90,0,39.908531188964844,3591.767807006836,4,11,0,46,34399,3
100116,Groceries,45.46712112426758,2022-11-19,169,530,38.46083297729492,26735.811546325684,5,11,1,46,34568,3
100116,Groceries,45.46712112426758,2022-11-20,62,0,38.871665954589844,2410.0432891845703,6,11,1,46,34630,3
100116,Groceries,45.46712112426758,2022-11-21,141,0,38.871665954589844,5480.904899597168,0,11,0,47,34771,3
100116,Groceries,45.46712112426758,2022-11-22,99,0,38.871665954589844,3848.2949295043945,1,11,0,47,34870,3
100116,Groceries,45.46712112426758,2022-11-23,51,0,38.871665954589844,1982.454963684082,2,11,0,47,34921,3
100116,Groceries,45.46712112426758,2022-11-24,185,632,51.368790283203126,43381.362404785155,3,11,0,47,35106,3
100116,Groceries,45.46712112426758,2022-11-25,123,0,48.20758056640625,5929.532409667969,4,11,0,47,35229,3
100116,Groceries,45.46712112426758,2022-11-26,95,0,48.20758056640625,4579.720153808594,5,11,1,47,35324,3
100116,Groceries,45.46712112426758,2022-11-27,63,0,48.20758056640625,3037.0775756835938,6,11,1,47,35387,3
100116,Groceries,45.46712112426758,2022-11-28,65,0,48.20758056640625,3133.4927368164062,0,11,0,48,35452,3
100116,Groceries,45.46712112426758,2022-11-29,60,0,48.20758056640625,2892.454833984375,1,11,0,48,35512,3
100116,Groceries,45.46712112426758,2022-11-30,125,0,48.20758056640625,6025.947570800781,2,11,0,48,35637,3
100116,Groceries,45.46712112426758,2022-12-01,61,0,48.20758056640625,2940.6624145507812,3,12,0,48,35698,3
100116,Groceries,45.46712112426758,2022-12-02,105,263,39.25258689880371,13950.003248748779,4,12,0,48,35803,3
100116,Groceries,45.46712112426758,2022-12-03,54,0,42.38517379760742,2288.799385070801,5,12,1,48,35857,3
100116,Groceries,45.46712112426758,2022-12-04,119,490,39.61440757751465,23834.159003448487,6,12,1,48,35976,3
100116,Groceries,45.46712112426758,2022-12-05,100,0,40.3988151550293,4039.8815155029297,0,12,0,49,36076,3
100116,Groceries,45.46712112426758,2022-12-06,117,0,40.3988151550293,4726.661373138428,1,12,0,49,36193,3
100116,Groceries,45.46712112426758,2022-12-07,197,590,43.81584770202637,34905.21399459839,2,12,0,49,36390,3
100116,Groceries,45.46712112426758,2022-12-08,79,0,42.741695404052734,3376.593936920166,3,12,0,49,36469,3
100116,Groceries,45.46712112426758,2022-12-09,228,0,42.741695404052734,9745.106552124023,4,12,0,49,36697,3
100116,Groceries,45.46712112426758,2022-12-10,114,0,42.741695404052734,4872.553276062012,5,12,1,49,36811,3
100116,Groceries,45.46712112426758,2022-12-11,90,0,42.741695404052734,3846.752586364746,6,12,1,49,36901,3
100116,Groceries,45.46712112426758,2022-12-12,87,0,42.741695404052734,3718.527500152588,0,12,0,50,36988,3
100116,Groceries,45.46712112426758,2022-12-13,82,407,38.71615745544433,18549.94982269287,1,12,0,50,37070,3
100116,Groceries,45.46712112426758,2022-12-14,77,0,39.89231491088867,3071.7082481384277,2,12,0,50,37147,3
100116,Groceries,45.46712112426758,2022-12-15,54,0,39.89231491088867,2154.1850051879883,3,12,0,50,37201,3
100116,Groceries,45.46712112426758,2022-12-16,72,0,39.89231491088867,2872.2466735839844,4,12,0,50,37273,3
100116,Groceries,45.46712112426758,2022-12-17,154,453,40.549375305175786,24679.437593994142,5,12,1,50,37427,3
100116,Groceries,45.46712112426758,2022-12-18,181,0,40.32875061035156,7299.503860473633,6,12,1,50,37608,3
100116,Groceries,45.46712112426758,2022-12-19,63,0,40.32875061035156,2540.7112884521484,0,12,0,51,37671,3
100116,Groceries,45.46712112426758,2022-12-20,62,0,40.32875061035156,2500.382537841797,1,12,0,51,37733,3
100116,Groceries,45.46712112426758,2022-12-21,163,477,43.27444206237793,27992.548112335204,2,12,0,51,37896,3
100116,Groceries,45.46712112426758,2022-12-22,141,0,42.32888412475586,5968.372661590576,3,12,0,51,38037,3
100116,Groceries,45.46712112426758,2022-12-23,105,0,42.32888412475586,4444.532833099365,4,12,0,51,38142,3
100116,Groceries,45.46712112426758,2022-12-24,148,0,42.32888412475586,6264.674850463867,5,12,1,51,38290,3
100116,Groceries,45.46712112426758,2022-12-25,94,0,42.32888412475586,3978.915107727051,6,12,1,51,38384,3
100116,Groceries,45.46712112426758,2022-12-26,87,284,33.84959999084472,12010.620398406982,0,12,0,52,38471,3
100116,Groceries,45.46712112426758,2022-12-27,156,544,45.72102188110351,33075.19882690429,1,12,0,52,38627,3
100116,Groceries,45.46712112426758,2022-12-28,34,0,42.96204376220703,1460.709487915039,2,12,0,52,38661,3
100116,Groceries,45.46712112426758,2022-12-29,109,0,42.96204376220703,4682.862770080566,3,12,0,52,38770,3
100116,Groceries,45.46712112426758,2022-12-30,77,0,42.96204376220703,3308.0773696899414,4,12,0,52,38847,3
100116,Groceries,45.46712112426758,2022-12-31,145,0,42.96204376220703,6229.4963455200195,5,12,1,52,38992,3
100116,Groceries,45.46712112426758,2023-01-01,155,513,38.71570495605469,25366.008536376954,6,1,1,52,39147,3
100116,Groceries,45.46712112426758,2023-01-02,241,0,40.101409912109375,9664.43978881836,0,1,0,1,39388,3
100116,Groceries,45.46712112426758,2023-01-03,101,498,42.8006143951416,26046.234107818604,1,1,0,1,39489,3
100116,Groceries,45.46712112426758,2023-01-04,83,0,41.7712287902832,3467.011989593506,2,1,0,1,39572,3
100116,Groceries,45.46712112426758,2023-01-05,56,0,41.7712287902832,2339.1888122558594,3,1,0,1,39628,3
100116,Groceries,45.46712112426758,2023-01-06,180,0,41.7712287902832,7518.821182250977,4,1,0,1,39808,3
100116,Groceries,45.46712112426758,2023-01-07,147,0,41.7712287902832,6140.370632171631,5,1,1,1,39955,3
100116,Groceries,45.46712112426758,2023-01-08,57,0,41.7712287902832,2380.9600410461426,6,1,1,1,40012,3
100116,Groceries,45.46712112426758,2023-01-09,167,750,40.44544464111328,36898.738510131836,0,1,0,2,40179,3
100116,Groceries,45.46712112426758,2023-01-10,106,0,40.77088928222656,4321.714263916016,1,1,0,2,40285,3
100116,Groceries,45.46712112426758,2023-01-11,79,0,40.77088928222656,3220.9002532958984,2,1,0,2,40364,3
100116,Groceries,45.46712112426758,2023-01-12,120,0,40.77088928222656,4892.5067138671875,3,1,0,2,40484,3
100116,Groceries,45.46712112426758,2023-01-13,76,0,40.77088928222656,3098.5875854492188,4,1,0,2,40560,3
100116,Groceries,45.46712112426758,2023-01-14,97,0,40.77088928222656,3954.7762603759766,5,1,1,2,40657,3
100116,Groceries,45.46712112426758,2023-01-15,97,0,40.77088928222656,3954.7762603759766,6,1,1,2,40754,3
100116,Groceries,45.46712112426758,2023-01-16,136,384,45.89088745117188,24361.52138671875,0,1,0,3,40890,3
100116,Groceries,45.46712112426758,2023-01-17,135,0,43.88177490234375,5924.039611816406,1,1,0,3,41025,3
100116,Groceries,45.46712112426758,2023-01-18,157,587,41.949862976074215,30926.956974487304,2,1,0,3,41182,3
100116,Groceries,45.46712112426758,2023-01-19,160,0,42.60972595214844,6817.55615234375,3,1,0,3,41342,3
100116,Groceries,45.46712112426758,2023-01-20,119,0,42.60972595214844,5070.557388305664,4,1,0,3,41461,3
100116,Groceries,45.46712112426758,2023-01-21,115,0,42.60972595214844,4900.11848449707,5,1,1,3,41576,3
100116,Groceries,45.46712112426758,2023-01-22,200,0,42.60972595214844,8521.945190429688,6,1,1,3,41776,3
100116,Groceries,45.46712112426758,2023-01-23,52,0,42.60972595214844,2215.7057495117188,0,1,0,4,41828,3
100116,Groceries,45.46712112426758,2023-01-24,185,440,41.76941955566406,26039.7352355957,1,1,0,4,42013,3
100116,Groceries,45.46712112426758,2023-01-25,104,0,42.028839111328125,4370.999267578125,2,1,0,4,42117,3
100116,Groceries,45.46712112426758,2023-01-26,104,0,42.028839111328125,4370.999267578125,3,1,0,4,42221,3
100116,Groceries,45.46712112426758,2023-01-27,71,0,42.028839111328125,2984.047576904297,4,1,0,4,42292,3
100116,Groceries,45.46712112426758,2023-01-28,113,356,37.86971817016602,17415.90630645752,5,1,1,4,42405,3
100116,Groceries,45.46712112426758,2023-01-29,46,0,39.28943634033203,1807.3140716552734,6,1,1,4,42451,3
100116,Groceries,45.46712112426758,2023-01-30,114,0,39.28943634033203,4478.995742797852,0,1,0,5,42565,3
100116,Groceries,45.46712112426758,2023-01-31,26,0,39.28943634033203,1021.5253448486328,1,1,0,5,42591,3
100116,Groceries,45.46712112426758,2023-02-01,89,0,39.28943634033203,3496.759834289551,2,2,0,5,42680,3
100116,Groceries,45.46712112426758,2023-02-02,52,0,39.28943634033203,2043.0506896972656,3,2,0,5,42732,3
100116,Groceries,45.46712112426758,2023-02-03,44,0,39.28943634033203,1728.7351989746094,4,2,0,5,42776,3
100116,Groceries,45.46712112426758,2023-02-04,123,544,42.75208610534668,28779.993181915284,5,2,1,5,42899,3
100116,Groceries,45.46712112426758,2023-02-05,84,0,42.12417221069336,3538.430465698242,6,2,1,5,42983,3
100116,Groceries,45.46712112426758,2023-02-06,34,0,42.12417221069336,1432.2218551635742,0,2,0,6,43017,3
100116,Groceries,45.46712112426758,2023-02-07,86,0,42.12417221069336,3622.678810119629,1,2,0,6,43103,3
100116,Groceries,45.46712112426758,2023-02-08,53,0,42.12417221069336,2232.581127166748,2,2,0,6,43156,3
100116,Groceries,45.46712112426758,2023-02-09,90,0,42.12417221069336,3791.1754989624023,3,2,0,6,43246,3
100116,Groceries,45.46712112426758,2023-02-10,30,0,42.12417221069336,1263.7251663208008,4,2,0,6,43276,3
100116,Groceries,45.46712112426758,2023-02-11,115,369,38.6639820098877,18468.515862274173,5,2,1,6,43391,3
100116,Groceries,45.46712112426758,2023-02-12,35,0,39.62796401977539,1386.9787406921387,6,2,1,6,43426,3
100116,Groceries,45.46712112426758,2023-02-13,135,0,39.62796401977539,5349.775142669678,0,2,0,7,43561,3
100116,Groceries,45.46712112426758,2023-02-14,137,409,39.400660552978515,21493.540991516114,1,2,0,7,43698,3
100116,Groceries,45.46712112426758,2023-02-15,117,0,39.47132110595703,4618.144569396973,2,2,0,7,43815,3
100116,Groceries,45.46712112426758,2023-02-16,51,0,39.47132110595703,2013.0373764038086,3,2,0,7,43866,3
100116,Groceries,45.46712112426758,2023-02-17,70,0,39.47132110595703,2762.992477416992,4,2,0,7,43936,3
100116,Groceries,45.46712112426758,2023-02-18,113,0,39.47132110595703,4460.2592849731445,5,2,1,7,44049,3
100116,Groceries,45.46712112426758,2023-02-19,44,0,39.47132110595703,1736.7381286621094,6,2,1,7,44093,3
100116,Groceries,45.46712112426758,2023-02-20,32,0,39.47132110595703,1263.082275390625,0,2,0,8,44125,3
100116,Groceries,45.46712112426758,2023-02-21,86,326,41.57913093566894,17255.610520935057,1,2,0,8,44211,3
100116,Groceries,45.46712112426758,2023-02-22,60,0,41.05826187133789,2463.4957122802734,2,2,0,8,44271,3
100116,Groceries,45.46712112426758,2023-02-23,68,0,41.05826187133789,2791.9618072509766,3,2,0,8,44339,3
100116,Groceries,45.46712112426758,2023-02-24,46,0,41.05826187133789,1888.680046081543,4,2,0,8,44385,3
100116,Groceries,45.46712112426758,2023-02-25,66,258,32.92200210571289,10117.224277954101,5,2,1,8,44451,3
100116,Groceries,45.46712112426758,2023-02-26,51,0,35.78400421142578,1824.9842147827148,6,2,1,8,44502,3
100116,Groceries,45.46712112426758,2023-02-27,103,0,35.78400421142578,3685.7524337768555,0,2,0,9,44605,3
100116,Groceries,45.46712112426758,2023-02-28,56,0,35.78400421142578,2003.9042358398438,1,2,0,9,44661,3
100116,Groceries,45.46712112426758,2023-03-01,138,512,36.04651718139648,23450.23874206543,2,3,0,9,44799,3
100116,Groceries,45.46712112426758,2023-03-02,97,0,35.99303436279297,3491.324333190918,3,3,0,9,44896,3
100116,Groceries,45.46712112426758,2023-03-03,27,528,41.461900024414064,23937.25260131836,4,3,0,9,44923,3
100116,Groceries,45.46712112426758,2023-03-04,152,0,39.613800048828125,6021.297607421875,5,3,1,9,45075,3
100116,Groceries,45.46712112426758,2023-03-05,127,0,39.613800048828125,5030.952606201172,6,3,1,9,45202,3
100116,Groceries,45.46712112426758,2023-03-06,125,0,39.613800048828125,4951.725006103516,0,3,0,10,45327,3
100116,Groceries,45.46712112426758,2023-03-07,65,0,39.613800048828125,2574.897003173828,1,3,0,10,45392,3
100116,Groceries,45.46712112426758,2023-03-08,95,0,39.613800048828125,3763.311004638672,2,3,0,10,45487,3
100116,Groceries,45.46712112426758,2023-03-09,285,826,50.93714653015137,57961.44352218628,3,3,0,10,45772,3
100116,Groceries,45.46712112426758,2023-03-10,132,0,48.404293060302734,6389.366683959961,4,3,0,10,45904,3
100116,Groceries,45.46712112426758,2023-03-11,59,0,48.404293060302734,2855.8532905578613,5,3,1,10,45963,3
100116,Groceries,45.46712112426758,2023-03-12,153,0,48.404293060302734,7405.856838226318,6,3,1,10,46116,3
100116,Groceries,45.46712112426758,2023-03-13,62,0,48.404293060302734,3001.0661697387695,0,3,0,11,46178,3
100116,Groceries,45.46712112426758,2023-03-14,109,0,48.404293060302734,5276.067943572998,1,3,0,11,46287,3
100116,Groceries,45.46712112426758,2023-03-15,161,443,41.13066482543945,24101.074073791504,2,3,0,11,46448,3
100116,Groceries,45.46712112426758,2023-03-16,99,0,43.761329650878906,4332.371635437012,3,3,0,11,46547,3
100116,Groceries,45.46712112426758,2023-03-17,90,0,43.761329650878906,3938.5196685791016,4,3,0,11,46637,3
100116,Groceries,45.46712112426758,2023-03-18,130,0,43.761329650878906,5688.972854614258,5,3,1,11,46767,3
100116,Groceries,45.46712112426758,2023-03-19,110,0,43.761329650878906,4813.74626159668,6,3,1,11,46877,3
100116,Groceries,45.46712112426758,2023-03-20,94,484,43.697206344604496,25250.274792785644,0,3,0,12,46971,3
100116,Groceries,45.46712112426758,2023-03-21,172,0,43.714412689208984,7518.878982543945,1,3,0,12,47143,3
100116,Groceries,45.46712112426758,2023-03-22,89,0,43.714412689208984,3890.5827293395996,2,3,0,12,47232,3
100116,Groceries,45.46712112426758,2023-03-23,166,440,41.954487838745116,25253.30996246338,3,3,0,12,47398,3
100116,Groceries,45.46712112426758,2023-03-24,185,0,42.578975677490234,7877.110500335693,4,3,0,12,47583,3
100116,Groceries,45.46712112426758,2023-03-25,103,0,42.578975677490234,4385.634494781494,5,3,1,12,47686,3
100116,Groceries,45.46712112426758,2023-03-26,37,0,42.578975677490234,1575.4221000671387,6,3,1,12,47723,3
100116,Groceries,45.46712112426758,2023-03-27,92,0,42.578975677490234,3917.2657623291016,0,3,0,13,47815,3
100116,Groceries,45.46712112426758,2023-03-28,115,304,40.7847216796875,16966.945986328123,1,3,0,13,47930,3
100116,Groceries,45.46712112426758,2023-03-29,106,0,41.429443359375,4391.52099609375,2,3,0,13,48036,3
100116,Groceries,45.46712112426758,2023-03-30,109,0,41.429443359375,4515.809326171875,3,3,0,13,48145,3
100116,Groceries,45.46712112426758,2023-03-31,115,424,41.4692251586914,22355.241786499024,4,3,0,13,48260,3
100116,Groceries,45.46712112426758,2023-04-01,77,0,41.45845031738281,3192.3006744384766,5,4,1,13,48337,3
100116,Groceries,45.46712112426758,2023-04-02,51,0,41.45845031738281,2114.3809661865234,6,4,1,13,48388,3
100116,Groceries,45.46712112426758,2023-04-03,67,0,41.45845031738281,2777.7161712646484,0,4,0,14,48455,3
100116,Groceries,45.46712112426758,2023-04-04,102,0,41.45845031738281,4228.761932373047,1,4,0,14,48557,3
100116,Groceries,45.46712112426758,2023-04-05,113,258,39.63666900634766,14602.73719543457,2,4,0,14,48670,3
100116,Groceries,45.46712112426758,2023-04-06,68,0,40.34333801269531,2743.3469848632812,3,4,0,14,48738,3
100116,Groceries,45.46712112426758,2023-04-07,90,0,40.34333801269531,3630.900421142578,4,4,0,14,48828,3
100116,Groceries,45.46712112426758,2023-04-08,135,487,41.160730056762695,25672.117115325927,5,4,1,14,48963,3
100116,Groceries,45.46712112426758,2023-04-09,67,0,40.96146011352539,2744.417827606201,6,4,1,14,49030,3
100116,Groceries,45.46712112426758,2023-04-10,112,0,40.96146011352539,4587.683532714844,0,4,0,15,49142,3
100116,Groceries,45.46712112426758,2023-04-11,126,0,40.96146011352539,5161.143974304199,1,4,0,15,49268,3
100116,Groceries,45.46712112426758,2023-04-12,55,0,40.96146011352539,2252.8803062438965,2,4,0,15,49323,3
100116,Groceries,45.46712112426758,2023-04-13,51,0,40.96146011352539,2089.034465789795,3,4,0,15,49374,3
100116,Groceries,45.46712112426758,2023-04-14,31,0,40.96146011352539,1269.805263519287,4,4,0,15,49405,3
100116,Groceries,45.46712112426758,2023-04-15,45,0,40.96146011352539,1843.2657051086426,5,4,1,15,49450,3
100116,Groceries,45.46712112426758,2023-04-16,98,283,36.969212417602535,13907.815633850098,6,4,1,15,49548,3
100116,Groceries,45.46712112426758,2023-04-17,81,0,37.92842483520508,3072.2024116516113,0,4,0,16,49629,3
100116,Groceries,45.46712112426758,2023-04-18,0,421,41.88,17631.48,1,4,0,16,49629,3
100116,Groceries,45.46712112426758,2023-04-19,73,0,40.29151153564453,2941.280342102051,2,4,0,16,49702,3
100116,Groceries,45.46712112426758,2023-04-20,66,0,40.29151153564453,2659.239761352539,3,4,0,16,49768,3
100116,Groceries,45.46712112426758,2023-04-21,28,0,40.29151153564453,1128.1623229980469,4,4,0,16,49796,3
100116,Groceries,45.46712112426758,2023-04-22,126,0,40.29151153564453,5076.730453491211,5,4,1,16,49922,3
100116,Groceries,45.46712112426758,2023-04-23,115,0,40.29151153564453,4633.523826599121,6,4,1,16,50037,3
100116,Groceries,45.46712112426758,2023-04-24,58,0,40.29151153564453,2336.907669067383,0,4,0,17,50095,3
100116,Groceries,45.46712112426758,2023-04-25,130,319,35.5800537109375,15733.513964843749,1,4,0,17,50225,3
100116,Groceries,45.46712112426758,2023-04-26,63,0,36.860107421875,2322.186767578125,2,4,0,17,50288,3
100116,Groceries,45.46712112426758,2023-04-27,45,0,36.860107421875,1658.704833984375,3,4,0,17,50333,3
100116,Groceries,45.46712112426758,2023-04-28,34,0,36.860107421875,1253.24365234375,4,4,0,17,50367,3
100116,Groceries,45.46712112426758,2023-04-29,65,0,36.860107421875,2395.906982421875,5,4,1,17,50432,3
100116,Groceries,45.46712112426758,2023-04-30,46,0,36.860107421875,1695.56494140625,6,4,1,17,50478,3
100116,Groceries,45.46712112426758,2023-05-01,88,408,37.336304626464845,18545.589614257813,0,5,0,18,50566,3
100116,Groceries,45.46712112426758,2023-05-02,41,0,37.25260925292969,1527.3569793701172,1,5,0,18,50607,3
100116,Groceries,45.46712112426758,2023-05-03,45,0,37.25260925292969,1676.367416381836,2,5,0,18,50652,3
100116,Groceries,45.46712112426758,2023-05-04,95,412,35.582941665649415,17865.26891647339,3,5,0,18,50747,3
100116,Groceries,45.46712112426758,2023-05-05,75,0,36.13588333129883,2710.191249847412,4,5,0,18,50822,3
100116,Groceries,45.46712112426758,2023-05-06,87,0,36.13588333129883,3143.821849822998,5,5,1,18,50909,3
100116,Groceries,45.46712112426758,2023-05-07,127,0,36.13588333129883,4589.257183074951,6,5,1,18,51036,3
100116,Groceries,45.46712112426758,2023-05-08,108,409,40.2571036529541,21244.224389038085,0,5,0,19,51144,3
100116,Groceries,45.46712112426758,2023-05-09,73,0,38.8242073059082,2834.167133331299,1,5,0,19,51217,3
100116,Groceries,45.46712112426758,2023-05-10,68,0,38.8242073059082,2640.046096801758,2,5,0,19,51285,3
100116,Groceries,45.46712112426758,2023-05-11,80,0,38.8242073059082,3105.9365844726562,3,5,0,19,51365,3
100116,Groceries,45.46712112426758,2023-05-12,73,0,38.8242073059082,2834.167133331299,4,5,0,19,51438,3
100116,Groceries,45.46712112426758,2023-05-13,90,0,38.8242073059082,3494.1786575317383,5,5,1,19,51528,3
100116,Groceries,45.46712112426758,2023-05-14,56,0,38.8242073059082,2174.1556091308594,6,5,1,19,51584,3
100116,Groceries,45.46712112426758,2023-05-15,115,416,43.62664825439453,23546.019098510744,0,5,0,20,51699,3
100116,Groceries,45.46712112426758,2023-05-16,114,0,42.36329650878906,4829.415802001953,1,5,0,20,51813,3
100116,Groceries,45.46712112426758,2023-05-17,68,0,42.36329650878906,2880.7041625976562,2,5,0,20,51881,3
100116,Groceries,45.46712112426758,2023-05-18,140,470,41.38892356872559,25148.598599243167,3,5,0,20,52021,3
100116,Groceries,45.46712112426758,2023-05-19,88,0,41.68784713745117,3668.530548095703,4,5,0,20,52109,3
100116,Groceries,45.46712112426758,2023-05-20,188,594,47.447126388549805,37937.11952209473,5,5,1,20,52297,3
100116,Groceries,45.46712112426758,2023-05-21,148,0,45.39425277709961,6718.349411010742,6,5,1,20,52445,3
100116,Groceries,45.46712112426758,2023-05-22,58,0,45.39425277709961,2632.8666610717773,0,5,0,21,52503,3
100116,Groceries,45.46712112426758,2023-05-23,31,0,45.39425277709961,1407.221836090088,1,5,0,21,52534,3
100116,Groceries,45.46712112426758,2023-05-24,110,0,45.39425277709961,4993.367805480957,2,5,0,21,52644,3
100116,Groceries,45.46712112426758,2023-05-25,136,0,45.39425277709961,6173.618377685547,3,5,0,21,52780,3
100116,Groceries,45.46712112426758,2023-05-26,53,0,45.39425277709961,2405.8953971862793,4,5,0,21,52833,3
100116,Groceries,45.46712112426758,2023-05-27,103,0,45.39425277709961,4675.60803604126,5,5,1,21,52936,3
100116,Groceries,45.46712112426758,2023-05-28,133,0,45.39425277709961,6037.435619354248,6,5,1,21,53069,3
100116,Groceries,45.46712112426758,2023-05-29,115,266,41.93562934875489,15792.404750213624,0,5,0,22,53184,3
100116,Groceries,45.46712112426758,2023-05-30,69,0,43.161258697509766,2978.126850128174,1,5,0,22,53253,3
100116,Groceries,45.46712112426758,2023-05-31,73,412,40.52348098754883,19374.72822418213,2,5,0,22,53326,3
100116,Groceries,45.46712112426758,2023-06-01,123,0,41.346961975097656,5085.676322937012,3,6,0,22,53449,3
100116,Groceries,45.46712112426758,2023-06-02,69,0,41.346961975097656,2852.9403762817383,4,6,0,22,53518,3
100116,Groceries,45.46712112426758,2023-06-03,168,508,43.425450744628904,29595.151450195313,5,6,1,22,53686,3
100116,Groceries,45.46712112426758,2023-06-04,85,0,42.72090148925781,3631.276626586914,6,6,1,22,53771,3
100116,Groceries,45.46712112426758,2023-06-05,210,0,42.72090148925781,8971.38931274414,0,6,0,23,53981,3
100116,Groceries,45.46712112426758,2023-06-06,152,0,42.72090148925781,6493.5770263671875,1,6,0,23,54133,3
100116,Groceries,45.46712112426758,2023-06-07,244,671,43.917811965942384,40305.29223937988,2,6,0,23,54377,3
100116,Groceries,45.46712112426758,2023-06-08,130,0,43.635623931884766,5672.6311111450195,3,6,0,23,54507,3
100116,Groceries,45.46712112426758,2023-06-09,40,0,43.635623931884766,1745.4249572753906,4,6,0,23,54547,3
100116,Groceries,45.46712112426758,2023-06-10,80,0,43.635623931884766,3490.8499145507812,5,6,1,23,54627,3
100116,Groceries,45.46712112426758,2023-06-11,83,0,43.635623931884766,3621.7567863464355,6,6,1,23,54710,3
100116,Groceries,45.46712112426758,2023-06-12,158,559,40.827365493774415,28921.397496032718,0,6,0,24,54868,3
100116,Groceries,45.46712112426758,2023-06-13,201,0,41.70473098754883,8382.650928497314,1,6,0,24,55069,3
100116,Groceries,45.46712112426758,2023-06-14,131,0,41.70473098754883,5463.3197593688965,2,6,0,24,55200,3
100116,Groceries,45.46712112426758,2023-06-15,64,0,41.70473098754883,2669.102783203125,3,6,0,24,55264,3
100116,Groceries,45.46712112426758,2023-06-16,262,619,43.41804214477539,38430.4940838623,4,6,0,24,55526,3
100116,Groceries,45.46712112426758,2023-06-17,172,0,42.91608428955078,7381.566497802734,5,6,1,24,55698,3
100116,Groceries,45.46712112426758,2023-06-18,79,0,42.91608428955078,3390.3706588745117,6,6,1,24,55777,3
100116,Groceries,45.46712112426758,2023-06-19,397,937,52.91685600280762,71931.98366622924,0,6,0,25,56174,3
100116,Groceries,45.46712112426758,2023-06-20,133,0,50.433712005615234,6707.683696746826,1,6,0,25,56307,3
100116,Groceries,45.46712112426758,2023-06-21,89,0,50.433712005615234,4488.600368499756,2,6,0,25,56396,3
100116,Groceries,45.46712112426758,2023-06-22,79,0,50.433712005615234,3984.2632484436035,3,6,0,25,56475,3
100116,Groceries,45.46712112426758,2023-06-23,100,0,50.433712005615234,5043.371200561523,4,6,0,25,56575,3
100116,Groceries,45.46712112426758,2023-06-24,103,0,50.433712005615234,5194.672336578369,5,6,1,25,56678,3
100116,Groceries,45.46712112426758,2023-06-25,192,0,50.433712005615234,9683.272705078125,6,6,1,25,56870,3
100116,Groceries,45.46712112426758,2023-06-26,183,615,52.70017066955566,42322.502465057376,0,6,0,26,57053,3
100116,Groceries,45.46712112426758,2023-06-27,210,0,52.08034133911133,10936.871681213379,1,6,0,26,57263,3
100116,Groceries,45.46712112426758,2023-06-28,70,0,52.08034133911133,3645.623893737793,2,6,0,26,57333,3
100116,Groceries,45.46712112426758,2023-06-29,168,0,52.08034133911133,8749.497344970703,3,6,0,26,57501,3
100116,Groceries,45.46712112426758,2023-06-30,104,0,52.08034133911133,5416.355499267578,4,6,0,26,57605,3
100116,Groceries,45.46712112426758,2023-07-01,103,478,42.69752632141113,23878.190422210693,5,7,1,26,57708,3
100116,Groceries,45.46712112426758,2023-07-02,127,0,45.175052642822266,5737.231685638428,6,7,1,26,57835,3
100116,Groceries,45.46712112426758,2023-07-03,113,671,52.469712829589845,42380.75509948731,0,7,0,27,57948,3
100116,Groceries,45.46712112426758,2023-07-04,84,0,50.23942565917969,4220.111755371094,1,7,0,27,58032,3
100116,Groceries,45.46712112426758,2023-07-05,48,0,50.23942565917969,2411.492431640625,2,7,0,27,58080,3
100116,Groceries,45.46712112426758,2023-07-06,51,0,50.23942565917969,2562.210708618164,3,7,0,27,58131,3
100116,Groceries,45.46712112426758,2023-07-07,102,0,50.23942565917969,5124.421417236328,4,7,0,27,58233,3
100116,Groceries,45.46712112426758,2023-07-08,153,0,50.23942565917969,7686.632125854492,5,7,1,27,58386,3
100116,Groceries,45.46712112426758,2023-07-09,90,0,50.23942565917969,4521.548309326172,6,7,1,27,58476,3
100116,Groceries,45.46712112426758,2023-07-10,133,0,50.23942565917969,6681.843612670898,0,7,0,28,58609,3
100116,Groceries,45.46712112426758,2023-07-11,61,0,50.23942565917969,3064.604965209961,1,7,0,28,58670,3
100116,Groceries,45.46712112426758,2023-07-12,85,481,38.62152328491211,20445.458958435058,2,7,0,28,58755,3
100116,Groceries,45.46712112426758,2023-07-13,42,0,42.19304656982422,1772.1079559326172,3,7,0,28,58797,3
100116,Groceries,45.46712112426758,2023-07-14,178,0,42.19304656982422,7510.362289428711,4,7,0,28,58975,3
100116,Groceries,45.46712112426758,2023-07-15,81,0,42.19304656982422,3417.6367721557617,5,7,1,28,59056,3
100116,Groceries,45.46712112426758,2023-07-16,340,1011,54.21353324890137,74897.48260925294,6,7,1,28,59396,3
100116,Groceries,45.46712112426758,2023-07-17,108,0,51.747066497802734,5588.683181762695,0,7,0,29,59504,3
100116,Groceries,45.46712112426758,2023-07-18,74,0,51.747066497802734,3829.2829208374023,1,7,0,29,59578,3
100116,Groceries,45.46712112426758,2023-07-19,101,0,51.747066497802734,5226.453716278076,2,7,0,29,59679,3
100116,Groceries,45.46712112426758,2023-07-20,176,0,51.747066497802734,9107.483703613281,3,7,0,29,59855,3
100116,Groceries,45.46712112426758,2023-07-21,152,0,51.747066497802734,7865.554107666016,4,7,0,29,60007,3
100116,Groceries,45.46712112426758,2023-07-22,181,0,51.747066497802734,9366.219036102295,5,7,1,29,60188,3
100116,Groceries,45.46712112426758,2023-07-23,107,481,44.826158065795894,25596.25782608032,6,7,1,29,60295,3
100116,Groceries,45.46712112426758,2023-07-24,179,0,46.8623161315918,8388.354587554932,0,7,0,30,60474,3
100116,Groceries,45.46712112426758,2023-07-25,104,0,46.8623161315918,4873.680877685547,1,7,0,30,60578,3
100116,Groceries,45.46712112426758,2023-07-26,155,545,40.59052116394043,27652.661560821532,2,7,0,30,60733,3
100116,Groceries,45.46712112426758,2023-07-27,138,0,42.54104232788086,5870.663841247559,3,7,0,30,60871,3
100116,Groceries,45.46712112426758,2023-07-28,164,0,42.54104232788086,6976.730941772461,4,7,0,30,61035,3
100116,Groceries,45.46712112426758,2023-07-29,75,0,42.54104232788086,3190.5781745910645,5,7,1,30,61110,3
100116,Groceries,45.46712112426758,2023-07-30,147,520,45.464451751708985,30681.208815002443,6,7,1,30,61257,3
100116,Groceries,45.46712112426758,2023-07-31,124,0,44.50890350341797,5519.104034423828,0,7,0,31,61381,3
100116,Groceries,45.46712112426758,2023-08-01,201,697,52.414828033447264,48445.0008694458,1,8,0,31,61582,3
100116,Groceries,45.46712112426758,2023-08-02,171,0,49.63965606689453,8488.381187438965,2,8,0,31,61753,3
100116,Groceries,45.46712112426758,2023-08-03,212,0,49.63965606689453,10523.60708618164,3,8,0,31,61965,3
100116,Groceries,45.46712112426758,2023-08-04,204,0,49.63965606689453,10126.489837646484,4,8,0,31,62169,3
100116,Groceries,45.46712112426758,2023-08-05,139,0,49.63965606689453,6899.91219329834,5,8,1,31,62308,3
100116,Groceries,45.46712112426758,2023-08-06,212,620,48.313837966918946,40036.427297973634,6,8,1,31,62520,3
100116,Groceries,45.46712112426758,2023-08-07,85,0,48.70767593383789,4140.152454376221,0,8,0,32,62605,3
100116,Groceries,45.46712112426758,2023-08-08,217,0,48.70767593383789,10569.565677642822,1,8,0,32,62822,3
100116,Groceries,45.46712112426758,2023-08-09,140,0,48.70767593383789,6819.074630737305,2,8,0,32,62962,3
100116,Groceries,45.46712112426758,2023-08-10,142,0,48.70767593383789,6916.4899826049805,3,8,0,32,63104,3
100116,Groceries,45.46712112426758,2023-08-11,82,0,48.70767593383789,3994.029426574707,4,8,0,32,63186,3
100116,Groceries,45.46712112426758,2023-08-12,67,379,40.120621032714844,17197.843218383787,5,8,1,32,63253,3
100116,Groceries,45.46712112426758,2023-08-13,110,0,42.35124206542969,4658.636627197266,6,8,1,32,63363,3
100116,Groceries,45.46712112426758,2023-08-14,89,845,56.945071868896484,55579.38279266357,0,8,0,33,63452,3
100116,Groceries,45.46712112426758,2023-08-15,46,0,53.78014373779297,2473.8866119384766,1,8,0,33,63498,3
100116,Groceries,45.46712112426758,2023-08-16,176,0,53.78014373779297,9465.305297851562,2,8,0,33,63674,3
100116,Groceries,45.46712112426758,2023-08-17,169,0,53.78014373779297,9088.844291687012,3,8,0,33,63843,3
100116,Groceries,45.46712112426758,2023-08-18,113,0,53.78014373779297,6077.1562423706055,4,8,0,33,63956,3
100116,Groceries,45.46712112426758,2023-08-19,119,0,53.78014373779297,6399.837104797363,5,8,1,33,64075,3
100116,Groceries,45.46712112426758,2023-08-20,66,0,53.78014373779297,3549.489486694336,6,8,1,33,64141,3
100116,Groceries,45.46712112426758,2023-08-21,184,644,46.296301651000974,37323.03900756836,0,8,0,34,64325,3
100116,Groceries,45.46712112426758,2023-08-22,88,0,48.49260330200195,4267.349090576172,1,8,0,34,64413,3
100116,Groceries,45.46712112426758,2023-08-23,63,0,48.49260330200195,3055.034008026123,2,8,0,34,64476,3
100116,Groceries,45.46712112426758,2023-08-24,122,0,48.49260330200195,5916.097602844238,3,8,0,34,64598,3
100116,Groceries,45.46712112426758,2023-08-25,94,0,48.49260330200195,4558.304710388184,4,8,0,34,64692,3
100116,Groceries,45.46712112426758,2023-08-26,60,0,48.49260330200195,2909.556198120117,5,8,1,34,64752,3
100116,Groceries,45.46712112426758,2023-08-27,5,0,48.49260330200195,242.46301651000977,6,8,1,34,64757,3
100116,Groceries,45.46712112426758,2023-08-28,77,0,48.49260330200195,3733.9304542541504,0,8,0,35,64834,3
100116,Groceries,45.46712112426758,2023-08-29,59,0,48.49260330200195,2861.0635948181152,1,8,0,35,64893,3
100116,Groceries,45.46712112426758,2023-08-30,103,0,48.49260330200195,4994.738140106201,2,8,0,35,64996,3
100116,Groceries,45.46712112426758,2023-08-31,102,307,40.50057327270508,15998.816947631836,3,8,0,35,65098,3
100116,Groceries,45.46712112426758,2023-09-01,128,0,43.261146545410156,5537.4267578125,4,9,0,35,65226,3
100116,Groceries,45.46712112426758,2023-09-02,83,0,43.261146545410156,3590.675163269043,5,9,1,35,65309,3
100116,Groceries,45.46712112426758,2023-09-03,205,499,47.92340507507324,34069.29608078003,6,9,1,35,65514,3
100116,Groceries,45.46712112426758,2023-09-04,113,0,46.796810150146484,5288.039546966553,0,9,0,36,65627,3
100116,Groceries,45.46712112426758,2023-09-05,0,424,36.17,15336.08,1,9,0,36,65627,3
100116,Groceries,45.46712112426758,2023-09-06,114,0,41.91515350341797,4778.327499389648,2,9,0,36,65741,3
100116,Groceries,45.46712112426758,2023-09-07,172,0,41.91515350341797,7209.406402587891,3,9,0,36,65913,3
100116,Groceries,45.46712112426758,2023-09-08,134,0,41.91515350341797,5616.630569458008,4,9,0,36,66047,3
100116,Groceries,45.46712112426758,2023-09-09,136,0,41.91515350341797,5700.460876464844,5,9,1,36,66183,3
100116,Groceries,45.46712112426758,2023-09-10,74,0,41.91515350341797,3101.7213592529297,6,9,1,36,66257,3
100116,Groceries,45.46712112426758,2023-09-11,97,423,38.64995124816895,19824.150542144776,0,9,0,37,66354,3
100116,Groceries,45.46712112426758,2023-09-12,142,0,39.48990249633789,5607.5661544799805,1,9,0,37,66496,3
100116,Groceries,45.46712112426758,2023-09-13,54,0,39.48990249633789,2132.454734802246,2,9,0,37,66550,3
100116,Groceries,45.46712112426758,2023-09-14,129,387,42.56375236511231,22243.148110198974,3,9,0,37,66679,3
100116,Groceries,45.46712112426758,2023-09-15,143,0,41.47750473022461,5931.283176422119,4,9,0,37,66822,3
100116,Groceries,45.46712112426758,2023-09-16,63,0,41.47750473022461,2613.0827980041504,5,9,1,37,66885,3
100116,Groceries,45.46712112426758,2023-09-17,60,0,41.47750473022461,2488.6502838134766,6,9,1,37,66945,3
100116,Groceries,45.46712112426758,2023-09-18,90,466,43.48232917785644,24408.419252014162,0,9,0,38,67035,3
100116,Groceries,45.46712112426758,2023-09-19,74,0,42.86465835571289,3171.984718322754,1,9,0,38,67109,3
100116,Groceries,45.46712112426758,2023-09-20,172,0,42.86465835571289,7372.721237182617,2,9,0,38,67281,3
100116,Groceries,45.46712112426758,2023-09-21,44,0,42.86465835571289,1886.0449676513672,3,9,0,38,67325,3
100116,Groceries,45.46712112426758,2023-09-22,98,0,42.86465835571289,4200.736518859863,4,9,0,38,67423,3
100116,Groceries,45.46712112426758,2023-09-23,195,587,47.27336235046387,37409.41131668091,5,9,1,38,67618,3
100116,Groceries,45.46712112426758,2023-09-24,77,0,46.146724700927734,3553.2978019714355,6,9,1,38,67695,3
100116,Groceries,45.46712112426758,2023-09-25,89,0,46.146724700927734,4107.058498382568,0,9,0,39,67784,3
100116,Groceries,45.46712112426758,2023-09-26,114,0,46.146724700927734,5260.726615905762,1,9,0,39,67898,3
100116,Groceries,45.46712112426758,2023-09-27,165,556,44.83515449523926,32163.820983428956,2,9,0,39,68063,3
100116,Groceries,45.46712112426758,2023-09-28,67,0,45.250308990478516,3031.7707023620605,3,9,0,39,68130,3
100116,Groceries,45.46712112426758,2023-09-29,131,0,45.250308990478516,5927.790477752686,4,9,0,39,68261,3
100116,Groceries,45.46712112426758,2023-09-30,62,0,45.250308990478516,2805.519157409668,5,9,1,39,68323,3
100116,Groceries,45.46712112426758,2023-10-01,90,0,45.250308990478516,4072.5278091430664,6,10,1,39,68413,3
100116,Groceries,45.46712112426758,2023-10-02,154,529,46.85664184570312,32210.595688476562,0,10,0,40,68567,3
100116,Groceries,45.46712112426758,2023-10-03,119,0,46.30328369140625,5510.090759277344,1,10,0,40,68686,3
100116,Groceries,45.46712112426758,2023-10-04,125,0,46.30328369140625,5787.910461425781,2,10,0,40,68811,3
100116,Groceries,45.46712112426758,2023-10-05,182,0,46.30328369140625,8427.197631835938,3,10,0,40,68993,3
100116,Groceries,45.46712112426758,2023-10-06,115,0,46.30328369140625,5324.877624511719,4,10,0,40,69108,3
100116,Groceries,45.46712112426758,2023-10-07,95,333,42.10901954650879,17653.993713836673,5,10,1,40,69203,3
100116,Groceries,45.46712112426758,2023-10-08,38,0,43.65803909301758,1659.005485534668,6,10,1,40,69241,3
100116,Groceries,45.46712112426758,2023-10-09,122,0,43.65803909301758,5326.2807693481445,0,10,0,41,69363,3
100116,Groceries,45.46712112426758,2023-10-10,52,0,43.65803909301758,2270.218032836914,1,10,0,41,69415,3
100116,Groceries,45.46712112426758,2023-10-11,96,0,43.65803909301758,4191.1717529296875,2,10,0,41,69511,3
100116,Groceries,45.46712112426758,2023-10-12,85,0,43.65803909301758,3710.933322906494,3,10,0,41,69596,3
100116,Groceries,45.46712112426758,2023-10-13,75,242,35.17320556640625,10686.780834960937,4,10,0,41,69671,3
100116,Groceries,45.46712112426758,2023-10-14,41,0,37.9464111328125,1555.8028564453125,5,10,1,41,69712,3
100116,Groceries,45.46712112426758,2023-10-15,82,0,37.9464111328125,3111.605712890625,6,10,1,41,69794,3
100116,Groceries,45.46712112426758,2023-10-16,78,185,36.66211097717285,9583.059312438963,0,10,0,42,69872,3
100116,Groceries,45.46712112426758,2023-10-17,32,0,37.2142219543457,1190.8551025390625,1,10,0,42,69904,3
100116,Groceries,45.46712112426758,2023-10-18,39,0,37.2142219543457,1451.3546562194824,2,10,0,42,69943,3
100116,Groceries,45.46712112426758,2023-10-19,86,307,38.025064849853514,15004.611154174803,3,10,0,42,70029,3
100116,Groceries,45.46712112426758,2023-10-20,143,0,37.75012969970703,5398.2685470581055,4,10,0,42,70172,3
100116,Groceries,45.46712112426758,2023-10-21,86,0,37.75012969970703,3246.5111541748047,5,10,1,42,70258,3
100116,Groceries,45.46712112426758,2023-10-22,34,0,37.75012969970703,1283.504409790039,6,10,1,42,70292,3
100116,Groceries,45.46712112426758,2023-10-23,95,215,33.0105485534668,10012.40422515869,0,10,0,43,70387,3
100116,Groceries,45.46712112426758,2023-10-24,69,0,34.851097106933594,2404.725700378418,1,10,0,43,70456,3
100116,Groceries,45.46712112426758,2023-10-25,100,394,43.59292251586914,22283.744503173828,2,10,0,43,70556,3
100116,Groceries,45.46712112426758,2023-10-26,133,0,41.04584503173828,5459.097389221191,3,10,0,43,70689,3
100116,Groceries,45.46712112426758,2023-10-27,89,527,45.846975021362304,28904.44155380249,4,10,0,43,70778,3
100116,Groceries,45.46712112426758,2023-10-28,131,0,44.33395004272461,5807.747455596924,5,10,1,43,70909,3
100116,Groceries,45.46712112426758,2023-10-29,82,0,44.33395004272461,3635.383903503418,6,10,1,43,70991,3
100116,Groceries,45.46712112426758,2023-10-30,64,0,44.33395004272461,2837.372802734375,0,10,0,44,71055,3
100116,Groceries,45.46712112426758,2023-10-31,76,0,44.33395004272461,3369.3802032470703,1,10,0,44,71131,3
100116,Groceries,45.46712112426758,2023-11-01,113,0,44.33395004272461,5009.736354827881,2,11,0,44,71244,3
100116,Groceries,45.46712112426758,2023-11-02,90,0,44.33395004272461,3990.055503845215,3,11,0,44,71334,3
100116,Groceries,45.46712112426758,2023-11-03,109,359,42.17145988464355,19553.378254852294,4,11,0,44,71443,3
100116,Groceries,45.46712112426758,2023-11-04,148,0,42.90291976928711,6349.632125854492,5,11,1,44,71591,3
100116,Groceries,45.46712112426758,2023-11-05,110,582,39.55230323791504,26915.98671234131,6,11,1,44,71701,3
100116,Groceries,45.46712112426758,2023-11-06,90,0,40.51460647583008,3646.314582824707,0,11,0,45,71791,3
100116,Groceries,45.46712112426758,2023-11-07,137,0,40.51460647583008,5550.501087188721,1,11,0,45,71928,3
100116,Groceries,45.46712112426758,2023-11-08,74,0,40.51460647583008,2998.080879211426,2,11,0,45,72002,3
100116,Groceries,45.46712112426758,2023-11-09,74,0,40.51460647583008,2998.080879211426,3,11,0,45,72076,3
100116,Groceries,45.46712112426758,2023-11-10,49,0,40.51460647583008,1985.2157173156738,4,11,0,45,72125,3
100116,Groceries,45.46712112426758,2023-11-11,45,0,40.51460647583008,1823.1572914123535,5,11,1,45,72170,3
100116,Groceries,45.46712112426758,2023-11-12,121,0,40.51460647583008,4902.267383575439,6,11,1,45,72291,3
100116,Groceries,45.46712112426758,2023-11-13,125,300,36.08492813110352,15049.982032775879,0,11,0,46,72416,3
100116,Groceries,45.46712112426758,2023-11-14,110,0,37.71985626220703,4149.184188842773,1,11,0,46,72526,3
100116,Groceries,45.46712112426758,2023-11-15,83,0,37.71985626220703,3130.7480697631836,2,11,0,46,72609,3
100116,Groceries,45.46712112426758,2023-11-16,34,0,37.71985626220703,1282.475112915039,3,11,0,46,72643,3
100116,Groceries,45.46712112426758,2023-11-17,169,620,44.53578727722168,35735.956099700925,4,11,0,46,72812,3
100116,Groceries,45.46712112426758,2023-11-18,90,0,43.21157455444336,3889.0417098999023,5,11,1,46,72902,3
100116,Groceries,45.46712112426758,2023-11-19,40,0,43.21157455444336,1728.4629821777344,6,11,1,46,72942,3
100116,Groceries,45.46712112426758,2023-11-20,62,0,43.21157455444336,2679.1176223754883,0,11,0,47,73004,3
100116,Groceries,45.46712112426758,2023-11-21,167,744,52.55247955322265,49345.22817077637,1,11,0,47,73171,3
100116,Groceries,45.46712112426758,2023-11-22,91,0,50.00495910644531,4550.451278686523,2,11,0,47,73262,3
100116,Groceries,45.46712112426758,2023-11-23,113,0,50.00495910644531,5650.56037902832,3,11,0,47,73375,3
100116,Groceries,45.46712112426758,2023-11-24,115,0,50.00495910644531,5750.570297241211,4,11,0,47,73490,3
100116,Groceries,45.46712112426758,2023-11-25,146,0,50.00495910644531,7300.724029541016,5,11,1,47,73636,3
100116,Groceries,45.46712112426758,2023-11-26,75,0,50.00495910644531,3750.3719329833984,6,11,1,47,73711,3
100116,Groceries,45.46712112426758,2023-11-27,120,0,50.00495910644531,6000.5950927734375,0,11,0,48,73831,3
100116,Groceries,45.46712112426758,2023-11-28,89,0,50.00495910644531,4450.441360473633,1,11,0,48,73920,3
100116,Groceries,45.46712112426758,2023-11-29,80,372,41.94367668151855,18154.46826904297,2,11,0,48,74000,3
100116,Groceries,45.46712112426758,2023-11-30,78,0,44.69735336303711,3486.3935623168945,3,11,0,48,74078,3
100116,Groceries,45.46712112426758,2023-12-01,143,0,44.69735336303711,6391.721530914307,4,12,0,48,74221,3
100116,Groceries,45.46712112426758,2023-12-02,99,0,44.69735336303711,4425.037982940674,5,12,1,48,74320,3
100116,Groceries,45.46712112426758,2023-12-03,239,670,46.58253501892089,42514.83173904419,6,12,1,48,74559,3
100116,Groceries,45.46712112426758,2023-12-04,101,0,46.1850700378418,4664.6920738220215,0,12,0,49,74660,3
100116,Groceries,45.46712112426758,2023-12-05,18,618,48.45006454467773,31300.2023236084,1,12,0,49,74678,3
100116,Groceries,45.46712112426758,2023-12-06,118,0,47.64012908935547,5621.535232543945,2,12,0,49,74796,3
100116,Groceries,45.46712112426758,2023-12-07,236,0,47.64012908935547,11243.07046508789,3,12,0,49,75032,3
100116,Groceries,45.46712112426758,2023-12-08,67,0,47.64012908935547,3191.8886489868164,4,12,0,49,75099,3
100116,Groceries,45.46712112426758,2023-12-09,110,0,47.64012908935547,5240.414199829102,5,12,1,49,75209,3
100116,Groceries,45.46712112426758,2023-12-10,56,0,47.64012908935547,2667.8472290039062,6,12,1,49,75265,3
100116,Groceries,45.46712112426758,2023-12-11,92,0,47.64012908935547,4382.891876220703,0,12,0,50,75357,3
100116,Groceries,45.46712112426758,2023-12-12,108,0,47.64012908935547,5145.133941650391,1,12,0,50,75465,3
100116,Groceries,45.46712112426758,2023-12-13,122,0,47.64012908935547,5812.095748901367,2,12,0,50,75587,3
100116,Groceries,45.46712112426758,2023-12-14,161,520,50.0944709777832,34349.66965484619,3,12,0,50,75748,3
100116,Groceries,45.46712112426758,2023-12-15,42,0,49.438941955566406,2076.435562133789,4,12,0,50,75790,3
100116,Groceries,45.46712112426758,2023-12-16,67,0,49.438941955566406,3312.409111022949,5,12,1,50,75857,3
100116,Groceries,45.46712112426758,2023-12-17,103,0,49.438941955566406,5092.21102142334,6,12,1,50,75960,3
100116,Groceries,45.46712112426758,2023-12-18,123,0,49.438941955566406,6080.989860534668,0,12,0,51,76083,3
100116,Groceries,45.46712112426758,2023-12-19,122,0,49.438941955566406,6031.550918579102,1,12,0,51,76205,3
100116,Groceries,45.46712112426758,2023-12-20,45,0,49.438941955566406,2224.7523880004883,2,12,0,51,76250,3
100116,Groceries,45.46712112426758,2023-12-21,61,201,37.62138557434082,9244.80904006958,3,12,0,51,76311,3
100116,Groceries,45.46712112426758,2023-12-22,112,444,40.04068420410157,22069.83326171875,4,12,0,51,76423,3
100116,Groceries,45.46712112426758,2023-12-23,63,0,40.621368408203125,2559.146209716797,5,12,1,51,76486,3
100116,Groceries,45.46712112426758,2023-12-24,78,0,40.621368408203125,3168.4667358398438,6,12,1,51,76564,3
100116,Groceries,45.46712112426758,2023-12-25,63,0,40.621368408203125,2559.146209716797,0,12,0,52,76627,3
100116,Groceries,45.46712112426758,2023-12-26,126,0,40.621368408203125,5118.292419433594,1,12,0,52,76753,3
100116,Groceries,45.46712112426758,2023-12-27,33,0,40.621368408203125,1340.5051574707031,2,12,0,52,76786,3
100116,Groceries,45.46712112426758,2023-12-28,76,242,40.924038314819335,13034.753823852538,3,12,0,52,76862,3
100116,Groceries,45.46712112426758,2023-12-29,88,0,40.79807662963867,3590.230743408203,4,12,0,52,76950,3
100116,Groceries,45.46712112426758,2023-12-30,43,0,40.79807662963867,1754.317295074463,5,12,1,52,76993,3
100116,Groceries,45.46712112426758,2023-12-31,46,0,40.79807662963867,1876.711524963379,6,12,1,52,77039,3
100116,Groceries,45.46712112426758,2024-01-01,81,0,40.79807662963867,3304.6442070007324,0,1,0,1,77120,3
100116,Groceries,45.46712112426758,2024-01-02,74,0,40.79807662963867,3019.0576705932617,1,1,0,1,77194,3
100116,Groceries,45.46712112426758,2024-01-03,81,255,36.402068023681636,12032.375019836425,2,1,0,1,77275,3
100116,Groceries,45.46712112426758,2024-01-04,41,0,37.54413604736328,1539.3095779418945,3,1,0,1,77316,3
100116,Groceries,45.46712112426758,2024-01-05,57,0,37.54413604736328,2140.015754699707,4,1,0,1,77373,3
100116,Groceries,45.46712112426758,2024-01-06,87,253,36.147868957519535,12212.609198608397,5,1,1,1,77460,3
100116,Groceries,45.46712112426758,2024-01-07,86,0,36.61573791503906,3148.9534606933594,6,1,1,1,77546,3
100116,Groceries,45.46712112426758,2024-01-08,60,0,36.61573791503906,2196.9442749023438,0,1,0,2,77606,3
100116,Groceries,45.46712112426758,2024-01-09,94,275,33.476434555053714,12163.399696350098,1,1,0,2,77700,3
100116,Groceries,45.46712112426758,2024-01-10,115,0,34.52286911010742,3970.1299476623535,2,1,0,2,77815,3
100116,Groceries,45.46712112426758,2024-01-11,66,0,34.52286911010742,2278.50936126709,3,1,0,2,77881,3
100116,Groceries,45.46712112426758,2024-01-12,40,0,34.52286911010742,1380.9147644042969,4,1,0,2,77921,3
100116,Groceries,45.46712112426758,2024-01-13,143,485,39.474358291625975,25120.146471405027,5,1,1,2,78064,3
100116,Groceries,45.46712112426758,2024-01-14,92,0,38.50871658325195,3542.8019256591797,6,1,1,2,78156,3
100116,Groceries,45.46712112426758,2024-01-15,0,575,48.07,27640.25,0,1,0,3,78156,3
100116,Groceries,45.46712112426758,2024-01-16,127,0,43.69526290893555,5549.298389434814,1,1,0,3,78283,3
100116,Groceries,45.46712112426758,2024-01-17,98,0,43.69526290893555,4282.135765075684,2,1,0,3,78381,3
100116,Groceries,45.46712112426758,2024-01-18,111,0,43.69526290893555,4850.174182891846,3,1,0,3,78492,3
100116,Groceries,45.46712112426758,2024-01-19,77,0,43.69526290893555,3364.535243988037,4,1,0,3,78569,3
100116,Groceries,45.46712112426758,2024-01-20,174,0,43.69526290893555,7602.975746154785,5,1,1,3,78743,3
100116,Groceries,45.46712112426758,2024-01-21,97,0,43.69526290893555,4238.440502166748,6,1,1,3,78840,3
100116,Groceries,45.46712112426758,2024-01-22,156,386,44.1357332611084,23954.748777465822,0,1,0,4,78996,3
100116,Groceries,45.46712112426758,2024-01-23,122,0,43.9914665222168,5366.958915710449,1,1,0,4,79118,3
100116,Groceries,45.46712112426758,2024-01-24,92,414,44.69899223327637,22701.73457092285,2,1,0,4,79210,3
100116,Groceries,45.46712112426758,2024-01-25,186,0,44.437984466552734,8265.465110778809,3,1,0,4,79396,3
100116,Groceries,45.46712112426758,2024-01-26,98,0,44.437984466552734,4354.922477722168,4,1,0,4,79494,3
100116,Groceries,45.46712112426758,2024-01-27,56,0,44.437984466552734,2488.527130126953,5,1,1,4,79550,3
100116,Groceries,45.46712112426758,2024-01-28,163,447,46.003560562133785,28214.520743255616,6,1,1,4,79713,3
100116,Groceries,45.46712112426758,2024-01-29,78,0,45.46712112426758,3546.435447692871,0,1,0,5,79791,3
100116,Groceries,45.46712112426758,2024-01-30,66,0,45.46712112426758,3000.82999420166,1,1,0,5,79857,3
100117,Toys,21.962413787841797,2022-01-01,59,128,21.20999954223633,3966.269945983887,5,1,1,52,59,4
100117,Toys,21.962413787841797,2022-01-02,33,50,18.76020992279053,1540.0938549041748,6,1,1,52,92,4
100117,Toys,21.962413787841797,2022-01-03,59,94,22.028211708068845,3395.228981552124,0,1,0,1,151,4
100117,Toys,21.962413787841797,2022-01-04,59,0,21.316423416137695,1257.668981552124,1,1,0,1,210,4
100117,Toys,21.962413787841797,2022-01-05,36,52,18.836308555603026,1642.7742160034181,2,1,0,1,246,4
100117,Toys,21.962413787841797,2022-01-06,78,138,23.43158351898193,5109.7270289611815,3,1,0,1,324,4
100117,Toys,21.962413787841797,2022-01-07,79,118,22.189877166748047,4365.170592346191,4,1,0,1,403,4
100117,Toys,21.962413787841797,2022-01-08,79,0,22.349754333496094,1765.6305923461914,5,1,1,1,482,4
100117,Toys,21.962413787841797,2022-01-09,70,93,19.093601570129394,3086.4142198181153,6,1,1,1,552,4
100117,Toys,21.962413787841797,2022-01-10,85,77,20.073311691284182,3252.382987518311,0,1,0,2,637,4
100117,Toys,21.962413787841797,2022-01-11,88,98,21.274048538208007,3961.1325427246097,1,1,0,2,725,4
100117,Toys,21.962413787841797,2022-01-12,96,173,24.717763175964357,6727.020529785156,2,1,0,2,821,4
100117,Toys,21.962413787841797,2022-01-13,70,0,23.70552635192871,1659.3868446350098,3,1,0,2,891,4
100117,Toys,21.962413787841797,2022-01-14,86,117,22.773032875061034,4612.601654510498,4,1,0,2,977,4
100117,Toys,21.962413787841797,2022-01-15,79,0,23.10606575012207,1825.3791942596436,5,1,1,2,1056,4
100117,Toys,21.962413787841797,2022-01-16,75,90,20.504295082092284,3370.994262313843,6,1,1,2,1131,4
100117,Toys,21.962413787841797,2022-01-17,54,87,21.945579490661622,3101.732584991455,0,1,0,3,1185,4
100117,Toys,21.962413787841797,2022-01-18,130,160,25.684914627075194,7482.97780303955,1,1,0,3,1315,4
100117,Toys,21.962413787841797,2022-01-19,74,0,24.53982925415039,1815.947364807129,2,1,0,3,1389,4
100117,Toys,21.962413787841797,2022-01-20,86,128,25.299078102111814,5422.021433563232,3,1,0,3,1475,4
100117,Toys,21.962413787841797,2022-01-21,128,151,22.1966743850708,6172.938642578125,4,1,0,3,1603,4
100117,Toys,21.962413787841797,2022-01-22,84,0,23.0633487701416,1937.3212966918945,5,1,1,3,1687,4
100117,Toys,21.962413787841797,2022-01-23,67,104,18.75875518798828,3168.94319519043,6,1,1,3,1754,4
100117,Toys,21.962413787841797,2022-01-24,47,75,19.277154235839845,2345.7324981689453,0,1,0,4,1801,4
100117,Toys,21.962413787841797,2022-01-25,71,124,22.52665714263916,4448.525314254761,1,1,0,4,1872,4
100117,Toys,21.962413787841797,2022-01-26,45,0,21.47331428527832,966.2991428375244,2,1,0,4,1917,4
100117,Toys,21.962413787841797,2022-01-27,51,0,21.47331428527832,1095.1390285491943,3,1,0,4,1968,4
100117,Toys,21.962413787841797,2022-01-28,89,130,25.996518325805663,5740.530261993408,4,1,0,4,2057,4
100117,Toys,21.962413787841797,2022-01-29,128,106,23.47863338470459,5505.410146484375,5,1,1,4,2185,4
100117,Toys,21.962413787841797,2022-01-30,62,0,23.99726676940918,1487.8305397033691,6,1,1,4,2247,4
100117,Toys,21.962413787841797,2022-01-31,46,137,24.48927429199219,4487.973234863281,0,1,0,5,2293,4
100117,Toys,21.962413787841797,2022-02-01,137,160,22.15774654388428,6565.262553024292,1,2,0,5,2430,4
100117,Toys,21.962413787841797,2022-02-02,160,154,23.390317001342773,7343.421440429687,2,2,0,5,2590,4
100117,Toys,21.962413787841797,2022-02-03,60,0,23.200634002685547,1392.0380401611328,3,2,0,5,2650,4
100117,Toys,21.962413787841797,2022-02-04,84,84,23.465111045837403,3942.1386557006836,4,2,0,5,2734,4
100117,Toys,21.962413787841797,2022-02-05,94,115,21.26172466278076,4430.854236602783,5,2,1,5,2828,4
100117,Toys,21.962413787841797,2022-02-06,81,76,20.123655853271487,3163.1822482299804,6,2,1,5,2909,4
100117,Toys,21.962413787841797,2022-02-07,94,106,21.08801944732666,4218.467656097412,0,2,0,6,3003,4
100117,Toys,21.962413787841797,2022-02-08,78,0,21.01603889465332,1639.251033782959,1,2,0,6,3081,4
100117,Toys,21.962413787841797,2022-02-09,44,199,25.17589656829834,6181.928898010254,2,2,0,6,3125,4
100117,Toys,21.962413787841797,2022-02-10,66,0,24.76179313659668,1634.2783470153809,3,2,0,6,3191,4
100117,Toys,21.962413787841797,2022-02-11,66,0,24.76179313659668,1634.2783470153809,4,2,0,6,3257,4
100117,Toys,21.962413787841797,2022-02-12,67,87,21.802663078308107,3341.1568524932864,5,2,1,6,3324,4
100117,Toys,21.962413787841797,2022-02-13,74,56,21.007354164123534,2743.6884162902834,6,2,1,6,3398,4
100117,Toys,21.962413787841797,2022-02-14,24,50,17.85560859680176,1280.3492126464844,0,2,0,7,3422,4
100117,Toys,21.962413787841797,2022-02-15,74,63,18.77995491027832,2575.9333267211914,1,2,0,7,3496,4
100117,Toys,21.962413787841797,2022-02-16,84,109,22.932778244018557,4452.956744995117,2,2,0,7,3580,4
100117,Toys,21.962413787841797,2022-02-17,109,154,21.438908615112304,5633.532078094482,3,2,0,7,3689,4
100117,Toys,21.962413787841797,2022-02-18,150,197,23.446444740295412,8160.993422088623,4,2,0,7,3839,4
100117,Toys,21.962413787841797,2022-02-19,168,0,22.91288948059082,3849.365432739258,5,2,1,7,4007,4
100117,Toys,21.962413787841797,2022-02-20,33,271,28.26295295715332,8665.01489517212,6,2,1,7,4040,4
100117,Toys,21.962413787841797,2022-02-21,73,0,27.95590591430664,2040.7811317443848,0,2,0,8,4113,4
100117,Toys,21.962413787841797,2022-02-22,96,0,27.95590591430664,2683.7669677734375,1,2,0,8,4209,4
100117,Toys,21.962413787841797,2022-02-23,83,119,24.27443977355957,4863.677002410888,2,2,0,8,4292,4
100117,Toys,21.962413787841797,2022-02-24,89,0,25.37887954711914,2258.7202796936035,3,2,0,8,4381,4
100117,Toys,21.962413787841797,2022-02-25,49,96,20.468396530151367,2920.992859954834,4,2,0,8,4430,4
100117,Toys,21.962413787841797,2022-02-26,51,0,21.466793060302734,1094.8064460754395,5,2,1,8,4481,4
100117,Toys,21.962413787841797,2022-02-27,45,102,20.842774620056154,3057.4597158050537,6,2,1,8,4526,4
100117,Toys,21.962413787841797,2022-02-28,83,135,20.684359245300293,4505.323634719849,0,2,0,9,4609,4
100117,Toys,21.962413787841797,2022-03-01,70,0,20.758718490600586,1453.110294342041,1,3,0,9,4679,4
100117,Toys,21.962413787841797,2022-03-02,34,50,20.670344772338865,1735.663444519043,2,3,0,9,4713,4
100117,Toys,21.962413787841797,2022-03-03,100,173,25.725583839416505,7105.166767883301,3,3,0,9,4813,4
100117,Toys,21.962413787841797,2022-03-04,55,0,24.601167678833008,1353.0642223358154,4,3,0,9,4868,4
100117,Toys,21.962413787841797,2022-03-05,118,113,25.464020614624026,5880.70886505127,5,3,1,9,4986,4
100117,Toys,21.962413787841797,2022-03-06,50,87,21.043821296691895,2822.9221296691894,6,3,1,9,5036,4
100117,Toys,21.962413787841797,2022-03-07,55,0,22.66764259338379,1246.7203426361084,0,3,0,10,5091,4
100117,Toys,21.962413787841797,2022-03-08,95,114,24.068100204467775,5038.059038848877,1,3,0,10,5186,4
100117,Toys,21.962413787841797,2022-03-09,109,124,22.95942604064941,5346.2548768615725,2,3,0,10,5295,4
100117,Toys,21.962413787841797,2022-03-10,110,93,23.12291030883789,4694.340267944336,3,3,0,10,5405,4
100117,Toys,21.962413787841797,2022-03-11,109,173,23.896441497802734,6750.544246520996,4,3,0,10,5514,4
100117,Toys,21.962413787841797,2022-03-12,173,168,28.11631912231445,9580.096416320801,5,3,1,10,5687,4
100117,Toys,21.962413787841797,2022-03-13,171,130,27.051796188354494,8135.284296417236,6,3,1,10,5858,4
100117,Toys,21.962413787841797,2022-03-14,111,160,23.744080467224123,6390.3458637237545,0,3,0,11,5969,4
100117,Toys,21.962413787841797,2022-03-15,55,0,24.648160934448242,1355.6488513946533,1,3,0,11,6024,4
100117,Toys,21.962413787841797,2022-03-16,124,136,21.885176429748533,5679.763754577636,2,3,0,11,6148,4
100117,Toys,21.962413787841797,2022-03-17,136,240,26.01027702331543,9854.715350341798,3,3,0,11,6284,4
100117,Toys,21.962413787841797,2022-03-18,106,0,25.29055404663086,2680.798728942871,4,3,0,11,6390,4
100117,Toys,21.962413787841797,2022-03-19,134,127,23.483935050964355,6133.674593658447,5,3,1,11,6524,4
100117,Toys,21.962413787841797,2022-03-20,126,113,22.881290168762206,5474.365122528076,6,3,1,11,6650,4
100117,Toys,21.962413787841797,2022-03-21,72,80,22.24029399871826,3376.9223358154295,0,3,0,12,6722,4
100117,Toys,21.962413787841797,2022-03-22,58,95,23.092745780944824,3539.0085105895996,1,3,0,12,6780,4
100117,Toys,21.962413787841797,2022-03-23,159,326,32.01911678314209,15826.679137039184,2,3,0,12,6939,4
100117,Toys,21.962413787841797,2022-03-24,167,0,30.23823356628418,5049.785005569458,3,3,0,12,7106,4
100117,Toys,21.962413787841797,2022-03-25,134,134,22.63221683502197,6065.434111785889,4,3,0,12,7240,4
100117,Toys,21.962413787841797,2022-03-26,146,130,23.35172119140625,6457.902587890625,5,3,1,12,7386,4
100117,Toys,21.962413787841797,2022-03-27,70,0,24.1534423828125,1690.740966796875,6,3,1,12,7456,4
100117,Toys,21.962413787841797,2022-03-28,71,72,20.5067631149292,2931.240362319946,0,3,0,13,7527,4
100117,Toys,21.962413787841797,2022-03-29,69,67,19.186244621276856,2611.1417577362063,1,3,0,13,7596,4
100117,Toys,21.962413787841797,2022-03-30,72,94,23.418852729797365,3907.7947930908203,2,3,0,13,7668,4
100117,Toys,21.962413787841797,2022-03-31,94,69,21.339338836669924,3490.045701293945,3,3,0,13,7762,4
100117,Toys,21.962413787841797,2022-04-01,69,119,25.402310829162598,4816.018894424438,4,4,0,13,7831,4
100117,Toys,21.962413787841797,2022-04-02,119,130,23.06901638031006,5738.915898513794,5,4,1,13,7950,4
100117,Toys,21.962413787841797,2022-04-03,115,118,23.047709999084475,5369.583299789429,6,4,1,13,8065,4
100117,Toys,21.962413787841797,2022-04-04,63,0,23.225419998168945,1463.2014598846436,0,4,0,14,8128,4
100117,Toys,21.962413787841797,2022-04-05,70,135,22.44970561981201,4591.808786773681,1,4,0,14,8198,4
100117,Toys,21.962413787841797,2022-04-06,50,0,22.609411239624023,1130.4705619812012,2,4,0,14,8248,4
100117,Toys,21.962413787841797,2022-04-07,85,133,24.042867012023926,5258.007392044067,3,4,0,14,8333,4
100117,Toys,21.962413787841797,2022-04-08,133,312,28.36894676208496,12771.1498387146,4,4,0,14,8466,4
100117,Toys,21.962413787841797,2022-04-09,132,0,27.547893524169922,3636.3219451904297,5,4,1,14,8598,4
100117,Toys,21.962413787841797,2022-04-10,93,0,27.547893524169922,2561.9540977478027,6,4,1,14,8691,4
100117,Toys,21.962413787841797,2022-04-11,87,101,23.053103065490724,4315.039933395386,0,4,0,15,8778,4
100117,Toys,21.962413787841797,2022-04-12,101,183,28.33936092376709,8118.130906600953,1,4,0,15,8879,4
100117,Toys,21.962413787841797,2022-04-13,107,190,25.361455879211427,7474.961558151245,2,4,0,15,8986,4
100117,Toys,21.962413787841797,2022-04-14,145,0,26.05291175842285,3777.6722049713135,3,4,0,15,9131,4
100117,Toys,21.962413787841797,2022-04-15,99,145,26.12791748046875,6376.2276611328125,4,4,0,15,9230,4
100117,Toys,21.962413787841797,2022-04-16,56,0,26.1058349609375,1461.9267578125,5,4,1,15,9286,4
100117,Toys,21.962413787841797,2022-04-17,111,207,28.52790500640869,9121.034911422728,6,4,1,15,9397,4
100117,Toys,21.962413787841797,2022-04-18,138,0,28.015810012817383,3866.181781768799,0,4,0,16,9535,4
100117,Toys,21.962413787841797,2022-04-19,69,124,23.477774734497068,4476.882913360596,1,4,0,16,9604,4
100117,Toys,21.962413787841797,2022-04-20,124,150,24.523153800964355,6719.78214263916,2,4,0,16,9728,4
100117,Toys,21.962413787841797,2022-04-21,117,129,20.414383964538573,5003.885847702026,3,4,0,16,9845,4
100117,Toys,21.962413787841797,2022-04-22,130,153,23.1751114654541,6568.558981018066,4,4,0,16,9975,4
100117,Toys,21.962413787841797,2022-04-23,20,0,22.740222930908203,454.80445861816406,5,4,1,16,9995,4
100117,Toys,21.962413787841797,2022-04-24,39,0,22.740222930908203,886.8686943054199,6,4,1,16,10034,4
100117,Toys,21.962413787841797,2022-04-25,16,0,22.740222930908203,363.84356689453125,0,4,0,17,10050,4
100117,Toys,21.962413787841797,2022-04-26,34,0,22.740222930908203,773.1675796508789,1,4,0,17,10084,4
100117,Toys,21.962413787841797,2022-04-27,47,50,18.73816287994385,1812.4173107147217,2,4,0,17,10131,4
100117,Toys,21.962413787841797,2022-04-28,14,0,20.466325759887695,286.52856063842773,3,4,0,17,10145,4
100117,Toys,21.962413787841797,2022-04-29,65,86,20.34364631652832,3071.1840211486815,4,4,0,17,10210,4
100117,Toys,21.962413787841797,2022-04-30,21,0,20.37729263305664,427.92314529418945,5,4,1,17,10231,4
100117,Toys,21.962413787841797,2022-05-01,53,50,18.894234924316407,1947.858901977539,6,5,1,17,10284,4
100117,Toys,21.962413787841797,2022-05-02,14,0,19.478469848632812,272.6985778808594,0,5,0,18,10298,4
100117,Toys,21.962413787841797,2022-05-03,23,50,14.775339126586914,1037.415599822998,1,5,0,18,10321,4
100117,Toys,21.962413787841797,2022-05-04,30,0,16.300678253173828,489.02034759521484,2,5,0,18,10351,4
100117,Toys,21.962413787841797,2022-05-05,45,50,18.475160789489745,1758.5144710540771,3,5,0,18,10396,4
100117,Toys,21.962413787841797,2022-05-06,50,50,18.302580223083496,1830.2580223083496,4,5,0,18,10446,4
100117,Toys,21.962413787841797,2022-05-07,29,50,17.846290588378906,1407.8348541259766,5,5,1,18,10475,4
100117,Toys,21.962413787841797,2022-05-08,71,95,20.432630233764648,3408.07349319458,6,5,1,18,10546,4
100117,Toys,21.962413787841797,2022-05-09,16,0,19.755260467529297,316.08416748046875,0,5,0,19,10562,4
100117,Toys,21.962413787841797,2022-05-10,58,73,18.92982131958008,2475.4592730712893,1,5,0,19,10620,4
100117,Toys,21.962413787841797,2022-05-11,17,0,19.219642639160156,326.73392486572266,2,5,0,19,10637,4
100117,Toys,21.962413787841797,2022-05-12,14,0,19.219642639160156,269.0749969482422,3,5,0,19,10651,4
100117,Toys,21.962413787841797,2022-05-13,25,50,17.47450199127197,1293.7250995635986,4,5,0,19,10676,4
100117,Toys,21.962413787841797,2022-05-14,50,0,18.149003982543945,907.4501991271973,5,5,1,19,10726,4
100117,Toys,21.962413787841797,2022-05-15,14,50,15.287853240966797,950.0598907470703,6,5,1,19,10740,4
100117,Toys,21.962413787841797,2022-05-16,39,50,15.79105754852295,1404.07248878479,0,5,0,20,10779,4
100117,Toys,21.962413787841797,2022-05-17,26,0,15.912115097045898,413.71499252319336,1,5,0,20,10805,4
100117,Toys,21.962413787841797,2022-05-18,16,0,15.912115097045898,254.59384155273438,2,5,0,20,10821,4
100117,Toys,21.962413787841797,2022-05-19,16,50,16.071940956115725,1062.3821105957031,3,5,0,20,10837,4
100117,Toys,21.962413787841797,2022-05-20,17,0,16.023881912231445,272.40599250793457,4,5,0,20,10854,4
100117,Toys,21.962413787841797,2022-05-21,60,71,16.259897270202636,2130.8176724243162,5,5,1,20,10914,4
100117,Toys,21.962413787841797,2022-05-22,42,50,15.398534927368164,1414.0369338989258,6,5,1,20,10956,4
100117,Toys,21.962413787841797,2022-05-23,47,50,15.895614490509033,1542.0977621078491,0,5,0,21,11003,4
100117,Toys,21.962413787841797,2022-05-24,15,0,15.821228981018066,237.318434715271,1,5,0,21,11018,4
100117,Toys,21.962413787841797,2022-05-25,34,50,16.862317695617676,1423.117603302002,2,5,0,21,11052,4
100117,Toys,21.962413787841797,2022-05-26,80,111,17.572950782775877,3365.9521252441405,3,5,0,21,11132,4
100117,Toys,21.962413787841797,2022-05-27,114,163,24.758687591552736,6953.280770874023,4,5,0,21,11246,4
100117,Toys,21.962413787841797,2022-05-28,97,0,22.81737518310547,2213.2853927612305,5,5,1,21,11343,4
100117,Toys,21.962413787841797,2022-05-29,66,185,27.34467472076416,6945.067063140869,6,5,1,21,11409,4
100117,Toys,21.962413787841797,2022-05-30,58,0,26.65934944152832,1546.2422676086426,0,5,0,22,11467,4
100117,Toys,21.962413787841797,2022-05-31,127,169,27.044742774963378,8009.664664840698,1,5,0,22,11594,4
100117,Toys,21.962413787841797,2022-06-01,71,0,26.939485549926758,1912.7034740447998,2,6,0,22,11665,4
100117,Toys,21.962413787841797,2022-06-02,46,77,22.2382555770874,2678.6295130920407,3,6,0,22,11711,4
100117,Toys,21.962413787841797,2022-06-03,59,0,24.066511154174805,1419.9241580963135,4,6,0,22,11770,4
100117,Toys,21.962413787841797,2022-06-04,61,70,20.64162826538086,2693.778648376465,5,6,1,22,11831,4
100117,Toys,21.962413787841797,2022-06-05,79,77,23.252010345458984,3626.3176345825195,6,6,1,22,11910,4
100117,Toys,21.962413787841797,2022-06-06,64,91,21.887587966918943,3385.621259765625,0,6,0,23,11974,4
100117,Toys,21.962413787841797,2022-06-07,70,94,21.79479404449463,3571.3511662292485,1,6,0,23,12044,4
100117,Toys,21.962413787841797,2022-06-08,33,0,21.919588088989258,723.3464069366455,2,6,0,23,12077,4
100117,Toys,21.962413787841797,2022-06-09,67,0,21.919588088989258,1468.6124019622803,3,6,0,23,12144,4
100117,Toys,21.962413787841797,2022-06-10,28,116,23.698432273864746,3429.432207336426,4,6,0,23,12172,4
100117,Toys,21.962413787841797,2022-06-11,50,0,23.506864547729492,1175.3432273864746,5,6,1,23,12222,4
100117,Toys,21.962413787841797,2022-06-12,66,161,24.99659252166748,5698.300212860107,6,6,1,23,12288,4
100117,Toys,21.962413787841797,2022-06-13,99,0,24.74318504333496,2449.575319290161,0,6,0,24,12387,4
100117,Toys,21.962413787841797,2022-06-14,62,131,23.59056335449219,4537.7598559570315,1,6,0,24,12449,4
100117,Toys,21.962413787841797,2022-06-15,120,106,21.205248336791993,4806.319600830078,2,6,0,24,12569,4
100117,Toys,21.962413787841797,2022-06-16,117,138,21.03652545928955,5357.036957473755,3,6,0,24,12686,4
100117,Toys,21.962413787841797,2022-06-17,20,0,21.3830509185791,427.66101837158203,4,6,0,24,12706,4
100117,Toys,21.962413787841797,2022-06-18,118,112,20.7339571762085,4770.153893585206,5,6,1,24,12824,4
100117,Toys,21.962413787841797,2022-06-19,46,0,20.957914352416992,964.0640602111816,6,6,1,24,12870,4
100117,Toys,21.962413787841797,2022-06-20,66,138,22.4936328125,4610.03953125,0,6,0,25,12936,4
100117,Toys,21.962413787841797,2022-06-21,53,0,22.197265625,1176.455078125,1,6,0,25,12989,4
100117,Toys,21.962413787841797,2022-06-22,85,178,20.69881637573242,5416.928783874511,2,6,0,25,13074,4
100117,Toys,21.962413787841797,2022-06-23,47,0,20.987632751464844,986.4187393188477,3,6,0,25,13121,4
100117,Toys,21.962413787841797,2022-06-24,64,0,20.987632751464844,1343.20849609375,4,6,0,25,13185,4
100117,Toys,21.962413787841797,2022-06-25,67,125,21.10516017913818,4053.6314640045166,5,6,1,25,13252,4
100117,Toys,21.962413787841797,2022-06-26,91,126,22.349262962341307,4864.515859146119,6,6,1,25,13343,4
100117,Toys,21.962413787841797,2022-06-27,85,0,21.928525924682617,1863.9247035980225,0,6,0,26,13428,4
100117,Toys,21.962413787841797,2022-06-28,40,50,17.76455806732178,1580.9646453857422,1,6,0,26,13468,4
100117,Toys,21.962413787841797,2022-06-29,19,0,19.549116134643555,371.43320655822754,2,6,0,26,13487,4
100117,Toys,21.962413787841797,2022-06-30,19,0,19.549116134643555,371.43320655822754,3,6,0,26,13506,4
100117,Toys,21.962413787841797,2022-07-01,32,50,18.223755264282225,1486.7203369140625,4,7,0,26,13538,4
100117,Toys,21.962413787841797,2022-07-02,7,0,18.647510528564453,130.53257369995117,5,7,1,26,13545,4
100117,Toys,21.962413787841797,2022-07-03,19,50,16.80599826812744,1138.6579341888428,6,7,1,26,13564,4
100117,Toys,21.962413787841797,2022-07-04,38,0,17.481996536254883,664.3158683776855,0,7,0,27,13602,4
100117,Toys,21.962413787841797,2022-07-05,12,0,17.481996536254883,209.7839584350586,1,7,0,27,13614,4
100117,Toys,21.962413787841797,2022-07-06,24,50,17.902123222351072,1327.8219146728516,2,7,0,27,13638,4
100117,Toys,21.962413787841797,2022-07-07,22,0,17.78424644470215,391.25342178344727,3,7,0,27,13660,4
100117,Toys,21.962413787841797,2022-07-08,13,50,16.14340133666992,998.778434753418,4,7,0,27,13673,4
100117,Toys,21.962413787841797,2022-07-09,38,50,15.60055477142334,1367.3221626281738,5,7,1,27,13711,4
100117,Toys,21.962413787841797,2022-07-10,25,0,16.06110954284668,401.527738571167,6,7,1,27,13736,4
100117,Toys,21.962413787841797,2022-07-11,43,50,16.410018348693846,1527.111577987671,0,7,0,28,13779,4
100117,Toys,21.962413787841797,2022-07-12,9,0,16.270036697387695,146.43033027648926,1,7,0,28,13788,4
100117,Toys,21.962413787841797,2022-07-13,38,55,17.217926177978516,1607.252389526367,2,7,0,28,13826,4
100117,Toys,21.962413787841797,2022-07-14,46,56,16.02528949737549,1631.026633758545,3,7,0,28,13872,4
100117,Toys,21.962413787841797,2022-07-15,33,0,16.380578994750977,540.5591068267822,4,7,0,28,13905,4
100117,Toys,21.962413787841797,2022-07-16,29,50,14.88497308731079,1164.2584390640259,5,7,1,28,13934,4
100117,Toys,21.962413787841797,2022-07-17,50,52,16.422711181640626,1675.9711181640625,6,7,1,28,13984,4
100117,Toys,21.962413787841797,2022-07-18,44,0,15.99542236328125,703.798583984375,0,7,0,29,14028,4
100117,Toys,21.962413787841797,2022-07-19,22,50,16.461625022888185,1188.83150100708,1,7,0,29,14050,4
100117,Toys,21.962413787841797,2022-07-20,7,0,16.333250045776367,114.33275032043457,2,7,0,29,14057,4
100117,Toys,21.962413787841797,2022-07-21,24,50,17.27904457092285,1287.7741394042969,3,7,0,29,14081,4
100117,Toys,21.962413787841797,2022-07-22,22,0,16.928089141845703,372.41796112060547,4,7,0,29,14103,4
100117,Toys,21.962413787841797,2022-07-23,7,0,16.928089141845703,118.49662399291992,5,7,1,29,14110,4
100117,Toys,21.962413787841797,2022-07-24,21,50,17.687419395446778,1263.7116146087646,6,7,1,29,14131,4
100117,Toys,21.962413787841797,2022-07-25,85,98,19.883309783935545,3648.3526632690428,0,7,0,30,14216,4
100117,Toys,21.962413787841797,2022-07-26,98,218,24.428779792785644,7836.040839385986,1,7,0,30,14314,4
100117,Toys,21.962413787841797,2022-07-27,94,0,23.45755958557129,2205.010601043701,2,7,0,30,14408,4
100117,Toys,21.962413787841797,2022-07-28,124,137,22.925703887939456,5981.454564208985,3,7,0,30,14532,4
100117,Toys,21.962413787841797,2022-07-29,51,0,23.091407775878906,1177.6617965698242,4,7,0,30,14583,4
100117,Toys,21.962413787841797,2022-07-30,86,138,24.94875270843506,5611.46546585083,5,7,1,30,14669,4
100117,Toys,21.962413787841797,2022-07-31,84,127,24.442784271240235,5156.4477575683595,6,7,1,30,14753,4
100117,Toys,21.962413787841797,2022-08-01,114,0,24.46556854248047,2789.0748138427734,0,8,0,31,14867,4
100117,Toys,21.962413787841797,2022-08-02,67,120,22.466318740844727,4178.076711273194,1,8,0,31,14934,4
100117,Toys,21.962413787841797,2022-08-03,107,116,20.186094169616702,4493.1641522979735,2,8,0,31,15041,4
100117,Toys,21.962413787841797,2022-08-04,98,119,21.8948840713501,4756.967277984619,3,8,0,31,15139,4
100117,Toys,21.962413787841797,2022-08-05,77,0,21.619768142700195,1664.722146987915,4,8,0,31,15216,4
100117,Toys,21.962413787841797,2022-08-06,73,118,23.326735725402834,4473.553415908813,5,8,1,31,15289,4
100117,Toys,21.962413787841797,2022-08-07,71,91,23.042989654541017,3733.9045309448243,6,8,1,31,15360,4
100117,Toys,21.962413787841797,2022-08-08,95,0,22.99597930908203,2184.618034362793,0,8,0,32,15455,4
100117,Toys,21.962413787841797,2022-08-09,43,64,20.785781135559084,2212.4071776580813,1,8,0,32,15498,4
100117,Toys,21.962413787841797,2022-08-10,64,83,22.662448539733887,3338.3634130859373,2,8,0,32,15562,4
100117,Toys,21.962413787841797,2022-08-11,62,94,23.607870941162112,3695.6959967041016,3,8,0,32,15624,4
100117,Toys,21.962413787841797,2022-08-12,115,187,24.512649688720703,7424.949428405762,4,8,0,32,15739,4
100117,Toys,21.962413787841797,2022-08-13,115,0,24.205299377441406,2783.6094284057617,5,8,1,32,15854,4
100117,Toys,21.962413787841797,2022-08-14,72,133,23.104491767883303,4722.116814575195,6,8,1,32,15926,4
100117,Toys,21.962413787841797,2022-08-15,104,150,23.8217223739624,6057.53825378418,0,8,0,33,16030,4
100117,Toys,21.962413787841797,2022-08-16,165,170,25.767702217102048,8635.791731643676,1,8,0,33,16195,4
100117,Toys,21.962413787841797,2022-08-17,184,184,22.266351623535158,8194.017397460937,2,8,0,33,16379,4
100117,Toys,21.962413787841797,2022-08-18,95,0,23.192703247070312,2203.3068084716797,3,8,0,33,16474,4
100117,Toys,21.962413787841797,2022-08-19,89,78,21.11482208251953,3534.4783306884765,4,8,0,33,16563,4
100117,Toys,21.962413787841797,2022-08-20,78,142,22.009800453186035,4844.088870697022,5,8,1,33,16641,4
100117,Toys,21.962413787841797,2022-08-21,142,151,24.41963062286377,7161.97509689331,6,8,1,33,16783,4
100117,Toys,21.962413787841797,2022-08-22,72,0,23.63926124572754,1702.0268096923828,0,8,0,34,16855,4
100117,Toys,21.962413787841797,2022-08-23,68,108,23.766046905517577,4184.18237915039,1,8,0,34,16923,4
100117,Toys,21.962413787841797,2022-08-24,119,162,23.38361026763916,6566.76924369812,2,8,0,34,17042,4
100117,Toys,21.962413787841797,2022-08-25,111,145,25.113533592224123,6449.004457473755,3,8,0,34,17153,4
100117,Toys,21.962413787841797,2022-08-26,72,0,24.527067184448242,1765.9488372802734,4,8,0,34,17225,4
100117,Toys,21.962413787841797,2022-08-27,56,0,24.527067184448242,1373.5157623291016,5,8,1,34,17281,4
100117,Toys,21.962413787841797,2022-08-28,68,149,20.768342170715332,4450.164535217285,6,8,1,34,17349,4
100117,Toys,21.962413787841797,2022-08-29,114,146,23.001450309753416,5996.970670623779,0,8,0,35,17463,4
100117,Toys,21.962413787841797,2022-08-30,120,0,22.482900619506836,2697.9480743408203,1,8,0,35,17583,4
100117,Toys,21.962413787841797,2022-08-31,61,64,20.749467582702636,2592.0050450897215,2,8,0,35,17644,4
100117,Toys,21.962413787841797,2022-09-01,64,134,22.47518119812012,4465.823193359374,3,9,0,35,17708,4
100117,Toys,21.962413787841797,2022-09-02,80,0,22.250362396240234,1780.0289916992188,4,9,0,35,17788,4
100117,Toys,21.962413787841797,2022-09-03,54,83,21.286568069458006,2909.399351501465,5,9,1,35,17842,4
100117,Toys,21.962413787841797,2022-09-04,83,123,24.54711177825928,5087.220555191039,6,9,1,35,17925,4
100117,Toys,21.962413787841797,2022-09-05,66,0,23.784223556518555,1569.7587547302246,0,9,0,36,17991,4
100117,Toys,21.962413787841797,2022-09-06,57,147,23.298825607299804,4745.866119232178,1,9,0,36,18048,4
100117,Toys,21.962413787841797,2022-09-07,116,0,23.37765121459961,2711.8075408935547,2,9,0,36,18164,4
100117,Toys,21.962413787841797,2022-09-08,31,157,21.42541790008545,4005.875909805298,3,9,0,36,18195,4
100117,Toys,21.962413787841797,2022-09-09,97,0,21.6008358001709,2095.281072616577,4,9,0,36,18292,4
100117,Toys,21.962413787841797,2022-09-10,58,67,20.53090629577637,2563.3851303100582,5,9,1,36,18350,4
100117,Toys,21.962413787841797,2022-09-11,69,129,19.33266437530518,3808.5076837921147,6,9,1,36,18419,4
100117,Toys,21.962413787841797,2022-09-12,12,0,19.65532875061035,235.86394500732422,0,9,0,37,18431,4
100117,Toys,21.962413787841797,2022-09-13,88,127,22.372957458496096,4843.6105126953125,1,9,0,37,18519,4
100117,Toys,21.962413787841797,2022-09-14,146,138,24.04626319885254,6821.828854064941,2,9,0,37,18665,4
100117,Toys,21.962413787841797,2022-09-15,102,0,23.132526397705078,2359.517692565918,3,9,0,37,18767,4
100117,Toys,21.962413787841797,2022-09-16,46,126,22.47196632385254,3857.020901794434,4,9,0,37,18813,4
100117,Toys,21.962413787841797,2022-09-17,86,94,20.087671203613283,3607.7994470214844,5,9,1,37,18899,4
100117,Toys,21.962413787841797,2022-09-18,131,140,21.836780586242675,5919.956513595581,6,9,1,37,19030,4
100117,Toys,21.962413787841797,2022-09-19,73,0,21.59356117248535,1576.3299655914307,0,9,0,38,19103,4
100117,Toys,21.962413787841797,2022-09-20,70,113,18.404233169555663,3335.542643737793,1,9,0,38,19173,4
100117,Toys,21.962413787841797,2022-09-21,83,79,22.448247108459473,3631.129020004272,2,9,0,38,19256,4
100117,Toys,21.962413787841797,2022-09-22,109,184,24.652778015136718,7284.555607299804,3,9,0,38,19365,4
100117,Toys,21.962413787841797,2022-09-23,120,0,23.835556030273438,2860.2667236328125,4,9,0,38,19485,4
100117,Toys,21.962413787841797,2022-09-24,64,98,23.445912170410157,3794.9767578125,5,9,1,38,19549,4
100117,Toys,21.962413787841797,2022-09-25,78,92,21.484839210510252,3642.4149168395998,6,9,1,38,19627,4
100117,Toys,21.962413787841797,2022-09-26,112,100,25.23161331176758,5336.0413818359375,0,9,0,39,19739,4
100117,Toys,21.962413787841797,2022-09-27,92,91,23.011368446350097,4211.481794128418,1,9,0,39,19831,4
100117,Toys,21.962413787841797,2022-09-28,63,106,22.834172439575195,3851.0557273864742,2,9,0,39,19894,4
100117,Toys,21.962413787841797,2022-09-29,115,149,27.162551879882812,7216.386932373047,3,9,0,39,20009,4
100117,Toys,21.962413787841797,2022-09-30,34,0,25.825103759765625,878.0535278320312,4,9,0,39,20043,4
100117,Toys,21.962413787841797,2022-10-01,82,122,22.59739501953125,4562.372783203125,5,10,1,39,20125,4
100117,Toys,21.962413787841797,2022-10-02,100,0,23.7847900390625,2378.47900390625,6,10,1,39,20225,4
100117,Toys,21.962413787841797,2022-10-03,77,102,23.23704532623291,4155.504980239868,0,10,0,40,20302,4
100117,Toys,21.962413787841797,2022-10-04,49,81,21.13041900634766,2718.1410626220704,1,10,0,40,20351,4
100117,Toys,21.962413787841797,2022-10-05,125,153,22.685507125854492,6312.296781463623,2,10,0,40,20476,4
100117,Toys,21.962413787841797,2022-10-06,77,0,22.481014251708984,1731.0380973815918,3,10,0,40,20553,4
100117,Toys,21.962413787841797,2022-10-07,90,99,21.91643154144287,4140.617677459717,4,10,0,40,20643,4
100117,Toys,21.962413787841797,2022-10-08,99,100,22.33111389160156,4443.970550537109,5,10,1,40,20742,4
100117,Toys,21.962413787841797,2022-10-09,100,137,20.42781135559082,4823.342271118165,6,10,1,40,20842,4
100117,Toys,21.962413787841797,2022-10-10,69,0,20.91562271118164,1443.1779670715332,0,10,0,41,20911,4
100117,Toys,21.962413787841797,2022-10-11,68,67,19.437564582824706,2624.56878326416,1,10,0,41,20979,4
100117,Toys,21.962413787841797,2022-10-12,67,136,19.446560668945313,3940.9891296386722,2,10,0,41,21046,4
100117,Toys,21.962413787841797,2022-10-13,129,122,20.468729400634764,5135.33218536377,3,10,0,41,21175,4
100117,Toys,21.962413787841797,2022-10-14,61,120,23.41440227508545,4305.597077560425,4,10,0,41,21236,4
100117,Toys,21.962413787841797,2022-10-15,115,0,22.2688045501709,2560.9125232696533,5,10,1,41,21351,4
100117,Toys,21.962413787841797,2022-10-16,57,73,21.407201347351076,2778.3409535980227,6,10,1,41,21408,4
100117,Toys,21.962413787841797,2022-10-17,89,145,24.201307792663574,5696.0727870941155,0,10,0,42,21497,4
100117,Toys,21.962413787841797,2022-10-18,134,102,24.38789318084717,5745.235372467041,1,10,0,42,21631,4
100117,Toys,21.962413787841797,2022-10-19,60,0,24.065786361694336,1443.9471817016602,2,10,0,42,21691,4
100117,Toys,21.962413787841797,2022-10-20,50,50,20.44445011138916,2044.445011138916,3,10,0,42,21741,4
100117,Toys,21.962413787841797,2022-10-21,53,92,18.275557403564456,2620.099084777832,4,10,0,42,21794,4
100117,Toys,21.962413787841797,2022-10-22,92,159,24.120283966064456,6130.5522497558595,5,10,1,42,21886,4
100117,Toys,21.962413787841797,2022-10-23,102,0,22.980567932128906,2344.0179290771484,6,10,1,42,21988,4
100117,Toys,21.962413787841797,2022-10-24,57,193,27.3214640045166,6906.326896514893,0,10,0,43,22045,4
100117,Toys,21.962413787841797,2022-10-25,58,0,26.762928009033203,1552.2498245239258,1,10,0,43,22103,4
100117,Toys,21.962413787841797,2022-10-26,84,123,22.76617317199707,4657.367092895508,2,10,0,43,22187,4
100117,Toys,21.962413787841797,2022-10-27,62,0,24.18234634399414,1499.3054733276367,3,10,0,43,22249,4
100117,Toys,21.962413787841797,2022-10-28,112,208,25.483910446166995,8181.355939941406,4,10,0,43,22361,4
100117,Toys,21.962413787841797,2022-10-29,74,0,25.207820892333984,1865.3787460327148,5,10,1,43,22435,4
100117,Toys,21.962413787841797,2022-10-30,54,0,25.207820892333984,1361.2223281860352,6,10,1,43,22489,4
100117,Toys,21.962413787841797,2022-10-31,77,76,22.24995445251465,3405.262985687256,0,10,0,44,22566,4
100117,Toys,21.962413787841797,2022-11-01,79,151,23.949158592224123,5518.447057571411,1,11,0,44,22645,4
100117,Toys,21.962413787841797,2022-11-02,32,0,23.808317184448242,761.8661499023438,2,11,0,44,22677,4
100117,Toys,21.962413787841797,2022-11-03,71,0,23.808317184448242,1690.3905200958252,3,11,0,44,22748,4
100117,Toys,21.962413787841797,2022-11-04,48,110,21.14670654296875,3311.6238281250003,4,11,0,44,22796,4
100117,Toys,21.962413787841797,2022-11-05,90,99,24.944055976867674,4725.1000758361815,5,11,1,44,22886,4
100117,Toys,21.962413787841797,2022-11-06,81,91,21.845965309143068,3749.946380081177,6,11,1,44,22967,4
100117,Toys,21.962413787841797,2022-11-07,112,82,22.23954776763916,4319.258699951171,0,11,0,45,23079,4
100117,Toys,21.962413787841797,2022-11-08,99,195,24.653572731018066,7291.967400741577,1,11,0,45,23178,4
100117,Toys,21.962413787841797,2022-11-09,86,0,24.197145462036133,2080.9545097351074,2,11,0,45,23264,4
100117,Toys,21.962413787841797,2022-11-10,109,124,22.27643558502197,5181.6129575347895,3,11,0,45,23373,4
100117,Toys,21.962413787841797,2022-11-11,35,0,22.862871170043945,800.2004909515381,4,11,0,45,23408,4
100117,Toys,21.962413787841797,2022-11-12,89,209,27.20735870361328,8199.309849243164,5,11,1,45,23497,4
100117,Toys,21.962413787841797,2022-11-13,117,0,26.444717407226562,3094.031936645508,6,11,1,45,23614,4
100117,Toys,21.962413787841797,2022-11-14,92,133,23.807675781249998,5328.94234375,0,11,0,46,23706,4
100117,Toys,21.962413787841797,2022-11-15,117,134,24.541407852172853,6160.209437408447,1,11,0,46,23823,4
100117,Toys,21.962413787841797,2022-11-16,94,111,25.5042573928833,5235.10038986206,2,11,0,46,23917,4
100117,Toys,21.962413787841797,2022-11-17,78,0,25.1085147857666,1958.464153289795,3,11,0,46,23995,4
100117,Toys,21.962413787841797,2022-11-18,89,115,26.532666053771973,5422.994557571411,4,11,0,46,24084,4
100117,Toys,21.962413787841797,2022-11-19,64,0,26.135332107543945,1672.6612548828125,5,11,1,46,24148,4
100117,Toys,21.962413787841797,2022-11-20,51,101,23.101552124023435,3480.8583166503904,6,11,1,46,24199,4
100117,Toys,21.962413787841797,2022-11-21,101,110,24.326880226135252,5134.709805679321,0,11,0,47,24300,4
100117,Toys,21.962413787841797,2022-11-22,52,86,21.980085678100586,3004.688910522461,1,11,0,47,24352,4
100117,Toys,21.962413787841797,2022-11-23,107,0,22.820171356201172,2441.7583351135254,2,11,0,47,24459,4
100117,Toys,21.962413787841797,2022-11-24,37,187,23.29706756591797,5224.98299987793,3,11,0,47,24496,4
100117,Toys,21.962413787841797,2022-11-25,49,0,23.254135131835938,1139.452621459961,4,11,0,47,24545,4
100117,Toys,21.962413787841797,2022-11-26,96,143,22.496566772460938,5365.0908203125,5,11,1,47,24641,4
100117,Toys,21.962413787841797,2022-11-27,110,0,22.743133544921875,2501.7446899414062,6,11,1,47,24751,4
100117,Toys,21.962413787841797,2022-11-28,75,122,24.570393562316895,4860.559034347534,0,11,0,48,24826,4
100117,Toys,21.962413787841797,2022-11-29,44,0,24.14078712463379,1062.1946334838867,1,11,0,48,24870,4
100117,Toys,21.962413787841797,2022-11-30,78,122,22.90045337677002,4566.870726776124,2,11,0,48,24948,4
100117,Toys,21.962413787841797,2022-12-01,119,127,22.294198036193848,5482.019132614136,3,12,0,48,25067,4
100117,Toys,21.962413787841797,2022-12-02,103,180,22.59756736755371,6395.298877716064,4,12,0,48,25170,4
100117,Toys,21.962413787841797,2022-12-03,69,0,22.595134735107422,1559.064296722412,5,12,1,48,25239,4
100117,Toys,21.962413787841797,2022-12-04,59,0,22.595134735107422,1333.112949371338,6,12,1,48,25298,4
100117,Toys,21.962413787841797,2022-12-05,79,187,26.797191276550294,7207.196221694947,0,12,0,49,25377,4
100117,Toys,21.962413787841797,2022-12-06,70,0,26.064382553100586,1824.506778717041,1,12,0,49,25447,4
100117,Toys,21.962413787841797,2022-12-07,117,97,22.93666542053223,4931.979708404541,2,12,0,49,25564,4
100117,Toys,21.962413787841797,2022-12-08,78,102,21.38063621520996,3827.379249572754,3,12,0,49,25642,4
100117,Toys,21.962413787841797,2022-12-09,82,104,24.51947479248047,4578.8938659667965,4,12,0,49,25724,4
100117,Toys,21.962413787841797,2022-12-10,115,134,23.355883712768552,5813.413253936767,5,12,1,49,25839,4
100117,Toys,21.962413787841797,2022-12-11,86,0,23.47176742553711,2018.5719985961914,6,12,1,49,25925,4
100117,Toys,21.962413787841797,2022-12-12,76,113,22.311889419555662,4206.147191772461,0,12,0,50,26001,4
100117,Toys,21.962413787841797,2022-12-13,97,92,22.927017593383788,4332.591413116455,1,12,0,50,26098,4
100117,Toys,21.962413787841797,2022-12-14,80,79,21.371593017578125,3398.6648828125,2,12,0,50,26178,4
100117,Toys,21.962413787841797,2022-12-15,75,98,20.58363609313965,3549.8454139709474,3,12,0,50,26253,4
100117,Toys,21.962413787841797,2022-12-16,69,127,22.14510810852051,4361.6049189758305,4,12,0,50,26322,4
100117,Toys,21.962413787841797,2022-12-17,90,0,21.780216217041016,1960.2194595336914,5,12,1,50,26412,4
100117,Toys,21.962413787841797,2022-12-18,98,135,23.896440963745118,5588.722428894043,6,12,1,50,26510,4
100117,Toys,21.962413787841797,2022-12-19,125,130,22.816488571166992,5817.322142791749,0,12,0,51,26635,4
100117,Toys,21.962413787841797,2022-12-20,61,0,22.992977142333984,1402.571605682373,1,12,0,51,26696,4
100117,Toys,21.962413787841797,2022-12-21,79,88,22.005823707580568,3672.2201457977294,2,12,0,51,26775,4
100117,Toys,21.962413787841797,2022-12-22,71,77,20.733772354125975,3065.1556742858884,3,12,0,51,26846,4
100117,Toys,21.962413787841797,2022-12-23,94,188,25.292923851013185,7207.529683990479,4,12,0,51,26940,4
100117,Toys,21.962413787841797,2022-12-24,131,140,22.80088287353516,6172.911312866211,5,12,1,51,27071,4
100117,Toys,21.962413787841797,2022-12-25,71,0,23.481765747070312,1667.2053680419922,6,12,1,51,27142,4
100117,Toys,21.962413787841797,2022-12-26,98,92,23.39518898010254,4445.297040100098,0,12,0,52,27240,4
100117,Toys,21.962413787841797,2022-12-27,120,160,24.32579532623291,6820.990878295898,1,12,0,52,27360,4
100117,Toys,21.962413787841797,2022-12-28,112,0,24.08159065246582,2697.138153076172,2,12,0,52,27472,4
100117,Toys,21.962413787841797,2022-12-29,48,145,24.701907653808593,4776.013134765624,3,12,0,52,27520,4
100117,Toys,21.962413787841797,2022-12-30,43,0,24.613815307617188,1058.394058227539,4,12,0,52,27563,4
100117,Toys,21.962413787841797,2022-12-31,102,145,27.848357887268065,6914.735009002686,5,12,1,52,27665,4
100117,Toys,21.962413787841797,2023-01-01,68,0,27.006715774536133,1836.456672668457,6,1,1,52,27733,4
100117,Toys,21.962413787841797,2023-01-02,77,119,25.65131965637207,5013.743227081299,0,1,0,1,27810,4
100117,Toys,21.962413787841797,2023-01-03,119,148,24.985831832885744,6662.927976226807,1,1,0,1,27929,4
100117,Toys,21.962413787841797,2023-01-04,133,125,21.625762710571287,5590.292881011963,2,1,0,1,28062,4
100117,Toys,21.962413787841797,2023-01-05,56,0,22.981525421142578,1286.9654235839844,3,1,0,1,28118,4
100117,Toys,21.962413787841797,2023-01-06,65,90,22.540368270874023,3490.247875213623,4,1,0,1,28183,4
100117,Toys,21.962413787841797,2023-01-07,87,94,19.43221771240234,3508.8858819580078,5,1,1,1,28270,4
100117,Toys,21.962413787841797,2023-01-08,116,126,24.26304634094238,5883.126751098633,6,1,1,1,28386,4
100117,Toys,21.962413787841797,2023-01-09,85,101,24.83838653564453,4630.52571105957,0,1,0,2,28471,4
100117,Toys,21.962413787841797,2023-01-10,73,0,24.176773071289062,1764.9044342041016,1,1,0,2,28544,4
100117,Toys,21.962413787841797,2023-01-11,69,96,21.600961647033692,3545.7727072906496,2,1,0,2,28613,4
100117,Toys,21.962413787841797,2023-01-12,26,0,22.281923294067383,579.330005645752,3,1,0,2,28639,4
100117,Toys,21.962413787841797,2023-01-13,70,161,20.931200714111327,4813.158099975586,4,1,0,2,28709,4
100117,Toys,21.962413787841797,2023-01-14,42,0,21.172401428222656,889.2408599853516,5,1,1,2,28751,4
100117,Toys,21.962413787841797,2023-01-15,76,0,21.172401428222656,1609.1025085449219,6,1,1,2,28827,4
100117,Toys,21.962413787841797,2023-01-16,43,120,25.614979286193847,4227.21821861267,0,1,0,3,28870,4
100117,Toys,21.962413787841797,2023-01-17,79,0,24.939958572387695,1970.256727218628,1,1,0,3,28949,4
100117,Toys,21.962413787841797,2023-01-18,41,105,24.931398239135742,3639.894655609131,2,1,0,3,28990,4
100117,Toys,21.962413787841797,2023-01-19,83,103,22.13469669342041,4098.159651107788,3,1,0,3,29073,4
100117,Toys,21.962413787841797,2023-01-20,69,123,22.533819007873536,4316.567023086548,4,1,0,3,29142,4
100117,Toys,21.962413787841797,2023-01-21,131,0,22.71763801574707,2976.010580062866,5,1,1,3,29273,4
100117,Toys,21.962413787841797,2023-01-22,48,130,23.12631103515625,4121.705859375001,6,1,1,3,29321,4
100117,Toys,21.962413787841797,2023-01-23,53,0,23.0626220703125,1222.3189697265625,0,1,0,4,29374,4
100117,Toys,21.962413787841797,2023-01-24,75,99,20.466823692321775,3543.7835538482664,1,1,0,4,29449,4
100117,Toys,21.962413787841797,2023-01-25,88,69,19.820347900390622,3122.82123046875,2,1,0,4,29537,4
100117,Toys,21.962413787841797,2023-01-26,82,165,21.91801010131836,5438.81365661621,3,1,0,4,29619,4
100117,Toys,21.962413787841797,2023-01-27,48,0,21.61602020263672,1037.5689697265625,4,1,0,4,29667,4
100117,Toys,21.962413787841797,2023-01-28,109,100,22.334733772277833,4665.571962356567,5,1,1,4,29776,4
100117,Toys,21.962413787841797,2023-01-29,8,0,22.069467544555664,176.5557403564453,6,1,1,4,29784,4
100117,Toys,21.962413787841797,2023-01-30,43,0,22.069467544555664,948.9871044158936,0,1,0,5,29827,4
100117,Toys,21.962413787841797,2023-01-31,9,0,22.069467544555664,198.62520790100098,1,1,0,5,29836,4
100117,Toys,21.962413787841797,2023-02-01,7,0,22.069467544555664,154.48627281188965,2,2,0,5,29843,4
100117,Toys,21.962413787841797,2023-02-02,15,50,17.4680122756958,1088.590368270874,3,2,0,5,29858,4
100117,Toys,21.962413787841797,2023-02-03,12,0,18.8060245513916,225.67229461669922,4,2,0,5,29870,4
100117,Toys,21.962413787841797,2023-02-04,16,0,18.8060245513916,300.8963928222656,5,2,1,5,29886,4
100117,Toys,21.962413787841797,2023-02-05,48,66,19.59074249267578,2237.111279296875,6,2,1,5,29934,4
100117,Toys,21.962413787841797,2023-02-06,33,50,16.1105082321167,1315.0635433197021,0,2,0,6,29967,4
100117,Toys,21.962413787841797,2023-02-07,33,0,17.4110164642334,574.5635433197021,1,2,0,6,30000,4
100117,Toys,21.962413787841797,2023-02-08,12,0,17.4110164642334,208.93219757080078,2,2,0,6,30012,4
100117,Toys,21.962413787841797,2023-02-09,38,53,17.884938125610354,1629.405297546387,3,2,0,6,30050,4
100117,Toys,21.962413787841797,2023-02-10,24,50,18.844336853027343,1404.2481689453125,4,2,0,6,30074,4
100117,Toys,21.962413787841797,2023-02-11,7,0,18.468673706054688,129.2807159423828,5,2,1,6,30081,4
100117,Toys,21.962413787841797,2023-02-12,18,0,18.468673706054688,332.4361267089844,6,2,1,6,30099,4
100117,Toys,21.962413787841797,2023-02-13,21,50,17.995809593200683,1272.8940029144287,0,2,0,7,30120,4
100117,Toys,21.962413787841797,2023-02-14,29,0,18.161619186401367,526.6869564056396,1,2,0,7,30149,4
100117,Toys,21.962413787841797,2023-02-15,54,80,20.24443031311035,2726.418473815918,2,2,0,7,30203,4
100117,Toys,21.962413787841797,2023-02-16,6,0,19.718860626220703,118.31316375732422,3,2,0,7,30209,4
100117,Toys,21.962413787841797,2023-02-17,21,0,19.718860626220703,414.09607315063477,4,2,0,7,30230,4
100117,Toys,21.962413787841797,2023-02-18,34,50,18.509076042175295,1548.05717086792,5,2,1,7,30264,4
100117,Toys,21.962413787841797,2023-02-19,27,50,16.437068901062013,1242.2617206573486,6,2,1,7,30291,4
100117,Toys,21.962413787841797,2023-02-20,21,0,17.454137802124023,366.5368938446045,0,2,0,8,30312,4
100117,Toys,21.962413787841797,2023-02-21,69,63,16.995349922180175,2244.378289260864,1,2,0,8,30381,4
100117,Toys,21.962413787841797,2023-02-22,58,50,17.51171989440918,1890.1595077514648,2,2,0,8,30439,4
100117,Toys,21.962413787841797,2023-02-23,30,50,16.989420700073243,1356.3652420043945,3,2,0,8,30469,4
100117,Toys,21.962413787841797,2023-02-24,23,0,17.128841400146484,393.96335220336914,4,2,0,8,30492,4
100117,Toys,21.962413787841797,2023-02-25,44,50,17.722006645202637,1667.116584777832,5,2,1,8,30536,4
100117,Toys,21.962413787841797,2023-02-26,34,50,19.343822135925294,1635.85990524292,6,2,1,8,30570,4
100117,Toys,21.962413787841797,2023-02-27,11,0,18.657644271850586,205.23408699035645,0,2,0,9,30581,4
100117,Toys,21.962413787841797,2023-02-28,23,0,18.657644271850586,429.1258182525635,1,2,0,9,30604,4
100117,Toys,21.962413787841797,2023-03-01,42,89,19.935958709716797,2623.080531616211,2,3,0,9,30646,4
100117,Toys,21.962413787841797,2023-03-02,89,148,24.661245613098146,5912.491719131469,3,3,0,9,30735,4
100117,Toys,21.962413787841797,2023-03-03,148,159,23.783825454711916,7302.5823345947265,4,3,0,9,30883,4
100117,Toys,21.962413787841797,2023-03-04,113,166,24.43970188140869,6831.412625198364,5,3,1,9,30996,4
100117,Toys,21.962413787841797,2023-03-05,79,0,24.199403762817383,1911.7528972625732,6,3,1,9,31075,4
100117,Toys,21.962413787841797,2023-03-06,72,0,24.199403762817383,1742.3570709228516,0,3,0,10,31147,4
100117,Toys,21.962413787841797,2023-03-07,59,80,20.62625343322754,2846.3379051208494,1,3,0,10,31206,4
100117,Toys,21.962413787841797,2023-03-08,61,54,19.75965259552002,2277.9576166534425,2,3,0,10,31267,4
100117,Toys,21.962413787841797,2023-03-09,75,156,24.379627761840823,5691.664164276123,3,3,0,10,31342,4
100117,Toys,21.962413787841797,2023-03-10,89,0,23.63925552368164,2103.893741607666,4,3,0,10,31431,4
100117,Toys,21.962413787841797,2023-03-11,67,91,21.535950050354003,3389.0973067474365,5,3,1,10,31498,4
100117,Toys,21.962413787841797,2023-03-12,91,112,23.10904712677002,4697.246577072143,6,3,1,10,31589,4
100117,Toys,21.962413787841797,2023-03-13,112,146,22.467260894775393,5793.246440429688,0,3,0,11,31701,4
100117,Toys,21.962413787841797,2023-03-14,98,125,21.05612564086914,4680.500625610352,1,3,0,11,31799,4
100117,Toys,21.962413787841797,2023-03-15,173,180,27.106643028259278,9581.12848777771,2,3,0,11,31972,4
100117,Toys,21.962413787841797,2023-03-16,119,0,25.323286056518555,3013.471040725708,3,3,0,11,32091,4
100117,Toys,21.962413787841797,2023-03-17,23,50,19.598875846862793,1372.1582889556885,4,3,0,11,32114,4
100117,Toys,21.962413787841797,2023-03-18,88,168,20.858675918579102,5324.726961669922,5,3,1,11,32202,4
100117,Toys,21.962413787841797,2023-03-19,94,143,24.36304656982422,5834.162755126953,6,3,1,11,32296,4
100117,Toys,21.962413787841797,2023-03-20,54,0,23.136093139648438,1249.3490295410156,0,3,0,12,32350,4
100117,Toys,21.962413787841797,2023-03-21,163,268,27.81007308959961,12100.583827209473,1,3,0,12,32513,4
100117,Toys,21.962413787841797,2023-03-22,175,255,30.468718414306643,13204.851445007323,2,3,0,12,32688,4
100117,Toys,21.962413787841797,2023-03-23,110,0,29.17743682861328,3209.518051147461,3,3,0,12,32798,4
100117,Toys,21.962413787841797,2023-03-24,86,0,29.17743682861328,2509.259567260742,4,3,0,12,32884,4
100117,Toys,21.962413787841797,2023-03-25,149,137,27.41046775817871,7846.959391937256,5,3,1,12,33033,4
100117,Toys,21.962413787841797,2023-03-26,62,0,28.040935516357422,1738.5380020141602,6,3,1,12,33095,4
100117,Toys,21.962413787841797,2023-03-27,78,88,23.503412895202636,3887.632411651611,0,3,0,13,33173,4
100117,Toys,21.962413787841797,2023-03-28,82,110,23.087072525024414,4418.239894104004,1,3,0,13,33255,4
100117,Toys,21.962413787841797,2023-03-29,59,0,23.604145050048828,1392.6445579528809,2,3,0,13,33314,4
100117,Toys,21.962413787841797,2023-03-30,57,83,21.42659336090088,2985.2516431427002,3,3,0,13,33371,4
100117,Toys,21.962413787841797,2023-03-31,83,112,24.161165237426758,4728.503429412842,4,3,0,13,33454,4
100117,Toys,21.962413787841797,2023-04-01,112,86,23.671062927246094,4685.858095703125,5,4,1,13,33566,4
100117,Toys,21.962413787841797,2023-04-02,86,98,22.389083747863772,4115.042404632568,6,4,1,13,33652,4
100117,Toys,21.962413787841797,2023-04-03,57,78,21.55000118255615,2899.380134811401,0,4,0,14,33709,4
100117,Toys,21.962413787841797,2023-04-04,119,114,22.22105266571045,5177.160534439086,1,4,0,14,33828,4
100117,Toys,21.962413787841797,2023-04-05,114,144,21.285697479248046,5484.339025268555,2,4,0,14,33942,4
100117,Toys,21.962413787841797,2023-04-06,132,157,26.71136371612549,7760.300021057129,3,4,0,14,34074,4
100117,Toys,21.962413787841797,2023-04-07,69,0,25.082727432250977,1730.7081928253174,4,4,0,14,34143,4
100117,Toys,21.962413787841797,2023-04-08,100,138,23.334858474731448,5536.031694946289,5,4,1,14,34243,4
100117,Toys,21.962413787841797,2023-04-09,39,0,23.79971694946289,928.1889610290527,6,4,1,14,34282,4
100117,Toys,21.962413787841797,2023-04-10,90,80,23.351374473571777,3971.44740524292,0,4,0,15,34372,4
100117,Toys,21.962413787841797,2023-04-11,89,139,24.333408966064454,5557.846795959473,1,4,0,15,34461,4
100117,Toys,21.962413787841797,2023-04-12,19,0,24.136817932128906,458.5995407104492,2,4,0,15,34480,4
100117,Toys,21.962413787841797,2023-04-13,111,111,19.601381187438967,4351.506623611451,3,4,0,15,34591,4
100117,Toys,21.962413787841797,2023-04-14,41,0,21.19276237487793,868.9032573699951,4,4,0,15,34632,4
100117,Toys,21.962413787841797,2023-04-15,10,0,21.19276237487793,211.9276237487793,5,4,1,15,34642,4
100117,Toys,21.962413787841797,2023-04-16,51,70,20.867412452697756,2522.9160701751707,6,4,1,15,34693,4
100117,Toys,21.962413787841797,2023-04-17,38,0,20.974824905395508,797.0433464050293,0,4,0,16,34731,4
100117,Toys,21.962413787841797,2023-04-18,20,50,17.70870643615723,1206.948257446289,1,4,0,16,34751,4
100117,Toys,21.962413787841797,2023-04-19,15,0,18.797412872314453,281.9611930847168,2,4,0,16,34766,4
100117,Toys,21.962413787841797,2023-04-20,15,0,18.797412872314453,281.9611930847168,3,4,0,16,34781,4
100117,Toys,21.962413787841797,2023-04-21,31,50,16.91685344696045,1358.3549137115479,4,4,0,16,34812,4
100117,Toys,21.962413787841797,2023-04-22,19,0,17.5437068939209,333.33043098449707,5,4,1,16,34831,4
100117,Toys,21.962413787841797,2023-04-23,30,50,17.525926361083982,1401.955581665039,6,4,1,16,34861,4
100117,Toys,21.962413787841797,2023-04-24,42,50,15.695956916809081,1437.980381011963,0,4,0,17,34903,4
100117,Toys,21.962413787841797,2023-04-25,75,74,18.427991561889648,2745.088734283447,1,4,0,17,34978,4
100117,Toys,21.962413787841797,2023-04-26,51,63,17.68364532470703,2015.6518231201171,2,4,0,17,35029,4
100117,Toys,21.962413787841797,2023-04-27,8,0,17.707290649414062,141.6583251953125,3,4,0,17,35037,4
100117,Toys,21.962413787841797,2023-04-28,41,54,19.872187042236327,1899.919337463379,4,4,0,17,35078,4
100117,Toys,21.962413787841797,2023-04-29,36,0,18.944374084472656,681.9974670410156,5,4,1,17,35114,4
100117,Toys,21.962413787841797,2023-04-30,46,50,18.143859672546387,1740.6350898742676,6,4,1,17,35160,4
100117,Toys,21.962413787841797,2023-05-01,33,50,18.135618934631346,1503.290849685669,0,5,0,18,35193,4
100117,Toys,21.962413787841797,2023-05-02,10,0,18.251237869262695,182.51237869262695,1,5,0,18,35203,4
100117,Toys,21.962413787841797,2023-05-03,48,66,18.659760856628417,2129.7370422363283,2,5,0,18,35251,4
100117,Toys,21.962413787841797,2023-05-04,43,0,18.519521713256836,796.339433670044,3,5,0,18,35294,4
100117,Toys,21.962413787841797,2023-05-05,24,50,17.70031318664551,1303.3150329589844,4,5,0,18,35318,4
100117,Toys,21.962413787841797,2023-05-06,67,50,16.505182342529295,1941.2244338989258,5,5,1,18,35385,4
100117,Toys,21.962413787841797,2023-05-07,47,51,19.82004451751709,1946.0841846466064,6,5,1,18,35432,4
100117,Toys,21.962413787841797,2023-05-08,41,50,18.57455680847168,1689.2536582946777,0,5,0,19,35473,4
100117,Toys,21.962413787841797,2023-05-09,17,0,18.68911361694336,317.7149314880371,1,5,0,19,35490,4
100117,Toys,21.962413787841797,2023-05-10,21,50,16.695588607788086,1166.3747215270996,2,5,0,19,35511,4
100117,Toys,21.962413787841797,2023-05-11,38,0,17.351177215576172,659.3447341918945,3,5,0,19,35549,4
100117,Toys,21.962413787841797,2023-05-12,40,50,16.96915023803711,1526.1320190429688,4,5,0,19,35589,4
100117,Toys,21.962413787841797,2023-05-13,50,127,19.54439220428467,3490.589220428467,5,5,1,19,35639,4
100117,Toys,21.962413787841797,2023-05-14,54,0,19.138784408569336,1033.4943580627441,6,5,1,19,35693,4
100117,Toys,21.962413787841797,2023-05-15,73,111,22.562720375061033,4183.737174758911,0,5,0,20,35766,4
100117,Toys,21.962413787841797,2023-05-16,111,113,23.764941902160643,5324.697102279663,1,5,0,20,35877,4
100117,Toys,21.962413787841797,2023-05-17,113,182,24.55331630706787,7267.149485397339,2,5,0,20,35990,4
100117,Toys,21.962413787841797,2023-05-18,126,0,24.206632614135742,3050.0357093811035,3,5,0,20,36116,4
100117,Toys,21.962413787841797,2023-05-19,56,131,23.257196350097658,4336.5559912109375,4,5,0,20,36172,4
100117,Toys,21.962413787841797,2023-05-20,69,0,23.424392700195312,1616.2830963134766,5,5,1,20,36241,4
100117,Toys,21.962413787841797,2023-05-21,62,171,23.715348129272463,5530.543168029786,6,5,1,20,36303,4
100117,Toys,21.962413787841797,2023-05-22,155,158,25.14302261352539,7871.317010192872,0,5,0,21,36458,4
100117,Toys,21.962413787841797,2023-05-23,123,0,24.62604522705078,3029.003562927246,1,5,0,21,36581,4
100117,Toys,21.962413787841797,2023-05-24,51,138,24.724625701904294,4674.291821594238,2,5,0,21,36632,4
100117,Toys,21.962413787841797,2023-05-25,138,142,23.571922874450685,6598.650713348388,3,5,0,21,36770,4
100117,Toys,21.962413787841797,2023-05-26,142,205,24.29871208190918,8437.404231262208,4,5,0,21,36912,4
100117,Toys,21.962413787841797,2023-05-27,126,0,24.20742416381836,3050.1354446411133,5,5,1,21,37038,4
100117,Toys,21.962413787841797,2023-05-28,79,137,21.186149482727053,4536.991618270875,6,5,1,21,37117,4
100117,Toys,21.962413787841797,2023-05-29,90,124,23.556963996887205,5061.693519439697,0,5,0,22,37207,4
100117,Toys,21.962413787841797,2023-05-30,119,0,22.953927993774414,2731.5174312591553,1,5,0,22,37326,4
100117,Toys,21.962413787841797,2023-05-31,52,130,23.84198963165283,4350.786921691894,2,5,0,22,37378,4
100117,Toys,21.962413787841797,2023-06-01,66,0,23.693979263305664,1563.8026313781738,3,6,0,22,37444,4
100117,Toys,21.962413787841797,2023-06-02,64,111,22.53038478851318,3930.5792529296873,4,6,0,22,37508,4
100117,Toys,21.962413787841797,2023-06-03,66,105,22.923947677612304,3921.791093444824,5,6,1,22,37574,4
100117,Toys,21.962413787841797,2023-06-04,112,0,22.87789535522461,2562.3242797851562,6,6,1,22,37686,4
100117,Toys,21.962413787841797,2023-06-05,38,114,20.33348690032959,3063.0650044250488,0,6,0,23,37724,4
100117,Toys,21.962413787841797,2023-06-06,100,92,23.16561954498291,4440.243908996582,1,6,0,23,37824,4
100117,Toys,21.962413787841797,2023-06-07,74,107,22.663501052856446,4106.928155822754,2,6,0,23,37898,4
100117,Toys,21.962413787841797,2023-06-08,25,0,22.51700210571289,562.9250526428223,3,6,0,23,37923,4
100117,Toys,21.962413787841797,2023-06-09,89,94,22.047303733825686,4033.770064620972,4,6,0,23,38012,4
100117,Toys,21.962413787841797,2023-06-10,75,0,22.224607467651367,1666.8455600738525,5,6,1,23,38087,4
100117,Toys,21.962413787841797,2023-06-11,44,110,23.283515434265137,3597.309358215332,6,6,1,23,38131,4
100117,Toys,21.962413787841797,2023-06-12,90,118,24.566125526428223,5122.74259475708,0,6,0,24,38221,4
100117,Toys,21.962413787841797,2023-06-13,118,127,23.02073699951172,5636.653931884766,1,6,0,24,38339,4
100117,Toys,21.962413787841797,2023-06-14,82,107,23.094855651855468,4361.806326904297,2,6,0,24,38421,4
100117,Toys,21.962413787841797,2023-06-15,107,0,23.219711303710938,2484.5091094970703,3,6,0,24,38528,4
100117,Toys,21.962413787841797,2023-06-16,65,159,21.70676670074463,4838.179671096801,4,6,0,24,38593,4
100117,Toys,21.962413787841797,2023-06-17,66,0,21.963533401489258,1449.593204498291,5,6,1,24,38659,4
100117,Toys,21.962413787841797,2023-06-18,45,58,20.999134216308594,2157.3320794677734,6,6,1,24,38704,4
100117,Toys,21.962413787841797,2023-06-19,106,142,21.35100082397461,5294.292174682617,0,6,0,25,38810,4
100117,Toys,21.962413787841797,2023-06-20,52,0,21.37200164794922,1111.3440856933594,1,6,0,25,38862,4
100117,Toys,21.962413787841797,2023-06-21,51,53,18.300420112609864,1900.4228514862061,2,6,0,25,38913,4
100117,Toys,21.962413787841797,2023-06-22,80,130,23.935760040283203,5081.721606445312,3,6,0,25,38993,4
100117,Toys,21.962413787841797,2023-06-23,64,0,22.831520080566406,1461.21728515625,4,6,0,25,39057,4
100117,Toys,21.962413787841797,2023-06-24,78,88,22.0193936920166,3652.72541595459,5,6,1,25,39135,4
100117,Toys,21.962413787841797,2023-06-25,69,64,22.084912185668948,2937.667881622315,6,6,1,25,39204,4
100117,Toys,21.962413787841797,2023-06-26,83,77,23.5078918838501,3758.4300527191162,0,6,0,26,39287,4
100117,Toys,21.962413787841797,2023-06-27,77,82,20.075740280151365,3187.3140031433104,1,6,0,26,39364,4
100117,Toys,21.962413787841797,2023-06-28,82,183,22.524833106994627,5996.87262954712,2,6,0,26,39446,4
100117,Toys,21.962413787841797,2023-06-29,93,0,22.249666213989258,2069.218957901001,3,6,0,26,39539,4
100117,Toys,21.962413787841797,2023-06-30,90,123,24.458380126953124,5229.158422851562,4,6,0,26,39629,4
100117,Toys,21.962413787841797,2023-07-01,76,0,23.86676025390625,1813.873779296875,5,7,1,26,39705,4
100117,Toys,21.962413787841797,2023-07-02,47,84,19.848426208496093,2567.642063598633,6,7,1,26,39752,4
100117,Toys,21.962413787841797,2023-07-03,84,165,24.295854339599607,6108.323529052735,0,7,0,27,39836,4
100117,Toys,21.962413787841797,2023-07-04,47,0,23.57170867919922,1107.8703079223633,1,7,0,27,39883,4
100117,Toys,21.962413787841797,2023-07-05,118,147,24.49543655395508,6498.963026733399,2,7,0,27,40001,4
100117,Toys,21.962413787841797,2023-07-06,52,0,24.230873107910156,1260.0054016113281,3,7,0,27,40053,4
100117,Toys,21.962413787841797,2023-07-07,37,0,24.230873107910156,896.5423049926758,4,7,0,27,40090,4
100117,Toys,21.962413787841797,2023-07-08,58,155,25.37903907775879,5423.288533020019,5,7,1,27,40148,4
100117,Toys,21.962413787841797,2023-07-09,155,252,30.47811065673828,12525.054303588866,6,7,1,27,40303,4
100117,Toys,21.962413787841797,2023-07-10,222,0,29.236221313476562,6490.441131591797,0,7,0,28,40525,4
100117,Toys,21.962413787841797,2023-07-11,30,117,23.519614753723147,3400.8668852233886,1,7,0,28,40555,4
100117,Toys,21.962413787841797,2023-07-12,79,131,24.246229896545408,5092.944323654175,2,7,0,28,40634,4
100117,Toys,21.962413787841797,2023-07-13,150,143,23.40399913787842,6859.499741363526,3,7,0,28,40784,4
100117,Toys,21.962413787841797,2023-07-14,67,0,23.707998275756836,1588.435884475708,4,7,0,28,40851,4
100117,Toys,21.962413787841797,2023-07-15,95,161,25.525858612060546,6561.953136291504,5,7,1,28,40946,4
100117,Toys,21.962413787841797,2023-07-16,36,0,25.111717224121094,904.0218200683594,6,7,1,28,40982,4
100117,Toys,21.962413787841797,2023-07-17,125,170,25.732991409301757,7598.747852325439,0,7,0,29,41107,4
100117,Toys,21.962413787841797,2023-07-18,75,0,25.565982818603516,1917.4487113952637,1,7,0,29,41182,4
100117,Toys,21.962413787841797,2023-07-19,95,112,25.091348266601564,5191.5061706542965,2,7,0,29,41277,4
100117,Toys,21.962413787841797,2023-07-20,97,83,22.74303066253662,4107.787948532105,3,7,0,29,41374,4
100117,Toys,21.962413787841797,2023-07-21,98,78,20.09043773651123,3564.125796356201,4,7,0,29,41472,4
100117,Toys,21.962413787841797,2023-07-22,78,170,26.03408950805664,6534.277963256835,5,7,1,29,41550,4
100117,Toys,21.962413787841797,2023-07-23,78,0,25.18817901611328,1964.677963256836,6,7,1,29,41628,4
100117,Toys,21.962413787841797,2023-07-24,49,69,21.468051185607912,2503.469016189575,0,7,0,30,41677,4
100117,Toys,21.962413787841797,2023-07-25,74,116,19.5718501663208,3672.3738246154785,1,7,0,30,41751,4
100117,Toys,21.962413787841797,2023-07-26,126,0,20.6737003326416,2604.886241912842,2,7,0,30,41877,4
100117,Toys,21.962413787841797,2023-07-27,28,184,25.582886543273926,5477.72164642334,3,7,0,30,41905,4
100117,Toys,21.962413787841797,2023-07-28,59,0,25.23577308654785,1488.9106121063232,4,7,0,30,41964,4
100117,Toys,21.962413787841797,2023-07-29,43,0,25.23577308654785,1085.1382427215576,5,7,1,30,42007,4
100117,Toys,21.962413787841797,2023-07-30,82,100,24.1931689453125,4397.69970703125,6,7,1,30,42089,4
100117,Toys,21.962413787841797,2023-07-31,60,94,23.318849639892576,3577.2019567871093,0,7,0,31,42149,4
100117,Toys,21.962413787841797,2023-08-01,88,118,20.954388236999513,4286.472329711914,1,8,0,31,42237,4
100117,Toys,21.962413787841797,2023-08-02,164,174,22.732247581481936,7685.977206726075,2,8,0,31,42401,4
100117,Toys,21.962413787841797,2023-08-03,103,0,22.484495162963867,2315.9030017852783,3,8,0,31,42504,4
100117,Toys,21.962413787841797,2023-08-04,71,123,24.17203369140625,4709.028784179687,4,8,0,31,42575,4
100117,Toys,21.962413787841797,2023-08-05,64,102,22.177911911010742,3658.432724609375,5,8,1,31,42639,4
100117,Toys,21.962413787841797,2023-08-06,45,0,22.785823822021484,1025.3620719909668,6,8,1,31,42684,4
100117,Toys,21.962413787841797,2023-08-07,62,76,21.97915500640869,3028.235220794678,0,8,0,32,42746,4
100117,Toys,21.962413787841797,2023-08-08,72,110,21.002459411621096,3803.734155273438,1,8,0,32,42818,4
100117,Toys,21.962413787841797,2023-08-09,78,0,21.494918823242188,1676.6036682128906,2,8,0,32,42896,4
100117,Toys,21.962413787841797,2023-08-10,62,88,21.2297261428833,3182.1260417175295,3,8,0,32,42958,4
100117,Toys,21.962413787841797,2023-08-11,116,161,19.73865810394287,5448.7686801147465,4,8,0,32,43074,4
100117,Toys,21.962413787841797,2023-08-12,51,0,20.157316207885742,1028.0231266021729,5,8,1,32,43125,4
100117,Toys,21.962413787841797,2023-08-13,87,76,18.53931396484375,3029.380629882812,6,8,1,32,43212,4
100117,Toys,21.962413787841797,2023-08-14,99,121,23.900690917968753,5288.0568017578125,0,8,0,33,43311,4
100117,Toys,21.962413787841797,2023-08-15,113,142,24.38822624206543,6234.999130706787,1,8,0,33,43424,4
100117,Toys,21.962413787841797,2023-08-16,69,0,23.83645248413086,1644.7152214050293,2,8,0,33,43493,4
100117,Toys,21.962413787841797,2023-08-17,81,171,24.02407196044922,6057.299657592774,3,8,0,33,43574,4
100117,Toys,21.962413787841797,2023-08-18,50,0,23.988143920898438,1199.4071960449219,4,8,0,33,43624,4
100117,Toys,21.962413787841797,2023-08-19,106,100,23.5973201751709,4861.9318771362305,5,8,1,33,43730,4
100117,Toys,21.962413787841797,2023-08-20,115,190,23.586694145202635,7191.189653396606,6,8,1,33,43845,4
100117,Toys,21.962413787841797,2023-08-21,113,0,23.623388290405273,2669.442876815796,0,8,0,34,43958,4
100117,Toys,21.962413787841797,2023-08-22,77,99,20.620741500854493,3610.754191131592,1,8,0,34,44035,4
100117,Toys,21.962413787841797,2023-08-23,73,90,21.94753128051758,3580.3795669555666,2,8,0,34,44108,4
100117,Toys,21.962413787841797,2023-08-24,116,106,22.31060218811035,4951.059707641602,3,8,0,34,44224,4
100117,Toys,21.962413787841797,2023-08-25,106,91,18.684790573120118,3699.875601501465,4,8,0,34,44330,4
100117,Toys,21.962413787841797,2023-08-26,91,149,25.51748291015625,6199.741889648438,5,8,1,34,44421,4
100117,Toys,21.962413787841797,2023-08-27,149,117,25.658439979553222,6807.17511390686,6,8,1,34,44570,4
100117,Toys,21.962413787841797,2023-08-28,27,0,25.096879959106445,677.615758895874,0,8,0,35,44597,4
100117,Toys,21.962413787841797,2023-08-29,87,121,24.965590324401855,5191.632716445923,1,8,0,35,44684,4
100117,Toys,21.962413787841797,2023-08-30,124,128,24.04275058746338,6057.5221456909185,2,8,0,35,44808,4
100117,Toys,21.962413787841797,2023-08-31,74,112,23.090134086608884,4277.279844818115,3,8,0,35,44882,4
100117,Toys,21.962413787841797,2023-09-01,109,0,23.550268173217773,2566.9792308807373,4,9,0,35,44991,4
100117,Toys,21.962413787841797,2023-09-02,57,81,23.8912508392334,3299.1225956726075,5,9,1,35,45048,4
100117,Toys,21.962413787841797,2023-09-03,81,136,25.256388587951662,5498.984951248169,6,9,1,35,45129,4
100117,Toys,21.962413787841797,2023-09-04,62,0,24.92277717590332,1545.2121849060059,0,9,0,36,45191,4
100117,Toys,21.962413787841797,2023-09-05,74,115,22.419379501342775,4212.27816619873,1,9,0,36,45265,4
100117,Toys,21.962413787841797,2023-09-06,115,125,22.984077796936035,5516.037893295288,2,9,0,36,45380,4
100117,Toys,21.962413787841797,2023-09-07,58,92,22.849952239990234,3425.454459838867,3,9,0,36,45438,4
100117,Toys,21.962413787841797,2023-09-08,64,0,22.90990447998047,1466.23388671875,4,9,0,36,45502,4
100117,Toys,21.962413787841797,2023-09-09,78,84,18.42869022369385,2975.73567489624,5,9,1,36,45580,4
100117,Toys,21.962413787841797,2023-09-10,101,115,20.080036087036135,4337.427289581299,6,9,1,36,45681,4
100117,Toys,21.962413787841797,2023-09-11,44,0,20.070072174072266,883.0831756591797,0,9,0,37,45725,4
100117,Toys,21.962413787841797,2023-09-12,71,83,20.416283378601072,3145.3522397613524,1,9,0,37,45796,4
100117,Toys,21.962413787841797,2023-09-13,83,138,26.48333271026611,5931.283229904175,2,9,0,37,45879,4
100117,Toys,21.962413787841797,2023-09-14,117,100,24.107520446777343,5237.919784545898,3,9,0,37,45996,4
100117,Toys,21.962413787841797,2023-09-15,54,0,24.495040893554688,1322.7322082519531,4,9,0,37,46050,4
100117,Toys,21.962413787841797,2023-09-16,67,153,23.931267776489257,5256.16988204956,5,9,1,37,46117,4
100117,Toys,21.962413787841797,2023-09-17,99,123,21.312876472473143,4706.429541549683,6,9,1,37,46216,4
100117,Toys,21.962413787841797,2023-09-18,69,0,22.35575294494629,1542.546953201294,0,9,0,38,46285,4
100117,Toys,21.962413787841797,2023-09-19,104,112,23.022956962585447,4974.695048217773,1,9,0,38,46389,4
100117,Toys,21.962413787841797,2023-09-20,110,122,25.236735115051268,5864.32172531128,2,9,0,38,46499,4
100117,Toys,21.962413787841797,2023-09-21,50,0,24.45347023010254,1222.673511505127,3,9,0,38,46549,4
100117,Toys,21.962413787841797,2023-09-22,78,128,25.399152336120608,5243.267764434815,4,9,0,38,46627,4
100117,Toys,21.962413787841797,2023-09-23,63,0,25.17830467224121,1586.2331943511963,5,9,1,38,46690,4
100117,Toys,21.962413787841797,2023-09-24,65,121,25.30349353790283,4707.9341599273685,6,9,1,38,46755,4
100117,Toys,21.962413787841797,2023-09-25,95,129,21.6711909866333,4815.206287460327,0,9,0,39,46850,4
100117,Toys,21.962413787841797,2023-09-26,155,144,21.620517349243165,6469.16037826538,1,9,0,39,47005,4
100117,Toys,21.962413787841797,2023-09-27,92,119,23.303933753967286,4929.98381072998,2,9,0,39,47097,4
100117,Toys,21.962413787841797,2023-09-28,78,0,22.82786750793457,1780.5736656188965,3,9,0,39,47175,4
100117,Toys,21.962413787841797,2023-09-29,93,189,25.769223022460938,7322.675482177735,4,9,0,39,47268,4
100117,Toys,21.962413787841797,2023-09-30,40,0,25.188446044921875,1007.537841796875,5,9,1,39,47308,4
100117,Toys,21.962413787841797,2023-10-01,48,0,25.188446044921875,1209.04541015625,6,10,1,39,47356,4
100117,Toys,21.962413787841797,2023-10-02,93,122,23.51106048583984,5040.637250366211,0,10,0,40,47449,4
100117,Toys,21.962413787841797,2023-10-03,99,0,24.002120971679688,2376.209976196289,1,10,0,40,47548,4
100117,Toys,21.962413787841797,2023-10-04,31,78,19.900026664733886,2137.141653213501,2,10,0,40,47579,4
100117,Toys,21.962413787841797,2023-10-05,56,87,20.373831062316896,2911.479078979492,3,10,0,40,47635,4
100117,Toys,21.962413787841797,2023-10-06,47,0,20.43766212463379,960.5701198577881,4,10,0,40,47682,4
100117,Toys,21.962413787841797,2023-10-07,24,0,20.43766212463379,490.50389099121094,5,10,1,40,47706,4
100117,Toys,21.962413787841797,2023-10-08,38,50,16.824835815429687,1468.6475219726562,6,10,1,40,47744,4
100117,Toys,21.962413787841797,2023-10-09,11,0,17.819671630859375,196.01638793945312,0,10,0,41,47755,4
100117,Toys,21.962413787841797,2023-10-10,23,50,16.12537784576416,1164.3173809051514,1,10,0,41,47778,4
100117,Toys,21.962413787841797,2023-10-11,21,0,16.60075569152832,348.6158695220947,2,10,0,41,47799,4
100117,Toys,21.962413787841797,2023-10-12,42,54,16.901535148620603,1623.608952484131,3,10,0,41,47841,4
100117,Toys,21.962413787841797,2023-10-13,32,51,18.02539394378662,1504.3652124023438,4,10,0,41,47873,4
100117,Toys,21.962413787841797,2023-10-14,11,0,17.590787887573242,193.49866676330566,5,10,1,41,47884,4
100117,Toys,21.962413787841797,2023-10-15,28,50,18.680657081604004,1466.5367965698242,6,10,1,41,47912,4
100117,Toys,21.962413787841797,2023-10-16,9,0,18.251314163208008,164.26182746887207,0,10,0,42,47921,4
100117,Toys,21.962413787841797,2023-10-17,30,50,16.10188491821289,1269.3130950927734,1,10,0,42,47951,4
100117,Toys,21.962413787841797,2023-10-18,26,0,17.04376983642578,443.1380157470703,2,10,0,42,47977,4
100117,Toys,21.962413787841797,2023-10-19,5,0,17.04376983642578,85.2188491821289,3,10,0,42,47982,4
100117,Toys,21.962413787841797,2023-10-20,20,0,17.04376983642578,340.8753967285156,4,10,0,42,48002,4
100117,Toys,21.962413787841797,2023-10-21,47,50,19.465655441284177,1890.491611480713,5,10,1,42,48049,4
100117,Toys,21.962413787841797,2023-10-22,50,59,18.212502632141113,1983.8802632141114,6,10,1,42,48099,4
100117,Toys,21.962413787841797,2023-10-23,39,50,18.920254173278806,1686.209825515747,0,10,0,43,48138,4
100117,Toys,21.962413787841797,2023-10-24,56,63,19.41013343811035,2311.5549450683593,1,10,0,43,48194,4
100117,Toys,21.962413787841797,2023-10-25,77,95,19.85084476470947,3417.930093765259,2,10,0,43,48271,4
100117,Toys,21.962413787841797,2023-10-26,91,94,19.508176307678223,3608.8680879974363,3,10,0,43,48362,4
100117,Toys,21.962413787841797,2023-10-27,98,129,24.84432258605957,5684.7872268676765,4,10,0,43,48460,4
100117,Toys,21.962413787841797,2023-10-28,99,102,22.099427032470704,4440.4865524292,5,10,1,43,48559,4
100117,Toys,21.962413787841797,2023-10-29,64,0,22.598854064941406,1446.32666015625,6,10,1,43,48623,4
100117,Toys,21.962413787841797,2023-10-30,60,76,22.21014587402344,3018.6575048828126,0,10,0,44,48683,4
100117,Toys,21.962413787841797,2023-10-31,84,89,21.989319267272947,3803.605636901855,1,10,0,44,48767,4
100117,Toys,21.962413787841797,2023-11-01,26,0,22.0986385345459,574.5646018981934,2,11,0,44,48793,4
100117,Toys,21.962413787841797,2023-11-02,63,119,20.619571952819825,3735.4260660552977,3,11,0,44,48856,4
100117,Toys,21.962413787841797,2023-11-03,52,0,20.92914390563965,1088.3154830932617,4,11,0,44,48908,4
100117,Toys,21.962413787841797,2023-11-04,67,95,19.866922302246095,3210.6875885009767,5,11,1,44,48975,4
100117,Toys,21.962413787841797,2023-11-05,71,95,19.780961112976073,3280.7364780426024,6,11,1,44,49046,4
100117,Toys,21.962413787841797,2023-11-06,62,86,21.362655143737793,3176.0092378234867,0,11,0,45,49108,4
100117,Toys,21.962413787841797,2023-11-07,88,0,20.765310287475586,1827.3473052978516,1,11,0,45,49196,4
100117,Toys,21.962413787841797,2023-11-08,55,156,20.952018966674807,4423.702086334229,2,11,0,45,49251,4
100117,Toys,21.962413787841797,2023-11-09,60,0,20.92403793334961,1255.4422760009766,3,11,0,45,49311,4
100117,Toys,21.962413787841797,2023-11-10,32,0,20.92403793334961,669.5692138671875,4,11,0,45,49343,4
100117,Toys,21.962413787841797,2023-11-11,64,90,22.83798210144043,3530.101708984375,5,11,1,45,49407,4
100117,Toys,21.962413787841797,2023-11-12,74,97,23.44769229888916,4017.6584602355956,6,11,1,45,49481,4
100117,Toys,21.962413787841797,2023-11-13,113,100,23.319197845458984,4965.9387130737305,0,11,0,46,49594,4
100117,Toys,21.962413787841797,2023-11-14,100,101,22.74378017425537,4571.336034851074,1,11,0,46,49694,4
100117,Toys,21.962413787841797,2023-11-15,101,172,22.290134620666503,6075.257193374633,2,11,0,46,49795,4
100117,Toys,21.962413787841797,2023-11-16,29,0,22.430269241333008,650.4778079986572,3,11,0,46,49824,4
100117,Toys,21.962413787841797,2023-11-17,77,0,22.430269241333008,1727.1307315826416,4,11,0,46,49901,4
100117,Toys,21.962413787841797,2023-11-18,66,75,20.767935638427737,2923.707504272461,5,11,1,46,49967,4
100117,Toys,21.962413787841797,2023-11-19,75,85,22.695438804626463,3635.61582069397,6,11,1,46,50042,4
100117,Toys,21.962413787841797,2023-11-20,52,61,19.99885097503662,2251.5105014038086,0,11,0,47,50094,4
100117,Toys,21.962413787841797,2023-11-21,93,128,22.041000289916994,4881.526053924561,1,11,0,47,50187,4
100117,Toys,21.962413787841797,2023-11-22,55,0,21.742000579833984,1195.8100318908691,2,11,0,47,50242,4
100117,Toys,21.962413787841797,2023-11-23,74,80,17.15924690246582,2633.8285415649416,3,11,0,47,50316,4
100117,Toys,21.962413787841797,2023-11-24,80,167,25.21364318847656,6338.81291015625,4,11,0,47,50396,4
100117,Toys,21.962413787841797,2023-11-25,93,0,23.937286376953125,2226.1676330566406,5,11,1,47,50489,4
100117,Toys,21.962413787841797,2023-11-26,74,134,22.385718727111815,4636.08637161255,6,11,1,47,50563,4
100117,Toys,21.962413787841797,2023-11-27,34,0,22.721437454223633,772.5288734436035,0,11,0,48,50597,4
100117,Toys,21.962413787841797,2023-11-28,76,148,25.53061210632324,5769.933040161133,1,11,0,48,50673,4
100117,Toys,21.962413787841797,2023-11-29,65,0,24.821224212646484,1613.3795738220215,2,11,0,48,50738,4
100117,Toys,21.962413787841797,2023-11-30,102,172,24.02007297515869,6568.194886932372,3,11,0,48,50840,4
100117,Toys,21.962413787841797,2023-12-01,80,0,24.210145950317383,1936.8116760253906,4,12,0,48,50920,4
100117,Toys,21.962413787841797,2023-12-02,46,0,24.210145950317383,1113.6667137145996,5,12,1,48,50966,4
100117,Toys,21.962413787841797,2023-12-03,51,102,26.093357429504394,4011.4924578094483,6,12,1,48,51017,4
100117,Toys,21.962413787841797,2023-12-04,14,0,25.71671485900879,360.03400802612305,0,12,0,49,51031,4
100117,Toys,21.962413787841797,2023-12-05,54,80,22.176282844543458,2938.9585472106937,1,12,0,49,51085,4
100117,Toys,21.962413787841797,2023-12-06,114,174,22.443945503234865,6449.219574737548,2,12,0,49,51199,4
100117,Toys,21.962413787841797,2023-12-07,76,0,22.687891006469727,1724.2797164916992,3,12,0,49,51275,4
100117,Toys,21.962413787841797,2023-12-08,98,128,19.51763946533203,4384.657335205078,4,12,0,49,51373,4
100117,Toys,21.962413787841797,2023-12-09,75,0,20.395278930664062,1529.6459197998047,5,12,1,49,51448,4
100117,Toys,21.962413787841797,2023-12-10,53,151,22.75735252380371,4677.059367523194,6,12,1,49,51501,4
100117,Toys,21.962413787841797,2023-12-11,95,160,23.082653427124022,5900.204151153564,0,12,0,50,51596,4
100117,Toys,21.962413787841797,2023-12-12,129,227,26.181045532226562,9425.209747314453,1,12,0,50,51725,4
100117,Toys,21.962413787841797,2023-12-13,88,0,25.112091064453125,2209.864013671875,2,12,0,50,51813,4
100117,Toys,21.962413787841797,2023-12-14,109,0,25.112091064453125,2737.2179260253906,3,12,0,50,51922,4
100117,Toys,21.962413787841797,2023-12-15,94,116,19.785654067993164,4115.702964782715,4,12,0,50,52016,4
100117,Toys,21.962413787841797,2023-12-16,139,152,19.675003089904784,5717.69085899353,5,12,1,50,52155,4
100117,Toys,21.962413787841797,2023-12-17,122,0,20.27000617980957,2472.9407539367676,6,12,1,50,52277,4
100117,Toys,21.962413787841797,2023-12-18,30,64,21.35415008544922,2014.289005126953,0,12,0,51,52307,4
100117,Toys,21.962413787841797,2023-12-19,64,141,23.124467010498044,4768.66177734375,1,12,0,51,52371,4
100117,Toys,21.962413787841797,2023-12-20,86,140,23.111814727783205,5229.652133178712,2,12,0,51,52457,4
100117,Toys,21.962413787841797,2023-12-21,97,0,22.993629455566406,2230.3820571899414,3,12,0,51,52554,4
100117,Toys,21.962413787841797,2023-12-22,98,161,21.320416297912598,5497.391594390869,4,12,0,51,52652,4
100117,Toys,21.962413787841797,2023-12-23,95,0,21.710832595825195,2062.5290966033936,5,12,1,51,52747,4
100117,Toys,21.962413787841797,2023-12-24,66,164,20.630901908874513,4727.379051971435,6,12,1,51,52813,4
100117,Toys,21.962413787841797,2023-12-25,99,0,20.811803817749023,2060.3685779571533,0,12,0,52,52912,4
100117,Toys,21.962413787841797,2023-12-26,65,119,22.539394454956053,4167.261279144287,1,12,0,52,52977,4
100117,Toys,21.962413787841797,2023-12-27,18,0,22.16878890991211,399.03820037841797,2,12,0,52,52995,4
100117,Toys,21.962413787841797,2023-12-28,49,0,22.16878890991211,1086.2706565856934,3,12,0,52,53044,4
100117,Toys,21.962413787841797,2023-12-29,27,50,18.49635803222656,1395.3233337402344,4,12,0,52,53071,4
100117,Toys,21.962413787841797,2023-12-30,18,0,19.752716064453125,355.54888916015625,5,12,1,52,53089,4
100117,Toys,21.962413787841797,2023-12-31,38,50,18.57689208984375,1629.643798828125,6,12,1,52,53127,4
100117,Toys,21.962413787841797,2024-01-01,14,0,19.0037841796875,266.052978515625,0,1,0,1,53141,4
100117,Toys,21.962413787841797,2024-01-02,23,50,17.51003860473633,1263.921775817871,1,1,0,1,53164,4
100117,Toys,21.962413787841797,2024-01-03,32,0,18.040077209472656,577.282470703125,2,1,0,1,53196,4
100117,Toys,21.962413787841797,2024-01-04,3,0,18.040077209472656,54.12023162841797,3,1,0,1,53199,4
100117,Toys,21.962413787841797,2024-01-05,8,0,18.040077209472656,144.32061767578125,4,1,0,1,53207,4
100117,Toys,21.962413787841797,2024-01-06,7,50,17.3918709564209,983.5161933898926,5,1,1,1,53214,4
100117,Toys,21.962413787841797,2024-01-07,22,0,17.573741912841797,386.62232208251953,6,1,1,1,53236,4
100117,Toys,21.962413787841797,2024-01-08,33,50,15.636474685668945,1285.4773292541504,0,1,0,2,53269,4
100117,Toys,21.962413787841797,2024-01-09,61,117,21.72293128967285,3940.997617340088,1,1,0,2,53330,4
100117,Toys,21.962413787841797,2024-01-10,77,0,20.395862579345703,1570.4814186096191,2,1,0,2,53407,4
100117,Toys,21.962413787841797,2024-01-11,37,63,19.15255619049072,1905.3091580963135,3,1,0,2,53444,4
100117,Toys,21.962413787841797,2024-01-12,72,112,23.17468852996826,4303.155148315429,4,1,0,2,53516,4
100117,Toys,21.962413787841797,2024-01-13,122,172,25.78997253417969,7629.253298339844,5,1,1,2,53638,4
100117,Toys,21.962413787841797,2024-01-14,37,0,24.849945068359375,919.4479675292969,6,1,1,2,53675,4
100117,Toys,21.962413787841797,2024-01-15,113,99,21.982484016418457,4676.561387710572,0,1,0,3,53788,4
100117,Toys,21.962413787841797,2024-01-16,60,0,23.144968032836914,1388.6980819702148,1,1,0,3,53848,4
100117,Toys,21.962413787841797,2024-01-17,61,120,24.620892486572266,4474.028883361816,2,1,0,3,53909,4
100117,Toys,21.962413787841797,2024-01-18,120,166,27.299465103149416,7844.011624755859,3,1,0,3,54029,4
100117,Toys,21.962413787841797,2024-01-19,66,0,26.508930206298828,1749.5893936157227,4,1,0,3,54095,4
100117,Toys,21.962413787841797,2024-01-20,100,246,29.315856475830078,10212.511295166016,5,1,1,3,54195,4
100117,Toys,21.962413787841797,2024-01-21,64,0,28.841712951660156,1845.86962890625,6,1,1,3,54259,4
100117,Toys,21.962413787841797,2024-01-22,182,193,29.16606880187988,10938.419043884278,0,1,0,4,54441,4
100117,Toys,21.962413787841797,2024-01-23,71,0,29.062137603759766,2063.4117698669434,1,1,0,4,54512,4
100117,Toys,21.962413787841797,2024-01-24,66,99,22.24792022705078,3585.175469970703,2,1,0,4,54578,4
100117,Toys,21.962413787841797,2024-01-25,106,0,24.845840454101562,2633.6590881347656,3,1,0,4,54684,4
100117,Toys,21.962413787841797,2024-01-26,49,82,22.044450950622558,2866.556193161011,4,1,0,4,54733,4
100117,Toys,21.962413787841797,2024-01-27,82,105,21.885588722229002,4087.416550445557,5,1,1,4,54815,4
100117,Toys,21.962413787841797,2024-01-28,105,143,21.1642809677124,5239.079003219605,6,1,1,4,54920,4
100117,Toys,21.962413787841797,2024-01-29,85,128,22.2662068939209,4755.765171966553,0,1,0,5,55005,4
100117,Toys,21.962413787841797,2024-01-30,95,0,21.962413787841797,2086.4293098449707,1,1,0,5,55100,4
100118,Groceries,65.29276275634766,2022-01-01,78,281,54.400000762939456,19529.600119018556,5,1,1,52,78,3
100118,Groceries,65.29276275634766,2022-01-02,172,155,62.94761184692383,20526.3684753418,6,1,1,52,250,3
100118,Groceries,65.29276275634766,2022-01-03,134,115,68.24095016479492,16918.294644165042,0,1,0,1,384,3
100118,Groceries,65.29276275634766,2022-01-04,63,117,59.785769882202146,10658.52700515747,1,1,0,1,447,3
100118,Groceries,65.29276275634766,2022-01-05,109,119,58.902751235961915,13416.399769439697,2,1,0,1,556,3
100118,Groceries,65.29276275634766,2022-01-06,123,0,60.24550247192383,7410.196804046631,3,1,0,1,679,3
100118,Groceries,65.29276275634766,2022-01-07,108,134,52.861062164306645,12737.229427490234,4,1,0,1,787,3
100118,Groceries,65.29276275634766,2022-01-08,134,229,73.35196197509765,27021.775809326173,5,1,1,1,921,3
100118,Groceries,65.29276275634766,2022-01-09,81,0,69.19392395019531,5604.70783996582,6,1,1,1,1002,3
100118,Groceries,65.29276275634766,2022-01-10,148,218,84.33330627441407,31134.558657226564,0,1,0,2,1150,3
100118,Groceries,65.29276275634766,2022-01-11,49,0,80.49661254882812,3944.334014892578,1,1,0,2,1199,3
100118,Groceries,65.29276275634766,2022-01-12,111,133,64.48183334350585,15596.6870022583,2,1,0,2,1310,3
100118,Groceries,65.29276275634766,2022-01-13,145,112,69.51642166137695,17883.752281799316,3,1,0,2,1455,3
100118,Groceries,65.29276275634766,2022-01-14,109,120,63.02422546386718,14401.811151123045,4,1,0,2,1564,3
100118,Groceries,65.29276275634766,2022-01-15,120,121,65.55027267456055,15797.505441894531,5,1,1,2,1684,3
100118,Groceries,65.29276275634766,2022-01-16,114,164,65.95088806152344,18339.30247802734,6,1,1,2,1798,3
100118,Groceries,65.29276275634766,2022-01-17,91,0,65.85177612304688,5992.511627197266,0,1,0,3,1889,3
100118,Groceries,65.29276275634766,2022-01-18,129,128,63.58838562011719,16342.973489990234,1,1,0,3,2018,3
100118,Groceries,65.29276275634766,2022-01-19,128,189,60.31890716552734,19058.940234374997,2,1,0,3,2146,3
100118,Groceries,65.29276275634766,2022-01-20,116,149,55.900262374877926,14743.930870971679,3,1,0,3,2262,3
100118,Groceries,65.29276275634766,2022-01-21,105,0,58.01052474975586,6091.105098724365,4,1,0,3,2367,3
100118,Groceries,65.29276275634766,2022-01-22,105,116,66.86244873046874,14809.244233398436,5,1,1,3,2472,3
100118,Groceries,65.29276275634766,2022-01-23,71,96,54.977113800048826,9092.000159606934,6,1,1,3,2543,3
100118,Groceries,65.29276275634766,2022-01-24,93,89,56.10670875549316,10215.927828521728,0,1,0,4,2636,3
100118,Groceries,65.29276275634766,2022-01-25,94,93,55.521445159912105,10383.271690063477,1,1,0,4,2730,3
100118,Groceries,65.29276275634766,2022-01-26,148,291,86.57797943115234,38886.0419116211,2,1,0,4,2878,3
100118,Groceries,65.29276275634766,2022-01-27,121,0,80.43595886230469,9732.751022338867,3,1,0,4,2999,3
100118,Groceries,65.29276275634766,2022-01-28,121,139,61.52574996948242,15867.531492614748,4,1,0,4,3120,3
100118,Groceries,65.29276275634766,2022-01-29,138,144,66.95843673706054,18878.14853942871,5,1,1,4,3258,3
100118,Groceries,65.29276275634766,2022-01-30,116,139,61.88728881835938,15726.811005859376,6,1,1,4,3374,3
100118,Groceries,65.29276275634766,2022-01-31,123,132,67.36620880126952,17191.017365112304,0,1,0,5,3497,3
100118,Groceries,65.29276275634766,2022-02-01,140,153,62.40235740661621,18264.230073852537,1,2,0,5,3637,3
100118,Groceries,65.29276275634766,2022-02-02,93,0,63.91471481323242,5944.068477630615,2,2,0,5,3730,3
100118,Groceries,65.29276275634766,2022-02-03,66,77,57.60212577819824,8203.31060272217,3,2,0,5,3796,3
100118,Groceries,65.29276275634766,2022-02-04,81,140,55.77142608642578,12221.561026000976,4,2,0,5,3877,3
100118,Groceries,65.29276275634766,2022-02-05,124,0,57.53285217285156,7134.073669433594,5,2,1,5,4001,3
100118,Groceries,65.29276275634766,2022-02-06,92,197,68.46965744018556,20005.11696899414,6,2,1,5,4093,3
100118,Groceries,65.29276275634766,2022-02-07,64,0,66.3993148803711,4249.55615234375,0,2,0,6,4157,3
100118,Groceries,65.29276275634766,2022-02-08,66,65,54.74408798217773,7177.369613647461,1,2,0,6,4223,3
100118,Groceries,65.29276275634766,2022-02-09,120,173,65.84275497436523,19368.10119384766,2,2,0,6,4343,3
100118,Groceries,65.29276275634766,2022-02-10,63,0,64.40550994873047,4057.5471267700195,3,2,0,6,4406,3
100118,Groceries,65.29276275634766,2022-02-11,122,174,62.32106842041016,18418.90069458008,4,2,0,6,4528,3
100118,Groceries,65.29276275634766,2022-02-12,30,0,62.86213684082031,1885.8641052246094,5,2,1,6,4558,3
100118,Groceries,65.29276275634766,2022-02-13,88,98,63.15567649841309,11748.199063720704,6,2,1,6,4646,3
100118,Groceries,65.29276275634766,2022-02-14,111,120,58.982533645629886,13610.722469329834,0,2,0,7,4757,3
100118,Groceries,65.29276275634766,2022-02-15,123,138,66.60673599243164,17418.007054138183,1,2,0,7,4880,3
100118,Groceries,65.29276275634766,2022-02-16,139,182,56.441635055541994,18005.894545440675,2,2,0,7,5019,3
100118,Groceries,65.29276275634766,2022-02-17,110,130,68.11973335266114,16432.14133758545,3,2,0,7,5129,3
100118,Groceries,65.29276275634766,2022-02-18,154,0,63.949466705322266,9848.217872619629,4,2,0,7,5283,3
100118,Groceries,65.29276275634766,2022-02-19,87,90,63.36156364440918,11214.422074127197,5,2,1,7,5370,3
100118,Groceries,65.29276275634766,2022-02-20,90,179,68.08048736572266,18394.597725830077,6,2,1,7,5460,3
100118,Groceries,65.29276275634766,2022-02-21,68,0,67.17097473144531,4567.626281738281,0,2,0,8,5528,3
100118,Groceries,65.29276275634766,2022-02-22,107,146,72.24299270629882,18331.96043914795,1,2,0,8,5635,3
100118,Groceries,65.29276275634766,2022-02-23,108,147,65.16817855834961,16543.076568603516,2,2,0,8,5743,3
100118,Groceries,65.29276275634766,2022-02-24,64,0,67.08635711669922,4293.52685546875,3,2,0,8,5807,3
100118,Groceries,65.29276275634766,2022-02-25,124,109,57.78112060546875,13513.86791015625,4,2,0,8,5931,3
100118,Groceries,65.29276275634766,2022-02-26,110,111,52.35227760314942,11566.93107269287,5,2,1,8,6041,3
100118,Groceries,65.29276275634766,2022-02-27,84,110,61.32200317382812,11949.196533203125,6,2,1,8,6125,3
100118,Groceries,65.29276275634766,2022-02-28,95,121,56.918641357421876,12272.101857910156,0,2,0,9,6220,3
100118,Groceries,65.29276275634766,2022-03-01,149,243,72.68567260742188,28844.75043701172,1,3,0,9,6369,3
100118,Groceries,65.29276275634766,2022-03-02,69,0,68.94134521484375,4756.952819824219,2,3,0,9,6438,3
100118,Groceries,65.29276275634766,2022-03-03,87,115,62.07031845092773,12451.675410461427,3,3,0,9,6525,3
100118,Groceries,65.29276275634766,2022-03-04,127,141,74.45758926391602,20011.087673034668,4,3,0,9,6652,3
100118,Groceries,65.29276275634766,2022-03-05,230,238,76.55351486206055,35843.016836547846,5,3,1,9,6882,3
100118,Groceries,65.29276275634766,2022-03-06,81,0,74.5570297241211,6039.119407653809,6,3,1,9,6963,3
100118,Groceries,65.29276275634766,2022-03-07,81,123,68.99632934570312,13984.265354003906,0,3,0,10,7044,3
100118,Groceries,65.29276275634766,2022-03-08,63,0,71.16265869140625,4483.247497558594,1,3,0,10,7107,3
100118,Groceries,65.29276275634766,2022-03-09,136,210,69.86693801879883,24150.50714111328,2,3,0,10,7243,3
100118,Groceries,65.29276275634766,2022-03-10,57,0,70.18387603759766,4000.4809341430664,3,3,0,10,7300,3
100118,Groceries,65.29276275634766,2022-03-11,54,71,59.13199157714844,7294.055090332031,4,3,0,10,7354,3
100118,Groceries,65.29276275634766,2022-03-12,126,116,59.58317642211914,14441.460458374024,5,3,1,10,7480,3
100118,Groceries,65.29276275634766,2022-03-13,79,119,61.811822204589845,12238.667908325195,6,3,1,10,7559,3
100118,Groceries,65.29276275634766,2022-03-14,60,0,61.81364440917969,3708.8186645507812,0,3,0,11,7619,3
100118,Groceries,65.29276275634766,2022-03-15,140,189,70.07673385620117,23164.67547973633,1,3,0,11,7759,3
100118,Groceries,65.29276275634766,2022-03-16,75,115,64.1748292541504,12127.024388122558,2,3,0,11,7834,3
100118,Groceries,65.29276275634766,2022-03-17,199,183,74.44440734863281,28384.71412475586,3,3,0,11,8033,3
100118,Groceries,65.29276275634766,2022-03-18,79,0,71.12881469726562,5619.176361083984,4,3,0,11,8112,3
100118,Groceries,65.29276275634766,2022-03-19,60,50,57.77630752563476,6431.856903076172,5,3,1,11,8172,3
100118,Groceries,65.29276275634766,2022-03-20,78,122,68.958544921875,13844.133007812501,6,3,1,11,8250,3
100118,Groceries,65.29276275634766,2022-03-21,168,185,74.03327285766602,26167.009680175783,0,3,0,12,8418,3
100118,Groceries,65.29276275634766,2022-03-22,104,114,59.205485076904296,12849.140895996094,1,3,0,12,8522,3
100118,Groceries,65.29276275634766,2022-03-23,116,167,58.36506828308106,16393.125841674802,2,3,0,12,8638,3
100118,Groceries,65.29276275634766,2022-03-24,111,0,60.80013656616211,6748.815158843994,3,3,0,12,8749,3
100118,Groceries,65.29276275634766,2022-03-25,58,96,54.918286437988286,8365.141226806641,4,3,0,12,8807,3
100118,Groceries,65.29276275634766,2022-03-26,33,0,57.34657287597656,1892.4369049072266,5,3,1,12,8840,3
100118,Groceries,65.29276275634766,2022-03-27,101,114,53.98779533386231,11590.764657440186,6,3,1,12,8941,3
100118,Groceries,65.29276275634766,2022-03-28,60,74,53.18007713317871,7111.2892559814445,0,3,0,13,9001,3
100118,Groceries,65.29276275634766,2022-03-29,84,126,60.81820175170898,12881.937894287108,1,3,0,13,9085,3
100118,Groceries,65.29276275634766,2022-03-30,97,0,58.19640350341797,5645.051139831543,2,3,0,13,9182,3
100118,Groceries,65.29276275634766,2022-03-31,78,113,62.810926361083986,12050.404512329102,3,3,0,13,9260,3
100118,Groceries,65.29276275634766,2022-04-01,147,202,73.1055744934082,25687.338901062012,4,4,0,13,9407,3
100118,Groceries,65.29276275634766,2022-04-02,90,0,69.9511489868164,6295.603408813477,5,4,1,13,9497,3
100118,Groceries,65.29276275634766,2022-04-03,51,55,56.823140716552736,5996.760353088379,6,4,1,13,9548,3
100118,Groceries,65.29276275634766,2022-04-04,116,124,60.77218528747559,14578.506986694336,0,4,0,14,9664,3
100118,Groceries,65.29276275634766,2022-04-05,90,97,59.23262825012207,11069.973085021971,1,4,0,14,9754,3
100118,Groceries,65.29276275634766,2022-04-06,97,161,65.9400326538086,17119.406334838866,2,4,0,14,9851,3
100118,Groceries,65.29276275634766,2022-04-07,171,172,69.31488067626952,23776.82919128418,3,4,0,14,10022,3
100118,Groceries,65.29276275634766,2022-04-08,158,198,63.771159667968746,22653.286455078123,4,4,0,14,10180,3
100118,Groceries,65.29276275634766,2022-04-09,68,0,65.0023193359375,4420.15771484375,5,4,1,14,10248,3
100118,Groceries,65.29276275634766,2022-04-10,75,100,63.53147476196289,11101.221214294434,6,4,1,14,10323,3
100118,Groceries,65.29276275634766,2022-04-11,193,219,76.43014617919923,31586.456425170898,0,4,0,15,10516,3
100118,Groceries,65.29276275634766,2022-04-12,41,0,72.69029235839844,2980.301986694336,1,4,0,15,10557,3
100118,Groceries,65.29276275634766,2022-04-13,145,133,71.41947372436523,19860.727380065917,2,4,0,15,10702,3
100118,Groceries,65.29276275634766,2022-04-14,35,0,71.92894744873047,2517.5131607055664,3,4,0,15,10737,3
100118,Groceries,65.29276275634766,2022-04-15,131,207,72.21197189331055,24412.816636047362,4,4,0,15,10868,3
100118,Groceries,65.29276275634766,2022-04-16,116,147,74.03051879882813,19494.190361328125,5,4,1,15,10984,3
100118,Groceries,65.29276275634766,2022-04-17,86,0,73.25103759765625,6299.5892333984375,6,4,1,15,11070,3
100118,Groceries,65.29276275634766,2022-04-18,152,154,72.27313385009765,22114.93269042969,0,4,0,16,11222,3
100118,Groceries,65.29276275634766,2022-04-19,154,180,65.70476943969726,21891.70898742676,1,4,0,16,11376,3
100118,Groceries,65.29276275634766,2022-04-20,106,85,59.66040908813477,11482.716726684572,2,4,0,16,11482,3
100118,Groceries,65.29276275634766,2022-04-21,106,97,60.05205039978027,12205.884684753419,3,4,0,16,11588,3
100118,Groceries,65.29276275634766,2022-04-22,99,94,57.43621994018555,11094.77154815674,4,4,0,16,11687,3
100118,Groceries,65.29276275634766,2022-04-23,23,0,59.352439880371094,1365.1061172485352,5,4,1,16,11710,3
100118,Groceries,65.29276275634766,2022-04-24,58,73,46.10194221496582,5948.875296936036,6,4,1,16,11768,3
100118,Groceries,65.29276275634766,2022-04-25,114,129,53.46746620178223,12999.532294006349,0,4,0,17,11882,3
100118,Groceries,65.29276275634766,2022-04-26,43,0,53.00493240356445,2279.2120933532715,1,4,0,17,11925,3
100118,Groceries,65.29276275634766,2022-04-27,68,69,51.14207283020019,7005.6419049072265,2,4,0,17,11993,3
100118,Groceries,65.29276275634766,2022-04-28,110,144,55.658849563598636,14172.0669039917,3,4,0,17,12103,3
100118,Groceries,65.29276275634766,2022-04-29,65,86,53.34780204772949,8043.174266204834,4,4,0,17,12168,3
100118,Groceries,65.29276275634766,2022-04-30,25,0,53.935604095458984,1348.3901023864746,5,4,1,17,12193,3
100118,Groceries,65.29276275634766,2022-05-01,41,50,50.14890739440918,4543.670406341553,6,5,1,17,12234,3
100118,Groceries,65.29276275634766,2022-05-02,53,0,52.35781478881836,2774.964183807373,0,5,0,18,12287,3
100118,Groceries,65.29276275634766,2022-05-03,96,172,59.74766891479492,16134.912431640625,1,5,0,18,12383,3
100118,Groceries,65.29276275634766,2022-05-04,53,0,58.135337829589844,3081.1729049682617,2,5,0,18,12436,3
100118,Groceries,65.29276275634766,2022-05-05,68,109,58.08705154418945,10280.709010009767,3,5,0,18,12504,3
100118,Groceries,65.29276275634766,2022-05-06,81,84,51.78331336975098,8534.996765899657,4,5,0,18,12585,3
100118,Groceries,65.29276275634766,2022-05-07,85,66,57.67709564208984,8679.736259155274,5,5,1,18,12670,3
100118,Groceries,65.29276275634766,2022-05-08,75,97,58.32316101074218,10052.19415161133,6,5,1,18,12745,3
100118,Groceries,65.29276275634766,2022-05-09,46,65,54.178807678222654,5979.670306396485,0,5,0,19,12791,3
100118,Groceries,65.29276275634766,2022-05-10,55,0,55.97761535644531,3078.768844604492,1,5,0,19,12846,3
100118,Groceries,65.29276275634766,2022-05-11,55,58,54.50055824279785,6156.221406707764,2,5,0,19,12901,3
100118,Groceries,65.29276275634766,2022-05-12,133,125,58.97668350219726,15205.717811584473,3,5,0,19,13034,3
100118,Groceries,65.29276275634766,2022-05-13,36,50,51.590488052368165,4389.315139770508,4,5,0,19,13070,3
100118,Groceries,65.29276275634766,2022-05-14,70,105,57.79087265014648,10152.572171020507,5,5,1,19,13140,3
100118,Groceries,65.29276275634766,2022-05-15,91,145,56.57593109130859,13349.979458618163,6,5,1,19,13231,3
100118,Groceries,65.29276275634766,2022-05-16,95,0,56.61186218261719,5378.126907348633,0,5,0,20,13326,3
100118,Groceries,65.29276275634766,2022-05-17,53,69,52.88771751403809,6423.058056488037,1,5,0,20,13379,3
100118,Groceries,65.29276275634766,2022-05-18,54,50,55.32515022277832,5752.356224060059,2,5,0,20,13433,3
100118,Groceries,65.29276275634766,2022-05-19,68,104,58.27743751525879,10072.771502075197,3,5,0,20,13501,3
100118,Groceries,65.29276275634766,2022-05-20,75,0,56.91487503051758,4268.615627288818,4,5,0,20,13576,3
100118,Groceries,65.29276275634766,2022-05-21,65,73,52.43457260131836,7220.894438171386,5,5,1,20,13641,3
100118,Groceries,65.29276275634766,2022-05-22,45,57,50.939714431762695,5175.574298858643,6,5,1,20,13686,3
100118,Groceries,65.29276275634766,2022-05-23,20,50,47.80803352355957,3265.921340942383,0,5,0,21,13706,3
100118,Groceries,65.29276275634766,2022-05-24,44,0,50.49606704711914,2221.826950073242,1,5,0,21,13750,3
100118,Groceries,65.29276275634766,2022-05-25,83,95,56.341980819702144,10054.888816070557,2,5,0,21,13833,3
100118,Groceries,65.29276275634766,2022-05-26,124,142,57.97483390808105,15442.098809204103,3,5,0,21,13957,3
100118,Groceries,65.29276275634766,2022-05-27,117,135,57.75695327758789,14560.567066955566,4,5,0,21,14074,3
100118,Groceries,65.29276275634766,2022-05-28,111,99,53.35360015869141,11226.139235229493,5,5,1,21,14185,3
100118,Groceries,65.29276275634766,2022-05-29,37,55,52.459176254272464,4798.179042816162,6,5,1,21,14222,3
100118,Groceries,65.29276275634766,2022-05-30,57,86,51.96731422424317,7402.113821563721,0,5,0,22,14279,3
100118,Groceries,65.29276275634766,2022-05-31,120,206,67.5255027770996,22415.320666503907,1,5,0,22,14399,3
100118,Groceries,65.29276275634766,2022-06-01,178,0,62.85100555419922,11187.478988647461,2,6,0,22,14577,3
100118,Groceries,65.29276275634766,2022-06-02,103,100,63.141314620971684,12817.390811920166,3,6,0,22,14680,3
100118,Groceries,65.29276275634766,2022-06-03,100,163,74.13593780517579,19661.807561035155,4,6,0,22,14780,3
100118,Groceries,65.29276275634766,2022-06-04,83,90,62.20317245483399,10730.11662750244,5,6,1,22,14863,3
100118,Groceries,65.29276275634766,2022-06-05,170,200,87.5288914489746,32572.623092651367,6,6,1,22,15033,3
100118,Groceries,65.29276275634766,2022-06-06,135,164,71.92884201049804,21403.807342834472,0,6,0,23,15168,3
100118,Groceries,65.29276275634766,2022-06-07,121,0,75.4776840209961,9132.799766540527,1,6,0,23,15289,3
100118,Groceries,65.29276275634766,2022-06-08,108,161,70.29235946655274,18839.61964477539,2,6,0,23,15397,3
100118,Groceries,65.29276275634766,2022-06-09,148,152,71.45750625610351,21437.06185180664,3,6,0,23,15545,3
100118,Groceries,65.29276275634766,2022-06-10,165,186,78.62292984008789,27642.576847229004,4,6,0,23,15710,3
100118,Groceries,65.29276275634766,2022-06-11,171,138,72.69575378417969,22512.677794189454,5,6,1,23,15881,3
100118,Groceries,65.29276275634766,2022-06-12,153,263,79.56209350585937,33230.70061279296,6,6,1,23,16034,3
100118,Groceries,65.29276275634766,2022-06-13,140,0,78.35418701171875,10969.586181640625,0,6,0,24,16174,3
100118,Groceries,65.29276275634766,2022-06-14,123,197,65.39349105834961,20697.738800354004,1,6,0,24,16297,3
100118,Groceries,65.29276275634766,2022-06-15,159,233,78.60933166503906,31037.647469482425,2,6,0,24,16456,3
100118,Groceries,65.29276275634766,2022-06-16,175,0,75.59866333007812,13229.766082763672,3,6,0,24,16631,3
100118,Groceries,65.29276275634766,2022-06-17,96,239,82.76195571899413,27896.575498046874,4,6,0,24,16727,3
100118,Groceries,65.29276275634766,2022-06-18,74,0,81.56391143798828,6035.729446411133,5,6,1,24,16801,3
100118,Groceries,65.29276275634766,2022-06-19,151,186,72.66446670532227,24392.218945007327,6,6,1,24,16952,3
100118,Groceries,65.29276275634766,2022-06-20,159,203,65.18946090698242,23450.32856842041,0,6,0,25,17111,3
100118,Groceries,65.29276275634766,2022-06-21,122,0,68.55892181396484,8364.188461303711,1,6,0,25,17233,3
100118,Groceries,65.29276275634766,2022-06-22,122,262,68.66076644897461,26368.427013549808,2,6,0,25,17355,3
100118,Groceries,65.29276275634766,2022-06-23,160,197,68.81194061279297,24568.38099609375,3,6,0,25,17515,3
100118,Groceries,65.29276275634766,2022-06-24,133,0,68.74388122558594,9142.93620300293,4,6,0,25,17648,3
100118,Groceries,65.29276275634766,2022-06-25,166,159,80.76652938842773,26220.25775695801,5,6,1,25,17814,3
100118,Groceries,65.29276275634766,2022-06-26,159,229,85.51397552490235,33339.44421691894,6,6,1,25,17973,3
100118,Groceries,65.29276275634766,2022-06-27,134,221,81.51470169067383,28886.85005310059,0,6,0,26,18107,3
100118,Groceries,65.29276275634766,2022-06-28,144,0,82.09940338134766,11822.314086914062,1,6,0,26,18251,3
100118,Groceries,65.29276275634766,2022-06-29,109,103,65.79770416259765,13993.619507446288,2,6,0,26,18360,3
100118,Groceries,65.29276275634766,2022-06-30,61,72,63.57974334716797,8399.348688354492,3,6,0,26,18421,3
100118,Groceries,65.29276275634766,2022-07-01,62,88,63.24501907348633,9415.122365112304,4,7,0,26,18483,3
100118,Groceries,65.29276275634766,2022-07-02,44,0,66.00003814697266,2904.001678466797,5,7,1,26,18527,3
100118,Groceries,65.29276275634766,2022-07-03,83,111,65.18862228393554,12637.1112991333,6,7,1,26,18610,3
100118,Groceries,65.29276275634766,2022-07-04,96,114,65.44642074584961,13743.092783203125,0,7,0,27,18706,3
100118,Groceries,65.29276275634766,2022-07-05,83,138,62.60606903076172,13768.507459106446,1,7,0,27,18789,3
100118,Groceries,65.29276275634766,2022-07-06,108,0,63.83213806152344,6893.870910644531,2,7,0,27,18897,3
100118,Groceries,65.29276275634766,2022-07-07,64,101,60.206689071655276,9876.506201171875,3,7,0,27,18961,3
100118,Groceries,65.29276275634766,2022-07-08,95,0,61.76337814331055,5867.520923614502,4,7,0,27,19056,3
100118,Groceries,65.29276275634766,2022-07-09,94,142,62.473426055908206,14752.204098510741,5,7,1,27,19150,3
100118,Groceries,65.29276275634766,2022-07-10,32,50,55.19638885498047,4451.10888671875,6,7,1,27,19182,3
100118,Groceries,65.29276275634766,2022-07-11,146,158,55.81315093994141,16952.88007446289,0,7,0,28,19328,3
100118,Groceries,65.29276275634766,2022-07-12,93,116,66.76521392822266,14049.489790649413,1,7,0,28,19421,3
100118,Groceries,65.29276275634766,2022-07-13,173,194,68.41013412475586,25147.25640716553,2,7,0,28,19594,3
100118,Groceries,65.29276275634766,2022-07-14,121,0,66.47026824951172,8042.902458190918,3,7,0,28,19715,3
100118,Groceries,65.29276275634766,2022-07-15,95,155,59.88475219726563,14878.50291748047,4,7,0,28,19810,3
100118,Groceries,65.29276275634766,2022-07-16,95,98,52.758899536132816,10170.980911865234,5,7,1,28,19905,3
100118,Groceries,65.29276275634766,2022-07-17,120,120,61.53574180603027,14768.578033447266,6,7,1,28,20025,3
100118,Groceries,65.29276275634766,2022-07-18,59,73,53.089122161865234,6960.596415100097,0,7,0,29,20084,3
100118,Groceries,65.29276275634766,2022-07-19,119,106,62.74434783935547,14080.874785766602,1,7,0,29,20203,3
100118,Groceries,65.29276275634766,2022-07-20,65,73,53.46145050048828,7350.708565063476,2,7,0,29,20268,3
100118,Groceries,65.29276275634766,2022-07-21,65,118,58.19539344787597,10679.681148223877,3,7,0,29,20333,3
100118,Groceries,65.29276275634766,2022-07-22,63,0,57.63078689575195,3630.739574432373,4,7,0,29,20396,3
100118,Groceries,65.29276275634766,2022-07-23,49,0,57.63078689575195,2823.9085578918457,5,7,1,29,20445,3
100118,Groceries,65.29276275634766,2022-07-24,86,92,54.62261283874511,9716.14940826416,6,7,1,29,20531,3
100118,Groceries,65.29276275634766,2022-07-25,114,176,69.92795867919922,20494.374578857423,0,7,0,30,20645,3
100118,Groceries,65.29276275634766,2022-07-26,132,236,79.27757537841796,29536.319899902344,1,7,0,30,20777,3
100118,Groceries,65.29276275634766,2022-07-27,171,0,75.79515075683594,12960.970779418945,2,7,0,30,20948,3
100118,Groceries,65.29276275634766,2022-07-28,109,183,78.58077178955078,22992.888250122072,3,7,0,30,21057,3
100118,Groceries,65.29276275634766,2022-07-29,148,166,71.1671971130371,22303.170345458988,4,7,0,30,21205,3
100118,Groceries,65.29276275634766,2022-07-30,103,142,69.44949447631836,16948.455862121584,5,7,1,30,21308,3
100118,Groceries,65.29276275634766,2022-07-31,122,0,71.15898895263672,8681.39665222168,6,7,1,30,21430,3
100118,Groceries,65.29276275634766,2022-08-01,83,92,59.180381774902344,10314.443374633789,0,8,0,31,21513,3
100118,Groceries,65.29276275634766,2022-08-02,127,358,84.8655744934082,41890.78592132569,1,8,0,31,21640,3
100118,Groceries,65.29276275634766,2022-08-03,133,0,81.7011489868164,10866.252815246582,2,8,0,31,21773,3
100118,Groceries,65.29276275634766,2022-08-04,142,149,76.7570166015625,22321.40271484375,3,8,0,31,21915,3
100118,Groceries,65.29276275634766,2022-08-05,168,133,69.82859771728516,21166.05883300781,4,8,0,31,22083,3
100118,Groceries,65.29276275634766,2022-08-06,109,89,66.98828186035156,13337.84544555664,5,8,1,31,22192,3
100118,Groceries,65.29276275634766,2022-08-07,93,0,70.69656372070312,6574.780426025391,6,8,1,31,22285,3
100118,Groceries,65.29276275634766,2022-08-08,23,50,52.39504196166992,3599.2519302368164,0,8,0,32,22308,3
100118,Groceries,65.29276275634766,2022-08-09,111,124,66.00517028808594,15532.337803955077,1,8,0,32,22419,3
100118,Groceries,65.29276275634766,2022-08-10,75,85,56.90349769592285,9073.024654388428,2,8,0,32,22494,3
100118,Groceries,65.29276275634766,2022-08-11,134,176,66.7771238708496,20778.729197387693,3,8,0,32,22628,3
100118,Groceries,65.29276275634766,2022-08-12,176,194,69.87506576538087,25881.583149414062,4,8,0,32,22804,3
100118,Groceries,65.29276275634766,2022-08-13,178,196,65.70805923461914,24559.189087524413,5,8,1,32,22982,3
100118,Groceries,65.29276275634766,2022-08-14,125,127,60.193624038696285,15162.986009674072,6,8,1,32,23107,3
100118,Groceries,65.29276275634766,2022-08-15,99,0,63.09724807739258,6246.627559661865,0,8,0,33,23206,3
100118,Groceries,65.29276275634766,2022-08-16,115,200,70.18687988281249,22243.432373046875,1,8,0,33,23321,3
100118,Groceries,65.29276275634766,2022-08-17,112,0,68.603759765625,7683.62109375,2,8,0,33,23433,3
100118,Groceries,65.29276275634766,2022-08-18,87,99,50.84441513061523,9391.48823272705,3,8,0,33,23520,3
100118,Groceries,65.29276275634766,2022-08-19,97,103,58.52557373046875,11709.461303710938,4,8,0,33,23617,3
100118,Groceries,65.29276275634766,2022-08-20,94,102,52.72553359985352,10320.32031677246,5,8,1,33,23711,3
100118,Groceries,65.29276275634766,2022-08-21,114,234,70.03870956420899,24739.62578063965,6,8,1,33,23825,3
100118,Groceries,65.29276275634766,2022-08-22,123,0,66.98741912841797,8239.45255279541,0,8,0,34,23948,3
100118,Groceries,65.29276275634766,2022-08-23,96,157,67.02911331176759,16959.029755859374,1,8,0,34,24044,3
100118,Groceries,65.29276275634766,2022-08-24,107,135,65.63735275268554,15869.193489074707,2,8,0,34,24151,3
100118,Groceries,65.29276275634766,2022-08-25,189,168,72.15030044555664,25710.83356842041,3,8,0,34,24340,3
100118,Groceries,65.29276275634766,2022-08-26,98,69,64.21932983398438,10817.988647460938,4,8,0,34,24438,3
100118,Groceries,65.29276275634766,2022-08-27,150,216,84.53398773193359,31230.23631958008,5,8,1,34,24588,3
100118,Groceries,65.29276275634766,2022-08-28,112,157,69.31627853393555,18447.79639160156,6,8,1,34,24700,3
100118,Groceries,65.29276275634766,2022-08-29,88,0,73.7225570678711,6487.585021972656,0,8,0,35,24788,3
100118,Groceries,65.29276275634766,2022-08-30,103,107,70.58332427978516,14816.884801635744,1,8,0,35,24891,3
100118,Groceries,65.29276275634766,2022-08-31,94,120,68.31041717529297,14577.858428955078,2,8,0,35,24985,3
100118,Groceries,65.29276275634766,2022-09-01,139,151,59.72030860900879,17269.925793304443,3,9,0,35,25124,3
100118,Groceries,65.29276275634766,2022-09-02,139,141,72.72803680419922,20371.574231567385,4,9,0,35,25263,3
100118,Groceries,65.29276275634766,2022-09-03,217,198,73.49232238769531,30468.197916259764,5,9,1,35,25480,3
100118,Groceries,65.29276275634766,2022-09-04,165,196,61.82566116333008,22214.728183898926,6,9,1,35,25645,3
100118,Groceries,65.29276275634766,2022-09-05,63,0,65.19132232666016,4107.05330657959,0,9,0,36,25708,3
100118,Groceries,65.29276275634766,2022-09-06,166,178,70.35720825195312,24222.593139648438,1,9,0,36,25874,3
100118,Groceries,65.29276275634766,2022-09-07,139,146,71.21352966308594,20302.48124633789,2,9,0,36,26013,3
100118,Groceries,65.29276275634766,2022-09-08,62,0,70.26705932617188,4356.557678222656,3,9,0,36,26075,3
100118,Groceries,65.29276275634766,2022-09-09,83,108,60.67889175415039,11502.696031188965,4,9,0,36,26158,3
100118,Groceries,65.29276275634766,2022-09-10,89,146,66.1648844909668,15587.229439392091,5,9,1,36,26247,3
100118,Groceries,65.29276275634766,2022-09-11,129,149,60.62333709716797,16813.620971069337,6,9,1,36,26376,3
100118,Groceries,65.29276275634766,2022-09-12,89,0,62.60667419433594,5571.994003295898,0,9,0,37,26465,3
100118,Groceries,65.29276275634766,2022-09-13,136,198,65.1737547302246,21808.721286621094,1,9,0,37,26601,3
100118,Groceries,65.29276275634766,2022-09-14,83,0,64.51750946044922,5354.953285217285,2,9,0,37,26684,3
100118,Groceries,65.29276275634766,2022-09-15,69,83,59.68692825317383,9044.736098937989,3,9,0,37,26753,3
100118,Groceries,65.29276275634766,2022-09-16,129,145,64.05410148620606,17562.598183441165,4,9,0,37,26882,3
100118,Groceries,65.29276275634766,2022-09-17,118,122,58.54807067871094,14044.424680175782,5,9,1,37,27000,3
100118,Groceries,65.29276275634766,2022-09-18,98,79,58.64562515258789,10395.772529907226,6,9,1,37,27098,3
100118,Groceries,65.29276275634766,2022-09-19,130,274,87.98151550292968,36331.99403076172,0,9,0,38,27228,3
100118,Groceries,65.29276275634766,2022-09-20,79,0,82.51303100585938,6518.529449462891,1,9,0,38,27307,3
100118,Groceries,65.29276275634766,2022-09-21,77,0,82.51303100585938,6353.503387451172,2,9,0,38,27384,3
100118,Groceries,65.29276275634766,2022-09-22,77,97,67.48404159545899,11628.542405700682,3,9,0,38,27461,3
100118,Groceries,65.29276275634766,2022-09-23,101,104,67.72209777832032,13876.513751220704,4,9,0,38,27562,3
100118,Groceries,65.29276275634766,2022-09-24,130,191,75.49108505249023,24324.68211364746,5,9,1,38,27692,3
100118,Groceries,65.29276275634766,2022-09-25,63,0,73.98217010498047,4660.8767166137695,6,9,1,38,27755,3
100118,Groceries,65.29276275634766,2022-09-26,139,146,65.75372009277343,18721.234185791014,0,9,0,39,27894,3
100118,Groceries,65.29276275634766,2022-09-27,115,133,69.42825653076173,17224.719002075195,1,9,0,39,28009,3
100118,Groceries,65.29276275634766,2022-09-28,133,135,65.46931045532227,17543.05658111572,2,9,0,39,28142,3
100118,Groceries,65.29276275634766,2022-09-29,110,111,62.095146331787106,13721.002192993164,3,9,0,39,28252,3
100118,Groceries,65.29276275634766,2022-09-30,141,145,69.34188842773438,19839.412536621094,4,9,0,39,28393,3
100118,Groceries,65.29276275634766,2022-10-01,79,104,61.5876823425293,11204.603810119628,5,10,1,39,28472,3
100118,Groceries,65.29276275634766,2022-10-02,177,175,64.64084960937501,22753.28076171875,6,10,1,39,28649,3
100118,Groceries,65.29276275634766,2022-10-03,121,120,70.12975997924805,16898.751914978027,0,10,0,40,28770,3
100118,Groceries,65.29276275634766,2022-10-04,70,0,67.6095199584961,4732.666397094727,1,10,0,40,28840,3
100118,Groceries,65.29276275634766,2022-10-05,108,160,64.32261474609375,17191.00478515625,2,10,0,40,28948,3
100118,Groceries,65.29276275634766,2022-10-06,140,127,63.62631546020508,16996.75832885742,3,10,0,40,29088,3
100118,Groceries,65.29276275634766,2022-10-07,122,128,70.54352890014648,17650.441051635742,4,10,0,40,29210,3
100118,Groceries,65.29276275634766,2022-10-08,80,92,65.43166275024414,11238.866040039062,5,10,1,40,29290,3
100118,Groceries,65.29276275634766,2022-10-09,138,135,65.12523757934571,17781.095571899416,6,10,1,40,29428,3
100118,Groceries,65.29276275634766,2022-10-10,149,215,77.27297729492187,28348.92723388672,0,10,0,41,29577,3
100118,Groceries,65.29276275634766,2022-10-11,156,181,70.60132766723632,23759.364232177733,1,10,0,41,29733,3
100118,Groceries,65.29276275634766,2022-10-12,91,0,71.93265533447266,6545.871635437012,2,10,0,41,29824,3
100118,Groceries,65.29276275634766,2022-10-13,83,121,69.08355850219726,14047.310711364746,3,10,0,41,29907,3
100118,Groceries,65.29276275634766,2022-10-14,71,0,70.28711700439453,4990.385307312012,4,10,0,41,29978,3
100118,Groceries,65.29276275634766,2022-10-15,70,66,55.700439376831056,7605.701512756348,5,10,1,41,30048,3
100118,Groceries,65.29276275634766,2022-10-16,113,126,61.188125457763675,14614.10635345459,6,10,1,41,30161,3
100118,Groceries,65.29276275634766,2022-10-17,79,139,56.16299026489258,12120.352461853028,0,10,0,42,30240,3
100118,Groceries,65.29276275634766,2022-10-18,80,0,58.215980529785156,4657.2784423828125,1,10,0,42,30320,3
100118,Groceries,65.29276275634766,2022-10-19,92,115,51.566361846923826,10618.200579833985,2,10,0,42,30412,3
100118,Groceries,65.29276275634766,2022-10-20,94,108,50.485123519897456,10177.343221740723,3,10,0,42,30506,3
100118,Groceries,65.29276275634766,2022-10-21,169,156,52.52929710388183,17069.412421112058,4,10,0,42,30675,3
100118,Groceries,65.29276275634766,2022-10-22,117,106,57.87860977172852,12880.954686584473,5,10,1,42,30792,3
100118,Groceries,65.29276275634766,2022-10-23,139,110,64.01155014038086,15840.610939025879,6,10,1,42,30931,3
100118,Groceries,65.29276275634766,2022-10-24,117,215,74.64154083251952,25074.84055480957,0,10,0,43,31048,3
100118,Groceries,65.29276275634766,2022-10-25,68,0,71.64308166503906,4871.729553222656,1,10,0,43,31116,3
100118,Groceries,65.29276275634766,2022-10-26,147,166,72.82674667358398,22801.673522033692,2,10,0,43,31263,3
100118,Groceries,65.29276275634766,2022-10-27,141,151,70.00280899047851,20432.09213531494,3,10,0,43,31404,3
100118,Groceries,65.29276275634766,2022-10-28,176,244,76.58631973266601,32269.184545898435,4,10,0,43,31580,3
100118,Groceries,65.29276275634766,2022-10-29,153,0,75.07263946533203,11486.1138381958,5,10,1,43,31733,3
100118,Groceries,65.29276275634766,2022-10-30,78,91,63.48316055297852,10678.433046264649,6,10,1,43,31811,3
100118,Groceries,65.29276275634766,2022-10-31,104,103,60.97685424804688,12624.34568359375,0,10,0,44,31915,3
100118,Groceries,65.29276275634766,2022-11-01,103,147,70.72522506713867,17768.196363830568,1,11,0,44,32018,3
100118,Groceries,65.29276275634766,2022-11-02,142,165,67.9092399597168,20842.17414855957,2,11,0,44,32160,3
100118,Groceries,65.29276275634766,2022-11-03,63,82,62.51004165649414,9009.235248718262,3,11,0,44,32223,3
100118,Groceries,65.29276275634766,2022-11-04,81,0,65.39008331298828,5296.596748352051,4,11,0,44,32304,3
100118,Groceries,65.29276275634766,2022-11-05,108,113,59.344770736694336,13105.420479125976,5,11,1,44,32412,3
100118,Groceries,65.29276275634766,2022-11-06,113,124,56.47132537841797,13367.079535522462,6,11,1,44,32525,3
100118,Groceries,65.29276275634766,2022-11-07,60,71,57.42838188171387,7520.275825805664,0,11,0,45,32585,3
100118,Groceries,65.29276275634766,2022-11-08,64,80,57.33224006652832,8253.246728515625,1,11,0,45,32649,3
100118,Groceries,65.29276275634766,2022-11-09,141,145,60.98487457275391,17446.4546295166,2,11,0,45,32790,3
100118,Groceries,65.29276275634766,2022-11-10,87,110,61.502190093994145,12132.21107635498,3,11,0,45,32877,3
100118,Groceries,65.29276275634766,2022-11-11,101,114,61.799382324218755,13292.595229492188,4,11,0,45,32978,3
100118,Groceries,65.29276275634766,2022-11-12,166,169,70.28654754638671,23555.663785400393,5,11,1,45,33144,3
100118,Groceries,65.29276275634766,2022-11-13,148,162,61.815365600585935,19135.24821777344,6,11,1,45,33292,3
100118,Groceries,65.29276275634766,2022-11-14,109,128,56.83403526306152,13410.499687347412,0,11,0,46,33401,3
100118,Groceries,65.29276275634766,2022-11-15,61,0,59.94807052612305,3656.832302093506,1,11,0,46,33462,3
100118,Groceries,65.29276275634766,2022-11-16,166,188,69.33503005981444,24607.849979858398,2,11,0,46,33628,3
100118,Groceries,65.29276275634766,2022-11-17,188,270,70.28280807495116,32270.47583618164,3,11,0,46,33816,3
100118,Groceries,65.29276275634766,2022-11-18,132,0,69.29561614990234,9147.02133178711,4,11,0,46,33948,3
100118,Groceries,65.29276275634766,2022-11-19,136,120,54.11289802551269,13941.588262939453,5,11,1,46,34084,3
100118,Groceries,65.29276275634766,2022-11-20,113,81,57.95193801879883,11266.097992248535,6,11,1,46,34197,3
100118,Groceries,65.29276275634766,2022-11-21,90,157,66.70345794677735,16595.452430419922,0,11,0,47,34287,3
100118,Groceries,65.29276275634766,2022-11-22,88,98,59.84554092407227,11108.715202636718,1,11,0,47,34375,3
100118,Groceries,65.29276275634766,2022-11-23,141,121,59.85649368286133,15700.731218566894,2,11,0,47,34516,3
100118,Groceries,65.29276275634766,2022-11-24,147,135,60.93343841552735,17182.55089416504,3,11,0,47,34663,3
100118,Groceries,65.29276275634766,2022-11-25,48,88,57.685377502441405,7789.796240234375,4,11,0,47,34711,3
100118,Groceries,65.29276275634766,2022-11-26,33,0,59.07075500488281,1949.3349151611328,5,11,1,47,34744,3
100118,Groceries,65.29276275634766,2022-11-27,142,205,63.190269470214844,21993.786529541016,6,11,1,47,34886,3
100118,Groceries,65.29276275634766,2022-11-28,107,118,63.42722953796387,14277.757121124268,0,11,0,48,34993,3
100118,Groceries,65.29276275634766,2022-11-29,64,0,62.824459075927734,4020.765380859375,1,11,0,48,35057,3
100118,Groceries,65.29276275634766,2022-11-30,91,104,61.949448623657226,12075.339649505615,2,11,0,48,35148,3
100118,Groceries,65.29276275634766,2022-12-01,110,107,60.22959152221679,13072.550134887695,3,12,0,48,35258,3
100118,Groceries,65.29276275634766,2022-12-02,83,83,58.50234184265137,9711.388745880127,4,12,0,48,35341,3
100118,Groceries,65.29276275634766,2022-12-03,81,89,50.72581405639649,8588.781877136229,5,12,1,48,35422,3
100118,Groceries,65.29276275634766,2022-12-04,151,199,62.11574005126953,21841.9934954834,6,12,1,48,35573,3
100118,Groceries,65.29276275634766,2022-12-05,66,0,60.00148010253906,3960.097686767578,0,12,0,49,35639,3
100118,Groceries,65.29276275634766,2022-12-06,59,63,57.427406082153325,7000.513917694092,1,12,0,49,35698,3
100118,Groceries,65.29276275634766,2022-12-07,110,89,60.07210273742676,11942.212602233885,2,12,0,49,35808,3
100118,Groceries,65.29276275634766,2022-12-08,120,149,61.93043586730957,16681.314608154295,3,12,0,49,35928,3
100118,Groceries,65.29276275634766,2022-12-09,93,151,57.51619552612304,13959.352367858886,4,12,0,49,36021,3
100118,Groceries,65.29276275634766,2022-12-10,127,130,59.14308395385742,15200.243324279785,5,12,1,49,36148,3
100118,Groceries,65.29276275634766,2022-12-11,106,0,58.986167907714844,6252.533798217773,6,12,1,49,36254,3
100118,Groceries,65.29276275634766,2022-12-12,72,88,58.19083076477051,9305.399630126953,0,12,0,50,36326,3
100118,Groceries,65.29276275634766,2022-12-13,135,151,60.74122985839844,17383.01206176758,1,12,0,50,36461,3
100118,Groceries,65.29276275634766,2022-12-14,122,122,63.93557067871094,15600.279245605469,2,12,0,50,36583,3
100118,Groceries,65.29276275634766,2022-12-15,126,130,63.371765594482426,16224.52492980957,3,12,0,50,36709,3
100118,Groceries,65.29276275634766,2022-12-16,49,77,57.7835075378418,7206.983738708496,4,12,0,50,36758,3
100118,Groceries,65.29276275634766,2022-12-17,160,113,60.68851974487305,16562.256318359374,5,12,1,50,36918,3
100118,Groceries,65.29276275634766,2022-12-18,126,93,59.57781036376953,13061.328211669923,6,12,1,50,37044,3
100118,Groceries,65.29276275634766,2022-12-19,103,144,62.278600158691404,15407.47163269043,0,12,0,51,37147,3
100118,Groceries,65.29276275634766,2022-12-20,122,117,62.21509071350098,14868.382134094238,1,12,0,51,37269,3
100118,Groceries,65.29276275634766,2022-12-21,83,89,59.98709373474121,10312.457559967042,2,12,0,51,37352,3
100118,Groceries,65.29276275634766,2022-12-22,31,50,54.84706939697266,4374.838302612305,3,12,0,51,37383,3
100118,Groceries,65.29276275634766,2022-12-23,164,202,63.346009979248045,23238.75127319336,4,12,0,51,37547,3
100118,Groceries,65.29276275634766,2022-12-24,96,0,61.922019958496094,5944.513916015625,5,12,1,51,37643,3
100118,Groceries,65.29276275634766,2022-12-25,76,94,54.548485107421875,9225.389736328125,6,12,1,51,37719,3
100118,Groceries,65.29276275634766,2022-12-26,124,168,63.628877334594726,18655.80157897949,0,12,0,52,37843,3
100118,Groceries,65.29276275634766,2022-12-27,141,119,59.897636566162106,15591.593511657715,1,12,0,52,37984,3
100118,Groceries,65.29276275634766,2022-12-28,61,78,62.18453056335449,8655.642728729248,2,12,0,52,38045,3
100118,Groceries,65.29276275634766,2022-12-29,129,170,70.49751754760743,21198.579527282716,3,12,0,52,38174,3
100118,Groceries,65.29276275634766,2022-12-30,96,170,66.85137084960937,17762.383203125,4,12,0,52,38270,3
100118,Groceries,65.29276275634766,2022-12-31,111,0,67.12274169921875,7450.624328613281,5,12,1,52,38381,3
100118,Groceries,65.29276275634766,2023-01-01,167,185,60.19457199096679,21149.70704498291,6,1,1,52,38548,3
100118,Groceries,65.29276275634766,2023-01-02,116,147,66.10096588134766,17429.474084472655,0,1,0,1,38664,3
100118,Groceries,65.29276275634766,2023-01-03,128,123,57.270879898071286,14392.24525390625,1,1,0,1,38792,3
100118,Groceries,65.29276275634766,2023-01-04,148,148,69.99197845458984,20717.625622558593,2,1,0,1,38940,3
100118,Groceries,65.29276275634766,2023-01-05,87,101,60.988692932128906,11429.07257019043,3,1,0,1,39027,3
100118,Groceries,65.29276275634766,2023-01-06,38,0,63.61738586425781,2417.460662841797,4,1,0,1,39065,3
100118,Groceries,65.29276275634766,2023-01-07,84,117,67.00519836425781,13517.703325195314,5,1,1,1,39149,3
100118,Groceries,65.29276275634766,2023-01-08,145,119,68.31027801513672,17998.82062438965,6,1,1,1,39294,3
100118,Groceries,65.29276275634766,2023-01-09,194,226,65.58353134155274,27531.85016052246,0,1,0,2,39488,3
100118,Groceries,65.29276275634766,2023-01-10,94,0,65.99706268310547,6203.723892211914,1,1,0,2,39582,3
100118,Groceries,65.29276275634766,2023-01-11,132,109,59.91413360595703,14492.071271972656,2,1,0,2,39714,3
100118,Groceries,65.29276275634766,2023-01-12,85,92,58.04776382446289,10263.619850158691,3,1,0,2,39799,3
100118,Groceries,65.29276275634766,2023-01-13,116,92,55.24298408508301,11530.932307739258,4,1,0,2,39915,3
100118,Groceries,65.29276275634766,2023-01-14,92,99,47.54578414916992,9060.414283447266,5,1,1,2,40007,3
100118,Groceries,65.29276275634766,2023-01-15,90,84,51.80435813903809,9011.104465026856,6,1,1,2,40097,3
100118,Groceries,65.29276275634766,2023-01-16,77,90,57.572869873046876,9642.321960449219,0,1,0,3,40174,3
100118,Groceries,65.29276275634766,2023-01-17,82,146,63.75656448364258,14678.156575317382,1,1,0,3,40256,3
100118,Groceries,65.29276275634766,2023-01-18,170,267,64.1584563446045,28098.505157165528,2,1,0,3,40426,3
100118,Groceries,65.29276275634766,2023-01-19,165,0,63.526912689208984,10481.940593719482,3,1,0,3,40591,3
100118,Groceries,65.29276275634766,2023-01-20,99,108,58.055107498168944,12001.61128463745,4,1,0,3,40690,3
100118,Groceries,65.29276275634766,2023-01-21,111,174,74.86846435546875,21566.929086914064,5,1,1,3,40801,3
100118,Groceries,65.29276275634766,2023-01-22,84,82,60.58063583374023,10067.34682006836,6,1,1,3,40885,3
100118,Groceries,65.29276275634766,2023-01-23,104,112,64.53355270385742,13933.938962402342,0,1,0,4,40989,3
100118,Groceries,65.29276275634766,2023-01-24,179,172,65.5416470336914,23004.28963806152,1,1,0,4,41168,3
100118,Groceries,65.29276275634766,2023-01-25,138,129,64.85721725463867,17318.92196228027,2,1,0,4,41306,3
100118,Groceries,65.29276275634766,2023-01-26,81,102,60.073247833251955,10946.506148986817,3,1,0,4,41387,3
100118,Groceries,65.29276275634766,2023-01-27,75,98,63.58109817504883,11013.764726257325,4,1,0,4,41462,3
100118,Groceries,65.29276275634766,2023-01-28,138,146,57.755844039916994,16385.33295501709,5,1,1,4,41600,3
100118,Groceries,65.29276275634766,2023-01-29,70,0,59.921688079833984,4194.518165588379,6,1,1,4,41670,3
100118,Groceries,65.29276275634766,2023-01-30,75,119,66.22386032104492,12952.859048156739,0,1,0,5,41745,3
100118,Groceries,65.29276275634766,2023-01-31,95,0,63.827720642089844,6063.633460998535,1,1,0,5,41840,3
100118,Groceries,65.29276275634766,2023-02-01,95,109,61.19044906616211,12471.645322570801,2,2,0,5,41935,3
100118,Groceries,65.29276275634766,2023-02-02,55,56,54.49638786315918,6045.402664947509,3,2,0,5,41990,3
100118,Groceries,65.29276275634766,2023-02-03,76,125,58.84171440124511,11836.900588989258,4,2,0,5,42066,3
100118,Groceries,65.29276275634766,2023-02-04,68,107,53.88737838745117,9351.22346069336,5,2,1,5,42134,3
100118,Groceries,65.29276275634766,2023-02-05,40,0,55.914756774902344,2236.5902709960938,6,2,1,5,42174,3
100118,Groceries,65.29276275634766,2023-02-06,41,0,55.914756774902344,2292.505027770996,0,2,0,6,42215,3
100118,Groceries,65.29276275634766,2023-02-07,43,51,54.05406692504883,5073.129755554199,1,2,0,6,42258,3
100118,Groceries,65.29276275634766,2023-02-08,36,50,50.47861930847168,4305.620590209961,2,2,0,6,42294,3
100118,Groceries,65.29276275634766,2023-02-09,28,0,53.01723861694336,1484.482681274414,3,2,0,6,42322,3
100118,Groceries,65.29276275634766,2023-02-10,97,104,46.401892471313474,9310.667139434816,4,2,0,6,42419,3
100118,Groceries,65.29276275634766,2023-02-11,25,50,48.99329299926758,3678.414649963379,5,2,1,6,42444,3
100118,Groceries,65.29276275634766,2023-02-12,52,61,44.77287200927734,5039.598688964844,6,2,1,6,42496,3
100118,Groceries,65.29276275634766,2023-02-13,49,0,46.96574401855469,2301.3214569091797,0,2,0,7,42545,3
100118,Groceries,65.29276275634766,2023-02-14,15,50,43.97663925170899,2805.3991775512695,1,2,0,7,42560,3
100118,Groceries,65.29276275634766,2023-02-15,89,64,52.746861343383785,7976.191319122314,2,2,0,7,42649,3
100118,Groceries,65.29276275634766,2023-02-16,17,50,47.164910888671876,3128.2069702148438,3,2,0,7,42666,3
100118,Groceries,65.29276275634766,2023-02-17,146,151,57.29359306335449,17031.12917449951,4,2,0,7,42812,3
100118,Groceries,65.29276275634766,2023-02-18,91,79,48.86127243041992,8338.351582336425,5,2,1,7,42903,3
100118,Groceries,65.29276275634766,2023-02-19,99,91,54.05387802124024,10261.467848205566,6,2,1,7,43002,3
100118,Groceries,65.29276275634766,2023-02-20,43,56,49.89247619628907,4917.87295288086,0,2,0,8,43045,3
100118,Groceries,65.29276275634766,2023-02-21,96,148,67.35560478210449,16703.836118164065,1,2,0,8,43141,3
100118,Groceries,65.29276275634766,2023-02-22,62,0,62.181209564208984,3855.234992980957,2,2,0,8,43203,3
100118,Groceries,65.29276275634766,2023-02-23,53,61,57.473954086303706,6532.319133148193,3,2,0,8,43256,3
100118,Groceries,65.29276275634766,2023-02-24,83,113,55.025535049438474,10728.138818206788,4,2,0,8,43339,3
100118,Groceries,65.29276275634766,2023-02-25,69,0,56.92107009887695,3927.5538368225098,5,2,1,8,43408,3
100118,Groceries,65.29276275634766,2023-02-26,53,67,56.397530517578126,6764.518234863282,6,2,1,8,43461,3
100118,Groceries,65.29276275634766,2023-02-27,76,102,58.61477653503418,10452.286033325196,0,2,0,9,43537,3
100118,Groceries,65.29276275634766,2023-02-28,33,0,57.88955307006836,1910.3552513122559,1,2,0,9,43570,3
100118,Groceries,65.29276275634766,2023-03-01,91,100,55.40988220214844,10575.368560791016,2,3,0,9,43661,3
100118,Groceries,65.29276275634766,2023-03-02,119,195,66.6077439880371,21098.163069152833,3,3,0,9,43780,3
100118,Groceries,65.29276275634766,2023-03-03,193,154,70.5114598083496,24371.983486022946,4,3,0,9,43973,3
100118,Groceries,65.29276275634766,2023-03-04,84,134,69.34009674072266,15139.636252441407,5,3,1,9,44057,3
100118,Groceries,65.29276275634766,2023-03-05,44,0,68.87019348144531,3030.2885131835938,6,3,1,9,44101,3
100118,Groceries,65.29276275634766,2023-03-06,127,153,67.97861953735352,19025.989362487795,0,3,0,10,44228,3
100118,Groceries,65.29276275634766,2023-03-07,109,158,68.6315640258789,18330.920957641603,1,3,0,10,44337,3
100118,Groceries,65.29276275634766,2023-03-08,99,0,68.50312805175781,6781.809677124023,2,3,0,10,44436,3
100118,Groceries,65.29276275634766,2023-03-09,86,72,55.69688400268555,8887.844048461913,3,3,0,10,44522,3
100118,Groceries,65.29276275634766,2023-03-10,113,166,72.37018356323242,20341.261485290528,4,3,0,10,44635,3
100118,Groceries,65.29276275634766,2023-03-11,66,0,69.54036712646484,4589.66423034668,5,3,1,10,44701,3
100118,Groceries,65.29276275634766,2023-03-12,58,89,64.34532623291015,9396.90784301758,6,3,1,10,44759,3
100118,Groceries,65.29276275634766,2023-03-13,97,133,67.34903869628906,15502.913507080078,0,3,0,11,44856,3
100118,Groceries,65.29276275634766,2023-03-14,100,124,61.73791076660156,13776.542153320312,1,3,0,11,44956,3
100118,Groceries,65.29276275634766,2023-03-15,106,104,60.93731353759766,12799.790469970703,2,3,0,11,45062,3
100118,Groceries,65.29276275634766,2023-03-16,120,121,55.05854438781738,13265.780653076172,3,3,0,11,45182,3
100118,Groceries,65.29276275634766,2023-03-17,75,0,58.387088775634766,4379.031658172607,4,3,0,11,45257,3
100118,Groceries,65.29276275634766,2023-03-18,112,134,55.44944847106933,13619.896457519531,5,3,1,11,45369,3
100118,Groceries,65.29276275634766,2023-03-19,99,102,53.566632690429685,10763.333272705078,6,3,1,11,45468,3
100118,Groceries,65.29276275634766,2023-03-20,151,153,65.02579399108888,19774.62978530884,0,3,0,12,45619,3
100118,Groceries,65.29276275634766,2023-03-21,99,103,65.24150909423828,13184.93880065918,1,3,0,12,45718,3
100118,Groceries,65.29276275634766,2023-03-22,120,109,59.154367446899414,13567.29818725586,2,3,0,12,45838,3
100118,Groceries,65.29276275634766,2023-03-23,74,112,56.4059602355957,10421.742114868164,3,3,0,12,45912,3
100118,Groceries,65.29276275634766,2023-03-24,165,169,57.45676025390625,19189.45088378906,4,3,0,12,46077,3
100118,Groceries,65.29276275634766,2023-03-25,88,106,63.812758407592774,12431.105479736329,5,3,1,12,46165,3
100118,Groceries,65.29276275634766,2023-03-26,68,0,60.95551681518555,4144.975143432617,6,3,1,12,46233,3
100118,Groceries,65.29276275634766,2023-03-27,80,85,60.24731239318848,9939.219982910156,0,3,0,13,46313,3
100118,Groceries,65.29276275634766,2023-03-28,120,154,67.49315139770508,18567.81633544922,1,3,0,13,46433,3
100118,Groceries,65.29276275634766,2023-03-29,92,0,65.29630279541016,6007.259857177734,2,3,0,13,46525,3
100118,Groceries,65.29276275634766,2023-03-30,85,90,66.43481674194337,11627.918846130371,3,3,0,13,46610,3
100118,Groceries,65.29276275634766,2023-03-31,72,68,59.232680206298824,8303.465949707032,4,3,0,13,46682,3
100118,Groceries,65.29276275634766,2023-04-01,48,71,54.86458847045898,6467.370493164062,5,4,1,13,46730,3
100118,Groceries,65.29276275634766,2023-04-02,109,149,65.65616325378417,17026.24358932495,6,4,1,13,46839,3
100118,Groceries,65.29276275634766,2023-04-03,102,74,62.56846778869629,11024.887428894042,0,4,0,14,46941,3
100118,Groceries,65.29276275634766,2023-04-04,67,104,64.50601997375489,11050.656676483155,1,4,0,14,47008,3
100118,Groceries,65.29276275634766,2023-04-05,39,0,63.962039947509766,2494.519557952881,2,4,0,14,47047,3
100118,Groceries,65.29276275634766,2023-04-06,115,106,60.731451187133786,13432.103773040772,3,4,0,14,47162,3
100118,Groceries,65.29276275634766,2023-04-07,82,104,60.74654083251953,11290.132696533205,4,4,0,14,47244,3
100118,Groceries,65.29276275634766,2023-04-08,44,65,56.918443222045894,6159.413003540039,5,4,1,14,47288,3
100118,Groceries,65.29276275634766,2023-04-09,59,101,59.83872779846192,9588.529880218506,6,4,1,14,47347,3
100118,Groceries,65.29276275634766,2023-04-10,101,119,63.91194839477539,14096.41357574463,0,4,0,15,47448,3
100118,Groceries,65.29276275634766,2023-04-11,112,151,56.58013778686524,14794.380864257811,1,4,0,15,47560,3
100118,Groceries,65.29276275634766,2023-04-12,59,0,58.79027557373047,3468.6262588500977,2,4,0,15,47619,3
100118,Groceries,65.29276275634766,2023-04-13,51,0,58.79027557373047,2998.304054260254,3,4,0,15,47670,3
100118,Groceries,65.29276275634766,2023-04-14,69,77,53.97840019226074,7862.379226531983,4,4,0,15,47739,3
100118,Groceries,65.29276275634766,2023-04-15,105,125,55.59094528198242,12780.698509216309,5,4,1,15,47844,3
100118,Groceries,65.29276275634766,2023-04-16,131,113,60.15339469909668,14644.18941116333,6,4,1,15,47975,3
100118,Groceries,65.29276275634766,2023-04-17,77,65,54.20882987976074,7724.159801483154,0,4,0,16,48052,3
100118,Groceries,65.29276275634766,2023-04-18,10,0,56.417659759521484,564.1765975952148,1,4,0,16,48062,3
100118,Groceries,65.29276275634766,2023-04-19,37,56,47.79955764770508,4357.397265930176,2,4,0,16,48099,3
100118,Groceries,65.29276275634766,2023-04-20,74,63,56.866010437011724,7764.199544677735,3,4,0,16,48173,3
100118,Groceries,65.29276275634766,2023-04-21,79,93,59.65021484375,10290.7739453125,4,4,0,16,48252,3
100118,Groceries,65.29276275634766,2023-04-22,57,0,57.4404296875,3274.1044921875,5,4,1,16,48309,3
100118,Groceries,65.29276275634766,2023-04-23,95,107,56.34636390686035,11377.929142303467,6,4,1,16,48404,3
100118,Groceries,65.29276275634766,2023-04-24,70,74,51.63715911865235,7427.282276611328,0,4,0,17,48474,3
100118,Groceries,65.29276275634766,2023-04-25,94,144,53.140704498291015,12638.952445678711,1,4,0,17,48568,3
100118,Groceries,65.29276275634766,2023-04-26,62,87,57.21428863525391,8571.821790771484,2,4,0,17,48630,3
100118,Groceries,65.29276275634766,2023-04-27,128,172,58.6558324432373,17647.97310546875,3,4,0,17,48758,3
100118,Groceries,65.29276275634766,2023-04-28,66,0,57.49166488647461,3794.449882507324,4,4,0,17,48824,3
100118,Groceries,65.29276275634766,2023-04-29,58,0,57.49166488647461,3334.5165634155273,5,4,1,17,48882,3
100118,Groceries,65.29276275634766,2023-04-30,84,120,57.92671897888184,11821.84878845215,6,4,1,17,48966,3
100118,Groceries,65.29276275634766,2023-05-01,37,50,53.335698471069335,4606.201686859131,0,5,0,18,49003,3
100118,Groceries,65.29276275634766,2023-05-02,44,75,52.86068870544433,6241.730606079102,1,5,0,18,49047,3
100118,Groceries,65.29276275634766,2023-05-03,30,0,54.43137741088867,1632.9413223266602,2,5,0,18,49077,3
100118,Groceries,65.29276275634766,2023-05-04,96,92,58.20059379577637,10934.794008789064,3,5,0,18,49173,3
100118,Groceries,65.29276275634766,2023-05-05,73,57,51.58315994262695,6750.501351623535,4,5,0,18,49246,3
100118,Groceries,65.29276275634766,2023-05-06,80,78,56.95770843505859,8996.913349609375,5,5,1,18,49326,3
100118,Groceries,65.29276275634766,2023-05-07,134,177,62.820105438232424,19620.46825744629,6,5,1,18,49460,3
100118,Groceries,65.29276275634766,2023-05-08,57,91,58.86404281616211,8678.08088104248,0,5,0,19,49517,3
100118,Groceries,65.29276275634766,2023-05-09,38,0,59.85808563232422,2274.6072540283203,1,5,0,19,49555,3
100118,Groceries,65.29276275634766,2023-05-10,97,109,59.60290634155274,12276.84383026123,2,5,0,19,49652,3
100118,Groceries,65.29276275634766,2023-05-11,85,0,59.71581268310547,5075.844078063965,3,5,0,19,49737,3
100118,Groceries,65.29276275634766,2023-05-12,100,163,59.5977212524414,15672.454250488281,4,5,0,19,49837,3
100118,Groceries,65.29276275634766,2023-05-13,90,106,61.935776443481444,12155.47975982666,5,5,1,19,49927,3
100118,Groceries,65.29276275634766,2023-05-14,76,103,65.39485488891602,11761.707943115234,6,5,1,19,50003,3
100118,Groceries,65.29276275634766,2023-05-15,128,133,62.10858444213867,16207.6976171875,0,5,0,20,50131,3
100118,Groceries,65.29276275634766,2023-05-16,148,126,67.07676773071289,18334.523248291014,1,5,0,20,50279,3
100118,Groceries,65.29276275634766,2023-05-17,70,0,65.05353546142578,4553.747482299805,2,5,0,20,50349,3
100118,Groceries,65.29276275634766,2023-05-18,119,179,65.61894500732421,19562.908911743165,3,5,0,20,50468,3
100118,Groceries,65.29276275634766,2023-05-19,106,120,58.60580726623535,13203.811140441896,4,5,0,20,50574,3
100118,Groceries,65.29276275634766,2023-05-20,116,112,64.035673828125,14595.516328124999,5,5,1,20,50690,3
100118,Groceries,65.29276275634766,2023-05-21,80,137,63.80355056762696,13866.828090820314,6,5,1,20,50770,3
100118,Groceries,65.29276275634766,2023-05-22,18,0,63.427101135253906,1141.6878204345703,0,5,0,21,50788,3
100118,Groceries,65.29276275634766,2023-05-23,91,169,71.87639678955078,18953.344215698242,1,5,0,21,50879,3
100118,Groceries,65.29276275634766,2023-05-24,95,0,68.47279357910156,6504.915390014648,2,5,0,21,50974,3
100118,Groceries,65.29276275634766,2023-05-25,121,192,69.85119049072266,21898.12809875488,3,5,0,21,51095,3
100118,Groceries,65.29276275634766,2023-05-26,282,289,82.29071105957031,47017.671037597655,4,5,0,21,51377,3
100118,Groceries,65.29276275634766,2023-05-27,82,0,78.05142211914062,6400.216613769531,5,5,1,21,51459,3
100118,Groceries,65.29276275634766,2023-05-28,73,0,78.05142211914062,5697.753814697266,6,5,1,21,51532,3
100118,Groceries,65.29276275634766,2023-05-29,70,74,62.31675521850586,8943.70573059082,0,5,0,22,51602,3
100118,Groceries,65.29276275634766,2023-05-30,57,61,55.27563873291015,6491.702815551758,1,5,0,22,51659,3
100118,Groceries,65.29276275634766,2023-05-31,59,79,54.43516189575195,7431.14910369873,2,5,0,22,51718,3
100118,Groceries,65.29276275634766,2023-06-01,162,194,74.48569259643554,26667.76440124512,3,6,0,22,51880,3
100118,Groceries,65.29276275634766,2023-06-02,89,153,57.709868087768555,13666.276519622803,4,6,0,22,51969,3
100118,Groceries,65.29276275634766,2023-06-03,78,0,62.38973617553711,4866.3994216918945,5,6,1,22,52047,3
100118,Groceries,65.29276275634766,2023-06-04,180,357,81.63509643554687,44523.90471679688,6,6,1,22,52227,3
100118,Groceries,65.29276275634766,2023-06-05,203,0,77.76019287109375,15785.319152832031,0,6,0,23,52430,3
100118,Groceries,65.29276275634766,2023-06-06,154,243,72.39177780151367,28624.56756286621,1,6,0,23,52584,3
100118,Groceries,65.29276275634766,2023-06-07,167,263,70.89968658447265,30402.415319213866,2,6,0,23,52751,3
100118,Groceries,65.29276275634766,2023-06-08,49,0,71.77937316894531,3517.1892852783203,3,6,0,23,52800,3
100118,Groceries,65.29276275634766,2023-06-09,99,0,71.77937316894531,7106.157943725586,4,6,0,23,52899,3
100118,Groceries,65.29276275634766,2023-06-10,90,142,67.87141265869141,15664.454278564453,5,6,1,23,52989,3
100118,Groceries,65.29276275634766,2023-06-11,157,183,60.220031280517574,20379.12982208252,6,6,1,23,53146,3
100118,Groceries,65.29276275634766,2023-06-12,155,0,63.900062561035156,9904.50969696045,0,6,0,24,53301,3
100118,Groceries,65.29276275634766,2023-06-13,114,205,77.8541796875,25111.74296875,1,6,0,24,53415,3
100118,Groceries,65.29276275634766,2023-06-14,162,140,72.96385940551758,22052.330447387696,2,6,0,24,53577,3
100118,Groceries,65.29276275634766,2023-06-15,86,133,70.11897689819335,15286.544026489259,3,6,0,24,53663,3
100118,Groceries,65.29276275634766,2023-06-16,163,135,69.94182189941407,20863.993939208987,4,6,0,24,53826,3
100118,Groceries,65.29276275634766,2023-06-17,115,128,69.23690216064453,16816.157496948243,5,6,1,24,53941,3
100118,Groceries,65.29276275634766,2023-06-18,215,192,75.86364639282226,30827.137948913576,6,6,1,24,54156,3
100118,Groceries,65.29276275634766,2023-06-19,137,136,60.90262298583984,16631.718698120116,0,6,0,25,54293,3
100118,Groceries,65.29276275634766,2023-06-20,110,101,64.72796524047851,13664.062352905274,1,6,0,25,54403,3
100118,Groceries,65.29276275634766,2023-06-21,134,135,62.18359619140625,16726.073779296872,2,6,0,25,54537,3
100118,Groceries,65.29276275634766,2023-06-22,74,95,64.33765411376953,10881.72280883789,3,6,0,25,54611,3
100118,Groceries,65.29276275634766,2023-06-23,182,126,62.118367462158204,19177.725756225587,4,6,0,25,54793,3
100118,Groceries,65.29276275634766,2023-06-24,122,200,62.023846282958985,19952.658493041992,5,6,1,25,54915,3
100118,Groceries,65.29276275634766,2023-06-25,127,121,66.62555908203126,16510.51200683594,6,6,1,25,55042,3
100118,Groceries,65.29276275634766,2023-06-26,52,0,64.5211181640625,3355.09814453125,0,6,0,26,55094,3
100118,Groceries,65.29276275634766,2023-06-27,78,97,57.259863204956055,9956.448659973144,1,6,0,26,55172,3
100118,Groceries,65.29276275634766,2023-06-28,187,253,76.58469039916992,33981.41420928955,2,6,0,26,55359,3
100118,Groceries,65.29276275634766,2023-06-29,146,221,76.37798934936524,28142.62289001465,3,6,0,26,55505,3
100118,Groceries,65.29276275634766,2023-06-30,161,0,74.88597869873047,12056.642570495605,4,6,0,26,55666,3
100118,Groceries,65.29276275634766,2023-07-01,142,151,69.72699386596679,20413.47625793457,5,7,1,26,55808,3
100118,Groceries,65.29276275634766,2023-07-02,176,306,74.20101882934571,35841.45862792969,6,7,1,26,55984,3
100118,Groceries,65.29276275634766,2023-07-03,115,0,73.6120376586914,8465.384330749512,0,7,0,27,56099,3
100118,Groceries,65.29276275634766,2023-07-04,120,215,78.13031936645507,26305.676647949218,1,7,0,27,56219,3
100118,Groceries,65.29276275634766,2023-07-05,179,221,75.69915344238282,30262.476932373047,2,7,0,27,56398,3
100118,Groceries,65.29276275634766,2023-07-06,78,0,76.10830688476562,5936.447937011719,3,7,0,27,56476,3
100118,Groceries,65.29276275634766,2023-07-07,69,0,76.10830688476562,5251.473175048828,4,7,0,27,56545,3
100118,Groceries,65.29276275634766,2023-07-08,181,207,70.08293151855469,27144.521209716797,5,7,1,27,56726,3
100118,Groceries,65.29276275634766,2023-07-09,74,131,67.47155654907226,13719.860369262697,6,7,1,27,56800,3
100118,Groceries,65.29276275634766,2023-07-10,64,0,69.43311309814453,4443.71923828125,0,7,0,28,56864,3
100118,Groceries,65.29276275634766,2023-07-11,190,178,69.13664306640625,25443.564365234375,1,7,0,28,57054,3
100118,Groceries,65.29276275634766,2023-07-12,136,110,67.52277969360352,16631.216076660156,2,7,0,28,57190,3
100118,Groceries,65.29276275634766,2023-07-13,162,209,66.27887008666991,24562.723908081054,3,7,0,28,57352,3
100118,Groceries,65.29276275634766,2023-07-14,178,175,70.34313507080078,24827.206085205078,4,7,0,28,57530,3
100118,Groceries,65.29276275634766,2023-07-15,201,235,83.32556900024414,36477.99873809815,5,7,1,28,57731,3
100118,Groceries,65.29276275634766,2023-07-16,85,0,78.97113800048828,6712.546730041504,6,7,1,28,57816,3
100118,Groceries,65.29276275634766,2023-07-17,87,114,64.56867324829102,12820.929145202637,0,7,0,29,57903,3
100118,Groceries,65.29276275634766,2023-07-18,39,0,70.39734649658203,2745.496513366699,1,7,0,29,57942,3
100118,Groceries,65.29276275634766,2023-07-19,137,166,68.20116378784181,20645.77887786865,2,7,0,29,58079,3
100118,Groceries,65.29276275634766,2023-07-20,97,81,60.715417633056646,10874.471020812987,3,7,0,29,58176,3
100118,Groceries,65.29276275634766,2023-07-21,132,146,64.25008178710937,17858.301591796873,4,7,0,29,58308,3
100118,Groceries,65.29276275634766,2023-07-22,170,200,74.30098175048829,27579.233795166016,5,7,1,29,58478,3
100118,Groceries,65.29276275634766,2023-07-23,169,213,76.49367279052734,29292.58140319824,6,7,1,29,58647,3
100118,Groceries,65.29276275634766,2023-07-24,213,195,70.82996810913086,28926.526414489745,0,7,0,30,58860,3
100118,Groceries,65.29276275634766,2023-07-25,138,199,68.41574691772462,22968.526149291993,1,7,0,30,58998,3
100118,Groceries,65.29276275634766,2023-07-26,132,0,69.85149383544922,9220.397186279297,2,7,0,30,59130,3
100118,Groceries,65.29276275634766,2023-07-27,44,0,69.85149383544922,3073.4657287597656,3,7,0,30,59174,3
100118,Groceries,65.29276275634766,2023-07-28,111,153,68.91838165283204,18184.020726928713,4,7,0,30,59285,3
100118,Groceries,65.29276275634766,2023-07-29,153,184,77.61039154052735,26231.56981140137,5,7,1,30,59438,3
100118,Groceries,65.29276275634766,2023-07-30,138,113,70.42973724365234,17730.607479248047,6,7,1,30,59576,3
100118,Groceries,65.29276275634766,2023-07-31,84,133,66.6888313293457,14364.223663330078,0,7,0,31,59660,3
100118,Groceries,65.29276275634766,2023-08-01,110,133,62.13764556884766,15031.422025146483,1,8,0,31,59770,3
100118,Groceries,65.29276275634766,2023-08-02,138,166,57.72432289123535,17463.513117980958,2,8,0,31,59908,3
100118,Groceries,65.29276275634766,2023-08-03,158,0,60.7486457824707,9598.286033630371,3,8,0,31,60066,3
100118,Groceries,65.29276275634766,2023-08-04,101,311,81.63260116577149,34245.28543548584,4,8,0,31,60167,3
100118,Groceries,65.29276275634766,2023-08-05,163,0,78.71520233154297,12830.577980041504,5,8,1,31,60330,3
100118,Groceries,65.29276275634766,2023-08-06,130,243,75.8085302734375,28199.90787109375,6,8,1,31,60460,3
100118,Groceries,65.29276275634766,2023-08-07,96,0,76.487060546875,7342.7578125,0,8,0,32,60556,3
100118,Groceries,65.29276275634766,2023-08-08,119,158,67.39790405273438,18547.62116455078,1,8,0,32,60675,3
100118,Groceries,65.29276275634766,2023-08-09,101,0,70.51580810546875,7122.096618652344,2,8,0,32,60776,3
100118,Groceries,65.29276275634766,2023-08-10,103,120,68.73481521606445,15318.771934509277,3,8,0,32,60879,3
100118,Groceries,65.29276275634766,2023-08-11,120,200,66.64555694580079,21278.133666992188,4,8,0,32,60999,3
100118,Groceries,65.29276275634766,2023-08-12,142,107,64.47912628173827,16102.171864013671,5,8,1,32,61141,3
100118,Groceries,65.29276275634766,2023-08-13,51,0,65.81825256347656,3356.7308807373047,6,8,1,32,61192,3
100118,Groceries,65.29276275634766,2023-08-14,114,289,68.06918212890625,27496.773525390625,0,8,0,33,61306,3
100118,Groceries,65.29276275634766,2023-08-15,177,0,67.6983642578125,11982.610473632812,1,8,0,33,61483,3
100118,Groceries,65.29276275634766,2023-08-16,112,191,76.16128067016601,23228.446870117186,2,8,0,33,61595,3
100118,Groceries,65.29276275634766,2023-08-17,107,112,64.36572280883789,14073.364681091309,3,8,0,33,61702,3
100118,Groceries,65.29276275634766,2023-08-18,115,171,74.28305541992188,21354.542746582032,4,8,0,33,61817,3
100118,Groceries,65.29276275634766,2023-08-19,47,0,72.32611083984375,3399.3272094726562,5,8,1,33,61864,3
100118,Groceries,65.29276275634766,2023-08-20,93,0,72.32611083984375,6726.328308105469,6,8,1,33,61957,3
100118,Groceries,65.29276275634766,2023-08-21,73,65,52.85255424499512,7365.7529197692875,0,8,0,34,62030,3
100118,Groceries,65.29276275634766,2023-08-22,104,215,68.79111511230468,22094.091943359374,1,8,0,34,62134,3
100118,Groceries,65.29276275634766,2023-08-23,113,0,67.44223022460938,7620.972015380859,2,8,0,34,62247,3
100118,Groceries,65.29276275634766,2023-08-24,102,186,76.1797688293457,22097.712841186523,3,8,0,34,62349,3
100118,Groceries,65.29276275634766,2023-08-25,179,150,75.8981770324707,24952.75737762451,4,8,0,34,62528,3
100118,Groceries,65.29276275634766,2023-08-26,157,229,70.73252502441406,27219.052857666014,5,8,1,34,62685,3
100118,Groceries,65.29276275634766,2023-08-27,156,164,70.6300732421875,22597.4628515625,6,8,1,34,62841,3
100118,Groceries,65.29276275634766,2023-08-28,126,139,73.95789337158203,19615.639129638672,0,8,0,35,62967,3
100118,Groceries,65.29276275634766,2023-08-29,134,158,72.41206588745118,21141.633657836916,1,8,0,35,63101,3
100118,Groceries,65.29276275634766,2023-08-30,226,228,80.23557037353515,36432.73780883789,2,8,0,35,63327,3
100118,Groceries,65.29276275634766,2023-08-31,146,0,77.34114074707031,11291.806549072266,3,8,0,35,63473,3
100118,Groceries,65.29276275634766,2023-09-01,81,108,63.98732696533203,11958.13696838379,4,9,0,35,63554,3
100118,Groceries,65.29276275634766,2023-09-02,104,104,66.97362213134765,13930.513403320312,5,9,1,35,63658,3
100118,Groceries,65.29276275634766,2023-09-03,128,158,71.56574096679688,20504.8296875,6,9,1,35,63786,3
100118,Groceries,65.29276275634766,2023-09-04,136,138,61.43370239257813,16825.64705078125,0,9,0,36,63922,3
100118,Groceries,65.29276275634766,2023-09-05,130,139,67.9408822631836,18286.709388427735,1,9,0,36,64052,3
100118,Groceries,65.29276275634766,2023-09-06,194,163,71.70292297363281,25540.064113769527,2,9,0,36,64246,3
100118,Groceries,65.29276275634766,2023-09-07,8,0,69.83584594726562,558.686767578125,3,9,0,36,64254,3
100118,Groceries,65.29276275634766,2023-09-08,93,100,54.34212326049804,10439.994926452637,4,9,0,36,64347,3
100118,Groceries,65.29276275634766,2023-09-09,61,95,58.56885902404785,9094.960800933837,5,9,1,36,64408,3
100118,Groceries,65.29276275634766,2023-09-10,54,0,59.7977180480957,3229.076774597168,6,9,1,36,64462,3
100118,Groceries,65.29276275634766,2023-09-11,124,108,62.9775341796875,14590.268476562502,0,9,0,37,64586,3
100118,Groceries,65.29276275634766,2023-09-12,67,64,52.92102813720703,6945.917770385742,1,9,0,37,64653,3
100118,Groceries,65.29276275634766,2023-09-13,115,95,59.41108238220215,12459.748947906493,2,9,0,37,64768,3
100118,Groceries,65.29276275634766,2023-09-14,107,129,52.61057441711426,12377.58292526245,3,9,0,37,64875,3
100118,Groceries,65.29276275634766,2023-09-15,72,76,52.70862922668457,7797.842608642579,4,9,0,37,64947,3
100118,Groceries,65.29276275634766,2023-09-16,133,108,52.144201583862305,12579.357621307372,5,9,1,37,65080,3
100118,Groceries,65.29276275634766,2023-09-17,108,182,58.622943038940434,17101.815696411133,6,9,1,37,65188,3
100118,Groceries,65.29276275634766,2023-09-18,62,0,57.25588607788086,3549.8649368286133,0,9,0,38,65250,3
100118,Groceries,65.29276275634766,2023-09-19,99,84,60.67526130676269,11082.201738739015,1,9,0,38,65349,3
100118,Groceries,65.29276275634766,2023-09-20,101,125,65.22338020324707,14782.882801055908,2,9,0,38,65450,3
100118,Groceries,65.29276275634766,2023-09-21,37,54,51.69303848266601,4595.214847717285,3,9,0,38,65487,3
100118,Groceries,65.29276275634766,2023-09-22,107,128,53.264683609008785,12480.35229232788,4,9,0,38,65594,3
100118,Groceries,65.29276275634766,2023-09-23,130,149,56.97695335388184,15909.927872009277,5,9,1,38,65724,3
100118,Groceries,65.29276275634766,2023-09-24,144,117,59.86822937011719,15582.63005859375,6,9,1,38,65868,3
100118,Groceries,65.29276275634766,2023-09-25,75,74,60.88763153076172,9070.904729614258,0,9,0,39,65943,3
100118,Groceries,65.29276275634766,2023-09-26,103,118,66.41223045349122,14718.46947341919,1,9,0,39,66046,3
100118,Groceries,65.29276275634766,2023-09-27,111,100,60.085368957519535,12696.221908569336,2,9,0,39,66157,3
100118,Groceries,65.29276275634766,2023-09-28,162,199,75.4144044494629,27370.957041625978,3,9,0,39,66319,3
100118,Groceries,65.29276275634766,2023-09-29,163,172,72.08903518676757,24151.90547088623,4,9,0,39,66482,3
100118,Groceries,65.29276275634766,2023-09-30,33,0,71.85807037353516,2371.31632232666,5,9,1,39,66515,3
100118,Groceries,65.29276275634766,2023-10-01,102,139,69.52232986450196,16721.4952923584,6,10,1,39,66617,3
100118,Groceries,65.29276275634766,2023-10-02,166,159,62.35704559326172,20288.62913696289,0,10,0,40,66783,3
100118,Groceries,65.29276275634766,2023-10-03,153,134,73.29713470458984,20972.763219604494,1,10,0,40,66936,3
100118,Groceries,65.29276275634766,2023-10-04,145,124,65.38028045654298,17628.461332397463,2,10,0,40,67081,3
100118,Groceries,65.29276275634766,2023-10-05,78,78,56.65340049743652,8837.930477600097,3,10,0,40,67159,3
100118,Groceries,65.29276275634766,2023-10-06,162,206,70.18996154785157,25931.107541503905,4,10,0,40,67321,3
100118,Groceries,65.29276275634766,2023-10-07,50,0,67.88992309570312,3394.4961547851562,5,10,1,40,67371,3
100118,Groceries,65.29276275634766,2023-10-08,72,59,53.89384811401367,7164.5341284179685,6,10,1,40,67443,3
100118,Groceries,65.29276275634766,2023-10-09,96,99,59.37388565063476,11574.656044921874,0,10,0,41,67539,3
100118,Groceries,65.29276275634766,2023-10-10,23,0,60.45777130126953,1390.5287399291992,1,10,0,41,67562,3
100118,Groceries,65.29276275634766,2023-10-11,91,64,58.21336631774902,9053.132669830322,2,10,0,41,67653,3
100118,Groceries,65.29276275634766,2023-10-12,83,81,53.85535110473633,8836.42828338623,3,10,0,41,67736,3
100118,Groceries,65.29276275634766,2023-10-13,97,167,61.48088668823242,16318.39201751709,4,10,0,41,67833,3
100118,Groceries,65.29276275634766,2023-10-14,126,98,59.58674766540527,13355.740411682129,5,10,1,41,67959,3
100118,Groceries,65.29276275634766,2023-10-15,55,75,54.51302703857422,7035.032974243164,6,10,1,41,68014,3
100118,Groceries,65.29276275634766,2023-10-16,62,112,57.48749465942383,10010.949337768554,0,10,0,42,68076,3
100118,Groceries,65.29276275634766,2023-10-17,134,149,63.31906845092774,17956.360344848632,1,10,0,42,68210,3
100118,Groceries,65.29276275634766,2023-10-18,112,0,60.84813690185547,6814.9913330078125,2,10,0,42,68322,3
100118,Groceries,65.29276275634766,2023-10-19,90,119,62.70560874938965,13122.709574890137,3,10,0,42,68412,3
100118,Groceries,65.29276275634766,2023-10-20,126,139,63.12039611816407,16731.319821777346,4,10,0,42,68538,3
100118,Groceries,65.29276275634766,2023-10-21,28,0,62.780792236328125,1757.8621826171875,5,10,1,42,68566,3
100118,Groceries,65.29276275634766,2023-10-22,67,66,57.33135314941406,7627.731322021485,6,10,1,42,68633,3
100118,Groceries,65.29276275634766,2023-10-23,46,50,51.389537506103515,4914.277450561523,0,10,0,43,68679,3
100118,Groceries,65.29276275634766,2023-10-24,94,109,58.81598892211914,11954.4059173584,1,10,0,43,68773,3
100118,Groceries,65.29276275634766,2023-10-25,106,132,58.000516204833986,13805.669435424805,2,10,0,43,68879,3
100118,Groceries,65.29276275634766,2023-10-26,90,73,57.394188690185544,9360.253964233398,3,10,0,43,68969,3
100118,Groceries,65.29276275634766,2023-10-27,57,64,56.8541976928711,6876.178536987305,4,10,0,43,69026,3
100118,Groceries,65.29276275634766,2023-10-28,107,145,57.13990692138672,14396.980081176758,5,10,1,43,69133,3
100118,Groceries,65.29276275634766,2023-10-29,65,0,57.19981384277344,3717.9878997802734,6,10,1,43,69198,3
100118,Groceries,65.29276275634766,2023-10-30,133,109,64.9524062347412,15647.980058441162,0,10,0,44,69331,3
100118,Groceries,65.29276275634766,2023-10-31,109,111,56.82803207397461,12498.750992126465,1,10,0,44,69440,3
100118,Groceries,65.29276275634766,2023-11-01,81,75,61.14180946350098,9531.473133087158,2,11,0,44,69521,3
100118,Groceries,65.29276275634766,2023-11-02,105,148,62.6855940246582,15889.314745178222,3,11,0,44,69626,3
100118,Groceries,65.29276275634766,2023-11-03,128,127,58.36500991821289,14884.412539062501,4,11,0,44,69754,3
100118,Groceries,65.29276275634766,2023-11-04,31,0,59.70001983642578,1850.7006149291992,5,11,1,44,69785,3
100118,Groceries,65.29276275634766,2023-11-05,63,84,50.54810646057129,7352.071414031982,6,11,1,44,69848,3
100118,Groceries,65.29276275634766,2023-11-06,57,84,57.66314682006836,8171.458737487793,0,11,0,45,69905,3
100118,Groceries,65.29276275634766,2023-11-07,152,146,59.20127716064453,17635.388256835937,1,11,0,45,70057,3
100118,Groceries,65.29276275634766,2023-11-08,158,241,68.29399230957031,27458.131569824218,2,11,0,45,70215,3
100118,Groceries,65.29276275634766,2023-11-09,134,199,74.68188049316407,25087.343972167968,3,11,0,45,70349,3
100118,Groceries,65.29276275634766,2023-11-10,88,0,71.32376098632812,6276.490966796875,4,11,0,45,70437,3
100118,Groceries,65.29276275634766,2023-11-11,94,0,71.32376098632812,6704.433532714844,5,11,1,45,70531,3
100118,Groceries,65.29276275634766,2023-11-12,115,173,62.37970901489258,17828.493073425292,6,11,1,45,70646,3
100118,Groceries,65.29276275634766,2023-11-13,76,0,64.73941802978516,4920.195770263672,0,11,0,46,70722,3
100118,Groceries,65.29276275634766,2023-11-14,86,94,61.42499565124511,11046.93925201416,1,11,0,46,70808,3
100118,Groceries,65.29276275634766,2023-11-15,114,174,68.10624740600585,19695.824408569337,2,11,0,46,70922,3
100118,Groceries,65.29276275634766,2023-11-16,86,83,63.443450927734375,10727.023559570312,3,11,0,46,71008,3
100118,Groceries,65.29276275634766,2023-11-17,55,0,65.13690185546875,3582.5296020507812,4,11,0,46,71063,3
100118,Groceries,65.29276275634766,2023-11-18,86,104,64.02727264404297,12158.030894775391,5,11,1,46,71149,3
100118,Groceries,65.29276275634766,2023-11-19,116,96,61.742454833984375,13111.449521484376,6,11,1,46,71265,3
100118,Groceries,65.29276275634766,2023-11-20,79,121,66.69659408569336,13391.121865539551,0,11,0,47,71344,3
100118,Groceries,65.29276275634766,2023-11-21,102,112,65.69488479614259,14059.656498413086,1,11,0,47,71446,3
100118,Groceries,65.29276275634766,2023-11-22,166,208,70.36954711914063,26375.349643554688,2,11,0,47,71612,3
100118,Groceries,65.29276275634766,2023-11-23,88,0,69.00909423828125,6072.80029296875,3,11,0,47,71700,3
100118,Groceries,65.29276275634766,2023-11-24,117,114,65.7231005859375,15185.435537109375,4,11,0,47,71817,3
100118,Groceries,65.29276275634766,2023-11-25,117,183,62.24661010742187,18600.28676513672,5,11,1,47,71934,3
100118,Groceries,65.29276275634766,2023-11-26,68,108,57.883331832885744,10086.93312927246,6,11,1,47,72002,3
100118,Groceries,65.29276275634766,2023-11-27,29,0,60.396663665771484,1751.503246307373,0,11,0,48,72031,3
100118,Groceries,65.29276275634766,2023-11-28,98,137,58.97098678588867,13835.133410034181,1,11,0,48,72129,3
100118,Groceries,65.29276275634766,2023-11-29,102,0,59.561973571777344,6075.321304321289,2,11,0,48,72231,3
100118,Groceries,65.29276275634766,2023-11-30,102,92,59.122687072753905,11471.628162841796,3,11,0,48,72333,3
100118,Groceries,65.29276275634766,2023-12-01,121,146,76.29299713134765,20494.65530578613,4,12,0,48,72454,3
100118,Groceries,65.29276275634766,2023-12-02,123,109,58.97140289306641,13750.685111694336,5,12,1,48,72577,3
100118,Groceries,65.29276275634766,2023-12-03,132,152,67.60515914916992,19222.16201538086,6,12,1,48,72709,3
100118,Groceries,65.29276275634766,2023-12-04,127,104,63.90259674072266,14786.629572143554,0,12,0,49,72836,3
100118,Groceries,65.29276275634766,2023-12-05,129,129,60.941297454833986,15722.854743347169,1,12,0,49,72965,3
100118,Groceries,65.29276275634766,2023-12-06,60,111,61.442447128295896,10490.723655395508,2,12,0,49,73025,3
100118,Groceries,65.29276275634766,2023-12-07,165,154,64.91455368041991,20694.922714538574,3,12,0,49,73190,3
100118,Groceries,65.29276275634766,2023-12-08,66,76,58.20752861022949,8236.293776550294,4,12,0,49,73256,3
100118,Groceries,65.29276275634766,2023-12-09,173,148,71.39852310180663,22822.138993225097,5,12,1,49,73429,3
100118,Groceries,65.29276275634766,2023-12-10,154,150,71.35987670898437,21688.202026367188,6,12,1,49,73583,3
100118,Groceries,65.29276275634766,2023-12-11,50,0,70.05975341796875,3502.9876708984375,0,12,0,50,73633,3
100118,Groceries,65.29276275634766,2023-12-12,100,159,66.88057189941406,17277.194379882814,1,12,0,50,73733,3
100118,Groceries,65.29276275634766,2023-12-13,118,128,61.465925979614255,15096.958531188964,2,12,0,50,73851,3
100118,Groceries,65.29276275634766,2023-12-14,157,132,65.03170013427734,18782.453842163086,3,12,0,50,74008,3
100118,Groceries,65.29276275634766,2023-12-15,112,141,56.22022743225098,14141.930944824218,4,12,0,50,74120,3
100118,Groceries,65.29276275634766,2023-12-16,35,0,59.04045486450195,2066.4159202575684,5,12,1,50,74155,3
100118,Groceries,65.29276275634766,2023-12-17,69,108,55.442565460205074,9758.6340335083,6,12,1,50,74224,3
100118,Groceries,65.29276275634766,2023-12-18,62,0,56.845130920410156,3524.3981170654297,0,12,0,51,74286,3
100118,Groceries,65.29276275634766,2023-12-19,115,118,59.793885116577144,13934.873576812744,1,12,0,51,74401,3
100118,Groceries,65.29276275634766,2023-12-20,57,87,57.148578033447265,8209.037895812988,2,12,0,51,74458,3
100118,Groceries,65.29276275634766,2023-12-21,109,106,59.56539215087891,12804.415488891602,3,12,0,51,74567,3
100118,Groceries,65.29276275634766,2023-12-22,115,171,63.8819994354248,18354.139870147705,4,12,0,51,74682,3
100118,Groceries,65.29276275634766,2023-12-23,182,183,61.465578384399414,22434.61053192139,5,12,1,51,74864,3
100118,Groceries,65.29276275634766,2023-12-24,130,107,65.64073455810546,15513.860985107422,6,12,1,51,74994,3
100118,Groceries,65.29276275634766,2023-12-25,31,0,63.77146911621094,1976.915542602539,0,12,0,52,75025,3
100118,Groceries,65.29276275634766,2023-12-26,114,127,62.44014129638672,15041.702215576173,1,12,0,52,75139,3
100118,Groceries,65.29276275634766,2023-12-27,72,0,62.93028259277344,4530.9803466796875,2,12,0,52,75211,3
100118,Groceries,65.29276275634766,2023-12-28,89,114,59.7756770324707,12112.320511779784,3,12,0,52,75300,3
100118,Groceries,65.29276275634766,2023-12-29,84,85,57.15677070617676,9658.087478637695,4,12,0,52,75384,3
100118,Groceries,65.29276275634766,2023-12-30,60,51,56.28011337280273,6257.983604736328,5,12,1,52,75444,3
100118,Groceries,65.29276275634766,2023-12-31,58,60,55.638505706787114,6563.606661987305,6,12,1,52,75502,3
100118,Groceries,65.29276275634766,2024-01-01,84,101,53.223820724487304,9826.961881713867,0,1,0,1,75586,3
100118,Groceries,65.29276275634766,2024-01-02,101,88,58.75712493896484,11081.3992376709,1,1,0,1,75687,3
100118,Groceries,65.29276275634766,2024-01-03,83,78,54.71672584533691,8814.026490325927,2,1,0,1,75770,3
100118,Groceries,65.29276275634766,2024-01-04,43,50,46.319583892822266,4273.984214782715,3,1,0,1,75813,3
100118,Groceries,65.29276275634766,2024-01-05,75,125,54.49804344177246,10952.20651626587,4,1,0,1,75888,3
100118,Groceries,65.29276275634766,2024-01-06,58,67,52.700385589599605,6583.854728393555,5,1,1,1,75946,3
100118,Groceries,65.29276275634766,2024-01-07,57,0,53.11077117919922,3027.3139572143555,6,1,1,1,76003,3
100118,Groceries,65.29276275634766,2024-01-08,69,66,57.273103103637695,7726.028228302002,0,1,0,2,76072,3
100118,Groceries,65.29276275634766,2024-01-09,67,124,57.88808319091797,11102.333147583007,1,1,0,2,76139,3
100118,Groceries,65.29276275634766,2024-01-10,56,0,57.08616638183594,3196.8253173828125,2,1,0,2,76195,3
100118,Groceries,65.29276275634766,2024-01-11,107,143,53.820667572021485,13421.662860412598,3,1,0,2,76302,3
100118,Groceries,65.29276275634766,2024-01-12,89,103,54.72225234985352,10506.500918273927,4,1,0,2,76391,3
100118,Groceries,65.29276275634766,2024-01-13,56,87,57.276572113037105,8228.786076660155,5,1,1,2,76447,3
100118,Groceries,65.29276275634766,2024-01-14,42,0,56.04314422607422,2353.812057495117,6,1,1,2,76489,3
100118,Groceries,65.29276275634766,2024-01-15,66,95,58.86933654785156,9514.522424316407,0,1,0,3,76555,3
100118,Groceries,65.29276275634766,2024-01-16,78,106,58.259406356811525,10728.147391662598,1,1,0,3,76633,3
100118,Groceries,65.29276275634766,2024-01-17,176,149,64.49006912231445,20886.374331054685,2,1,0,3,76809,3
100118,Groceries,65.29276275634766,2024-01-18,124,178,71.83842849731445,21879.430267333984,3,1,0,3,76933,3
100118,Groceries,65.29276275634766,2024-01-19,131,0,68.4268569946289,8963.918266296387,4,1,0,3,77064,3
100118,Groceries,65.29276275634766,2024-01-20,106,157,70.36967056274415,18532.23015930176,5,1,1,3,77170,3
100118,Groceries,65.29276275634766,2024-01-21,92,118,65.86406600952148,13789.748145751953,6,1,1,3,77262,3
100118,Groceries,65.29276275634766,2024-01-22,141,131,55.62168502807617,15177.81517791748,0,1,0,4,77403,3
100118,Groceries,65.29276275634766,2024-01-23,129,133,64.30709770202637,16854.471207122802,1,1,0,4,77532,3
100118,Groceries,65.29276275634766,2024-01-24,166,132,68.0389712524414,20204.178455810546,2,1,0,4,77698,3
100118,Groceries,65.29276275634766,2024-01-25,143,208,79.73939682006835,28218.01749053955,3,1,0,4,77841,3
100118,Groceries,65.29276275634766,2024-01-26,72,94,60.02865661621094,9777.786552734375,4,1,0,4,77913,3
100118,Groceries,65.29276275634766,2024-01-27,135,153,61.11896011352539,17545.039230651855,5,1,1,4,78048,3
100118,Groceries,65.29276275634766,2024-01-28,237,198,76.13977966308593,32942.95556030273,6,1,1,4,78285,3
100118,Groceries,65.29276275634766,2024-01-29,79,0,71.57955932617188,5654.785186767578,0,1,0,5,78364,3
100118,Groceries,65.29276275634766,2024-01-30,76,63,58.806381378173825,8258.409969482422,1,1,0,5,78440,3
100119,Furniture,112.46819305419922,2022-01-01,61,281,95.55999877929688,32681.51985107422,5,1,1,52,61,2
100119,Furniture,112.46819305419922,2022-01-02,35,0,95.55999755859375,3344.5999145507812,6,1,1,52,96,2
100119,Furniture,112.46819305419922,2022-01-03,48,0,95.55999755859375,4586.8798828125,0,1,0,1,144,2
100119,Furniture,112.46819305419922,2022-01-04,49,0,95.55999755859375,4682.439880371094,1,1,0,1,193,2
100119,Furniture,112.46819305419922,2022-01-05,66,50,91.18014282226562,10609.698852539062,2,1,0,1,259,2
100119,Furniture,112.46819305419922,2022-01-06,72,69,105.72581756591796,14894.487729492188,3,1,0,1,331,2
100119,Furniture,112.46819305419922,2022-01-07,55,55,103.90891998291016,11429.981198120116,4,1,0,1,386,2
100119,Furniture,112.46819305419922,2022-01-08,59,64,104.71466735839843,12882.980748291015,5,1,1,1,445,2
100119,Furniture,112.46819305419922,2022-01-09,44,67,108.70237915039063,12103.629365234376,6,1,1,1,489,2
100119,Furniture,112.46819305419922,2022-01-10,53,52,102.32658340454103,10746.577840881348,0,1,0,2,542,2
100119,Furniture,112.46819305419922,2022-01-11,18,0,104.61316680908203,1883.0370025634766,1,1,0,2,560,2
100119,Furniture,112.46819305419922,2022-01-12,72,73,113.2222055053711,16420.217592773435,2,1,0,2,632,2
100119,Furniture,112.46819305419922,2022-01-13,76,63,107.13900909423828,14907.77938232422,3,1,0,2,708,2
100119,Furniture,112.46819305419922,2022-01-14,66,95,111.77207763671875,18021.054248046872,4,1,0,2,774,2
100119,Furniture,112.46819305419922,2022-01-15,80,81,111.71345306396483,17986.172490234374,5,1,1,2,854,2
100119,Furniture,112.46819305419922,2022-01-16,96,88,105.77701904296876,19478.86765625,6,1,1,2,950,2
100119,Furniture,112.46819305419922,2022-01-17,88,104,103.76800827026366,19904.449455566406,0,1,0,3,1038,2
100119,Furniture,112.46819305419922,2022-01-18,54,50,100.99125228881836,10511.175247192383,1,1,0,3,1092,2
100119,Furniture,112.46819305419922,2022-01-19,63,86,118.72379302978516,17822.69792175293,2,1,0,3,1155,2
100119,Furniture,112.46819305419922,2022-01-20,51,78,105.53008163452148,13525.088326721192,3,1,0,3,1206,2
100119,Furniture,112.46819305419922,2022-01-21,116,161,114.01328369140626,31656.23181640625,4,1,0,3,1322,2
100119,Furniture,112.46819305419922,2022-01-22,88,0,112.3565673828125,9887.3779296875,5,1,1,3,1410,2
100119,Furniture,112.46819305419922,2022-01-23,53,56,106.3867562866211,11587.406166381836,6,1,1,3,1463,2
100119,Furniture,112.46819305419922,2022-01-24,82,109,115.62124740600586,22140.86457458496,0,1,0,4,1545,2
100119,Furniture,112.46819305419922,2022-01-25,98,79,104.45958602905273,18569.138861694337,1,1,0,4,1643,2
100119,Furniture,112.46819305419922,2022-01-26,46,0,108.65917205810547,4998.321914672852,2,1,0,4,1689,2
100119,Furniture,112.46819305419922,2022-01-27,72,79,104.79854385375977,15816.120314941407,3,1,0,4,1761,2
100119,Furniture,112.46819305419922,2022-01-28,79,121,126.35279815673829,25480.86210876465,4,1,0,4,1840,2
100119,Furniture,112.46819305419922,2022-01-29,39,0,121.34559631347656,4732.478256225586,5,1,1,4,1879,2
100119,Furniture,112.46819305419922,2022-01-30,80,132,117.01607238769532,24754.05158203125,6,1,1,4,1959,2
100119,Furniture,112.46819305419922,2022-01-31,71,0,118.04214477539062,8380.992279052734,0,1,0,5,2030,2
100119,Furniture,112.46819305419922,2022-02-01,39,52,102.16832717895508,9219.469519958497,1,2,0,5,2069,2
100119,Furniture,112.46819305419922,2022-02-02,61,63,98.77843856811523,12241.469505310059,2,2,0,5,2130,2
100119,Furniture,112.46819305419922,2022-02-03,78,101,102.88809051513672,18420.692120361327,3,2,0,5,2208,2
100119,Furniture,112.46819305419922,2022-02-04,57,89,117.39116821289062,17308.993176269534,4,2,0,5,2265,2
100119,Furniture,112.46819305419922,2022-02-05,87,0,112.08233642578125,9751.163269042969,5,2,1,5,2352,2
100119,Furniture,112.46819305419922,2022-02-06,46,102,110.53475570678711,16343.197525024414,6,2,1,5,2398,2
100119,Furniture,112.46819305419922,2022-02-07,60,97,106.40962249755859,16650.084699707033,0,2,0,6,2458,2
100119,Furniture,112.46819305419922,2022-02-08,69,0,107.92924499511719,7447.117904663086,1,2,0,6,2527,2
100119,Furniture,112.46819305419922,2022-02-09,47,50,84.78144836425781,8195.206146240234,2,2,0,6,2574,2
100119,Furniture,112.46819305419922,2022-02-10,73,99,118.93695083618164,20629.61482208252,3,2,0,6,2647,2
100119,Furniture,112.46819305419922,2022-02-11,67,74,114.74969696044923,16186.569392700196,4,2,0,6,2714,2
100119,Furniture,112.46819305419922,2022-02-12,51,81,103.79506759643554,13582.596894836424,5,2,1,6,2765,2
100119,Furniture,112.46819305419922,2022-02-13,85,85,110.68927383422852,18817.176551818848,6,2,1,6,2850,2
100119,Furniture,112.46819305419922,2022-02-14,59,0,109.37854766845703,6453.334312438965,0,2,0,7,2909,2
100119,Furniture,112.46819305419922,2022-02-15,59,68,102.33592559814454,12973.749220581056,1,2,0,7,2968,2
100119,Furniture,112.46819305419922,2022-02-16,76,101,127.75101379394532,22782.65409667969,2,2,0,7,3044,2
100119,Furniture,112.46819305419922,2022-02-17,68,68,107.99107727050782,14686.786508789064,3,2,0,7,3112,2
100119,Furniture,112.46819305419922,2022-02-18,111,97,123.66908538818359,25672.89695617676,4,2,0,7,3223,2
100119,Furniture,112.46819305419922,2022-02-19,68,82,112.40260543823243,16820.454339599608,5,2,1,7,3291,2
100119,Furniture,112.46819305419922,2022-02-20,57,58,115.49348419189454,13281.867197875978,6,2,1,7,3348,2
100119,Furniture,112.46819305419922,2022-02-21,65,59,101.8950910949707,12674.381842346193,0,2,0,8,3413,2
100119,Furniture,112.46819305419922,2022-02-22,79,93,110.62436874389648,19038.390261535642,1,2,0,8,3492,2
100119,Furniture,112.46819305419922,2022-02-23,108,97,112.71195724487305,23093.872764892578,2,2,0,8,3600,2
100119,Furniture,112.46819305419922,2022-02-24,74,76,107.11772262573243,16063.902948608398,3,2,0,8,3674,2
100119,Furniture,112.46819305419922,2022-02-25,45,56,100.81291687011719,10137.302518310546,4,2,0,8,3719,2
100119,Furniture,112.46819305419922,2022-02-26,61,89,103.4954298400879,15508.482440490723,5,2,1,8,3780,2
100119,Furniture,112.46819305419922,2022-02-27,30,0,104.06085968017578,3121.8257904052734,6,2,1,8,3810,2
100119,Furniture,112.46819305419922,2022-02-28,66,0,104.06085968017578,6868.016738891602,0,2,0,9,3876,2
100119,Furniture,112.46819305419922,2022-03-01,54,103,118.8486833190918,18809.737798461916,1,3,0,9,3930,2
100119,Furniture,112.46819305419922,2022-03-02,91,89,119.1308056640625,21441.086630859376,2,3,0,9,4021,2
100119,Furniture,112.46819305419922,2022-03-03,60,70,116.78708282470703,15177.649938964843,3,3,0,9,4081,2
100119,Furniture,112.46819305419922,2022-03-04,111,129,131.38827545166015,31609.717150268552,4,3,0,9,4192,2
100119,Furniture,112.46819305419922,2022-03-05,56,0,127.13655090332031,7119.6468505859375,5,3,1,9,4248,2
100119,Furniture,112.46819305419922,2022-03-06,64,58,96.14881118774414,11801.96783203125,6,3,1,9,4312,2
100119,Furniture,112.46819305419922,2022-03-07,67,111,99.66873596191405,17654.850618896482,0,3,0,10,4379,2
100119,Furniture,112.46819305419922,2022-03-08,97,94,102.43880187988282,19564.907564697263,1,3,0,10,4476,2
100119,Furniture,112.46819305419922,2022-03-09,93,96,111.87466186523437,21154.827106933593,2,3,0,10,4569,2
100119,Furniture,112.46819305419922,2022-03-10,37,65,103.2759245300293,10468.458415222169,3,3,0,10,4606,2
100119,Furniture,112.46819305419922,2022-03-11,23,0,105.6218490600586,2429.3025283813477,4,3,0,10,4629,2
100119,Furniture,112.46819305419922,2022-03-12,44,75,96.76317901611328,11395.059753417969,5,3,1,10,4673,2
100119,Furniture,112.46819305419922,2022-03-13,111,0,100.62635803222656,11169.525741577148,6,3,1,10,4784,2
100119,Furniture,112.46819305419922,2022-03-14,36,79,103.65751586914062,11944.801142578124,0,3,0,11,4820,2
100119,Furniture,112.46819305419922,2022-03-15,79,65,107.28589492797852,15426.991398620605,1,3,0,11,4899,2
100119,Furniture,112.46819305419922,2022-03-16,65,86,93.65419464111328,14072.395303344725,2,3,0,11,4964,2
100119,Furniture,112.46819305419922,2022-03-17,37,50,94.83963745117188,8238.313171386719,3,3,0,11,5001,2
100119,Furniture,112.46819305419922,2022-03-18,58,94,102.25872634887696,15623.292256469727,4,3,0,11,5059,2
100119,Furniture,112.46819305419922,2022-03-19,38,0,100.0374526977539,3801.4232025146484,5,3,1,11,5097,2
100119,Furniture,112.46819305419922,2022-03-20,24,0,100.0374526977539,2400.8988647460938,6,3,1,11,5121,2
100119,Furniture,112.46819305419922,2022-03-21,73,114,116.11161315917968,21872.705521240234,0,3,0,12,5194,2
100119,Furniture,112.46819305419922,2022-03-22,104,77,108.60488906860351,19698.92692626953,1,3,0,12,5298,2
100119,Furniture,112.46819305419922,2022-03-23,87,100,128.80262039184572,24159.635948181152,2,3,0,12,5385,2
100119,Furniture,112.46819305419922,2022-03-24,100,115,109.84145095825195,23555.440191650392,3,3,0,12,5485,2
100119,Furniture,112.46819305419922,2022-03-25,115,118,109.76567169189454,25571.36448913574,4,3,0,12,5600,2
100119,Furniture,112.46819305419922,2022-03-26,75,76,105.85654190063477,15982.041285095216,5,3,1,12,5675,2
100119,Furniture,112.46819305419922,2022-03-27,54,81,109.46459365844726,14792.716115112304,6,3,1,12,5729,2
100119,Furniture,112.46819305419922,2022-03-28,37,0,108.90918731689453,4029.6399307250977,0,3,0,13,5766,2
100119,Furniture,112.46819305419922,2022-03-29,60,59,107.29506469726562,12768.887763671875,1,3,0,13,5826,2
100119,Furniture,112.46819305419922,2022-03-30,106,92,108.0116358947754,21386.606809692385,2,3,0,13,5932,2
100119,Furniture,112.46819305419922,2022-03-31,55,61,97.62118713378906,11296.870584716797,3,3,0,13,5987,2
100119,Furniture,112.46819305419922,2022-04-01,67,68,110.90939575195313,14976.479030761719,4,4,0,13,6054,2
100119,Furniture,112.46819305419922,2022-04-02,40,50,97.71532592773437,8746.72607421875,5,4,1,13,6094,2
100119,Furniture,112.46819305419922,2022-04-03,44,0,102.48065185546875,4509.148681640625,6,4,1,13,6138,2
100119,Furniture,112.46819305419922,2022-04-04,33,50,96.53527374267578,7971.878067016602,0,4,0,14,6171,2
100119,Furniture,112.46819305419922,2022-04-05,84,81,96.48250122070313,15922.110205078126,1,4,0,14,6255,2
100119,Furniture,112.46819305419922,2022-04-06,81,85,108.66670135498046,18053.325619506835,2,4,0,14,6336,2
100119,Furniture,112.46819305419922,2022-04-07,28,50,102.20551391601563,7943.748779296875,3,4,0,14,6364,2
100119,Furniture,112.46819305419922,2022-04-08,107,179,125.7646678161621,36337.71891265869,4,4,0,14,6471,2
100119,Furniture,112.46819305419922,2022-04-09,30,0,120.63933563232422,3619.1800689697266,5,4,1,14,6501,2
100119,Furniture,112.46819305419922,2022-04-10,105,0,120.63933563232422,12667.130241394043,6,4,1,14,6606,2
100119,Furniture,112.46819305419922,2022-04-11,44,120,113.04637390136719,18450.200903320314,0,4,0,15,6650,2
100119,Furniture,112.46819305419922,2022-04-12,74,76,105.99145477294923,15891.455306396485,1,4,0,15,6724,2
100119,Furniture,112.46819305419922,2022-04-13,76,127,117.06521057128907,23887.392006835937,2,4,0,15,6800,2
100119,Furniture,112.46819305419922,2022-04-14,86,0,114.65042114257812,9859.936218261719,3,4,0,15,6886,2
100119,Furniture,112.46819305419922,2022-04-15,87,119,118.81513580322266,24511.59362976074,4,4,0,15,6973,2
100119,Furniture,112.46819305419922,2022-04-16,59,0,117.70027160644531,6944.316024780273,5,4,1,15,7032,2
100119,Furniture,112.46819305419922,2022-04-17,60,106,116.46293899536133,19320.29267944336,6,4,1,15,7092,2
100119,Furniture,112.46819305419922,2022-04-18,43,58,112.48141250610351,11330.151475524903,0,4,0,16,7135,2
100119,Furniture,112.46819305419922,2022-04-19,121,164,109.2013719177246,31060.842004089354,1,4,0,16,7256,2
100119,Furniture,112.46819305419922,2022-04-20,114,0,110.63274383544922,12612.132797241211,2,4,0,16,7370,2
100119,Furniture,112.46819305419922,2022-04-21,50,63,108.15414581298828,12212.264581298828,3,4,0,16,7420,2
100119,Furniture,112.46819305419922,2022-04-22,61,56,101.63160766601563,11903.906135253907,4,4,0,16,7481,2
100119,Furniture,112.46819305419922,2022-04-23,53,50,97.7060482788086,10070.911117553711,5,4,1,16,7534,2
100119,Furniture,112.46819305419922,2022-04-24,54,50,93.94483459472656,9779.002136230469,6,4,1,16,7588,2
100119,Furniture,112.46819305419922,2022-04-25,30,50,93.93219253540039,7499.731552124023,0,4,0,17,7618,2
100119,Furniture,112.46819305419922,2022-04-26,38,50,94.33917770385742,8300.177505493164,1,4,0,17,7656,2
100119,Furniture,112.46819305419922,2022-04-27,37,50,91.80328552246094,7971.113128662109,2,4,0,17,7693,2
100119,Furniture,112.46819305419922,2022-04-28,32,0,93.01657104492188,2976.5302734375,3,4,0,17,7725,2
100119,Furniture,112.46819305419922,2022-04-29,28,50,91.41500427246095,7116.6202392578125,4,4,0,17,7753,2
100119,Furniture,112.46819305419922,2022-04-30,37,54,97.29878753662109,8893.820277709961,5,4,1,17,7790,2
100119,Furniture,112.46819305419922,2022-05-01,29,0,94.96757507324219,2754.0596771240234,6,5,1,17,7819,2
100119,Furniture,112.46819305419922,2022-05-02,32,50,90.17726165771484,7357.86474609375,0,5,0,18,7851,2
100119,Furniture,112.46819305419922,2022-05-03,38,54,94.8826596069336,8748.842130126952,1,5,0,18,7889,2
100119,Furniture,112.46819305419922,2022-05-04,29,0,93.65531921386719,2716.0042572021484,2,5,0,18,7918,2
100119,Furniture,112.46819305419922,2022-05-05,34,50,87.96941802978515,7349.280426025391,3,5,0,18,7952,2
100119,Furniture,112.46819305419922,2022-05-06,24,0,90.47883605957031,2171.4920654296875,4,5,0,18,7976,2
100119,Furniture,112.46819305419922,2022-05-07,44,50,97.03701293945312,9137.817138671875,5,5,1,18,8020,2
100119,Furniture,112.46819305419922,2022-05-08,37,50,83.09193084716796,7165.53288269043,6,5,1,18,8057,2
100119,Furniture,112.46819305419922,2022-05-09,37,57,87.92954833984375,8264.986577148436,0,5,0,19,8094,2
100119,Furniture,112.46819305419922,2022-05-10,44,0,87.9490966796875,3869.76025390625,1,5,0,19,8138,2
100119,Furniture,112.46819305419922,2022-05-11,28,50,84.19327697753906,6534.2235107421875,2,5,0,19,8166,2
100119,Furniture,112.46819305419922,2022-05-12,23,0,85.68655395507812,1970.7907409667969,3,5,0,19,8189,2
100119,Furniture,112.46819305419922,2022-05-13,20,50,85.62445907592773,5992.978363037109,4,5,0,19,8209,2
100119,Furniture,112.46819305419922,2022-05-14,26,0,85.64891815185547,2226.871871948242,5,5,1,19,8235,2
100119,Furniture,112.46819305419922,2022-05-15,18,50,87.5243067932129,5976.155044555664,6,5,1,19,8253,2
100119,Furniture,112.46819305419922,2022-05-16,24,0,86.75861358642578,2082.2067260742188,0,5,0,20,8277,2
100119,Furniture,112.46819305419922,2022-05-17,65,65,90.14888580322265,11719.355154418945,1,5,0,20,8342,2
100119,Furniture,112.46819305419922,2022-05-18,60,66,95.28363067626952,12019.875681152344,2,5,0,20,8402,2
100119,Furniture,112.46819305419922,2022-05-19,40,50,95.52967117309569,8609.473693847656,3,5,0,20,8442,2
100119,Furniture,112.46819305419922,2022-05-20,71,68,85.61651626586914,11911.335309753416,4,5,0,20,8513,2
100119,Furniture,112.46819305419922,2022-05-21,77,64,90.61185882568358,12768.496259155272,5,5,1,20,8590,2
100119,Furniture,112.46819305419922,2022-05-22,19,50,85.92061645507812,5873.323425292969,6,5,1,20,8609,2
100119,Furniture,112.46819305419922,2022-05-23,100,102,96.38431579589843,19475.643159179686,0,5,0,21,8709,2
100119,Furniture,112.46819305419922,2022-05-24,51,0,93.37863159179688,4762.310211181641,1,5,0,21,8760,2
100119,Furniture,112.46819305419922,2022-05-25,55,50,99.5062338256836,10436.785720825195,2,5,0,21,8815,2
100119,Furniture,112.46819305419922,2022-05-26,51,58,108.37166412353515,11837.279740600585,3,5,0,21,8866,2
100119,Furniture,112.46819305419922,2022-05-27,61,93,123.62832427978516,19187.29556213379,4,5,0,21,8927,2
100119,Furniture,112.46819305419922,2022-05-28,93,97,115.4696531677246,21934.67548919678,5,5,1,21,9020,2
100119,Furniture,112.46819305419922,2022-05-29,70,114,123.38709075927734,22792.232706298826,6,5,1,21,9090,2
100119,Furniture,112.46819305419922,2022-05-30,57,0,121.36418151855469,6917.758346557617,0,5,0,22,9147,2
100119,Furniture,112.46819305419922,2022-05-31,83,66,116.97636962890624,17458.487358398437,1,5,0,22,9230,2
100119,Furniture,112.46819305419922,2022-06-01,66,88,112.68397964477539,17316.94531311035,2,6,0,22,9296,2
100119,Furniture,112.46819305419922,2022-06-02,68,124,113.51685180664063,21783.091845703122,3,6,0,22,9364,2
100119,Furniture,112.46819305419922,2022-06-03,123,127,128.2387417602539,32080.77047302246,4,6,0,22,9487,2
100119,Furniture,112.46819305419922,2022-06-04,35,0,122.96748352050781,4303.861923217773,5,6,1,22,9522,2
100119,Furniture,112.46819305419922,2022-06-05,82,130,109.63416687011718,23047.363366699217,6,6,1,22,9604,2
100119,Furniture,112.46819305419922,2022-06-06,48,0,113.69833374023438,5457.52001953125,0,6,0,23,9652,2
100119,Furniture,112.46819305419922,2022-06-07,59,0,113.69833374023438,6708.201690673828,1,6,0,23,9711,2
100119,Furniture,112.46819305419922,2022-06-08,55,75,102.1171482849121,13213.086311340332,2,6,0,23,9766,2
100119,Furniture,112.46819305419922,2022-06-09,52,57,93.07940185546875,10121.55779296875,3,6,0,23,9818,2
100119,Furniture,112.46819305419922,2022-06-10,58,54,107.88889724731445,12066.552080688478,4,6,0,23,9876,2
100119,Furniture,112.46819305419922,2022-06-11,67,74,99.56264099121094,14028.653892822265,5,6,1,23,9943,2
100119,Furniture,112.46819305419922,2022-06-12,13,0,100.94528198242188,1312.2886657714844,6,6,1,23,9956,2
100119,Furniture,112.46819305419922,2022-06-13,70,84,100.88711029052735,15536.375440673828,0,6,0,24,10026,2
100119,Furniture,112.46819305419922,2022-06-14,55,57,96.60423721313477,10816.026093444823,1,6,0,24,10081,2
100119,Furniture,112.46819305419922,2022-06-15,67,63,93.1153302001953,12113.614246826171,2,6,0,24,10148,2
100119,Furniture,112.46819305419922,2022-06-16,58,64,88.78319931030273,10816.351119995117,3,6,0,24,10206,2
100119,Furniture,112.46819305419922,2022-06-17,76,113,114.4552294921875,21871.9748828125,4,6,0,24,10282,2
100119,Furniture,112.46819305419922,2022-06-18,42,0,107.970458984375,4534.75927734375,5,6,1,24,10324,2
100119,Furniture,112.46819305419922,2022-06-19,74,89,115.09450119018555,18794.38617614746,6,6,1,24,10398,2
100119,Furniture,112.46819305419922,2022-06-20,54,68,111.14518615722656,13549.840104980469,0,6,0,25,10452,2
100119,Furniture,112.46819305419922,2022-06-21,112,179,127.78323272705079,37439.30413085938,1,6,0,25,10564,2
100119,Furniture,112.46819305419922,2022-06-22,38,0,123.98646545410156,4711.485687255859,2,6,0,25,10602,2
100119,Furniture,112.46819305419922,2022-06-23,101,123,120.66877029418944,27003.21159942627,3,6,0,25,10703,2
100119,Furniture,112.46819305419922,2022-06-24,12,0,121.8775405883789,1462.5304870605469,4,6,0,25,10715,2
100119,Furniture,112.46819305419922,2022-06-25,94,97,114.17935302734375,21798.148369140625,5,6,1,25,10809,2
100119,Furniture,112.46819305419922,2022-06-26,77,0,117.5487060546875,9051.250366210938,6,6,1,25,10886,2
100119,Furniture,112.46819305419922,2022-06-27,59,53,97.30700256347657,10949.486302490233,0,6,0,26,10945,2
100119,Furniture,112.46819305419922,2022-06-28,25,50,95.69543182373047,7072.021591186523,1,6,0,26,10970,2
100119,Furniture,112.46819305419922,2022-06-29,29,0,99.90086364746094,2897.125045776367,2,6,0,26,10999,2
100119,Furniture,112.46819305419922,2022-06-30,49,54,94.10065216064453,9681.263911743164,3,6,0,26,11048,2
100119,Furniture,112.46819305419922,2022-07-01,56,50,92.78169479370118,9843.749816894531,4,7,0,26,11104,2
100119,Furniture,112.46819305419922,2022-07-02,34,50,85.07372375488282,7087.733215332031,5,7,1,26,11138,2
100119,Furniture,112.46819305419922,2022-07-03,36,50,88.31557220458984,7592.541198730469,6,7,1,26,11174,2
100119,Furniture,112.46819305419922,2022-07-04,34,0,88.50114440917969,3009.0389099121094,0,7,0,27,11208,2
100119,Furniture,112.46819305419922,2022-07-05,35,50,96.94746002197266,8289.022201538086,1,7,0,27,11243,2
100119,Furniture,112.46819305419922,2022-07-06,21,50,96.8333804321289,6914.511978149414,2,7,0,27,11264,2
100119,Furniture,112.46819305419922,2022-07-07,49,68,84.42907135009766,9786.25899230957,3,7,0,27,11313,2
100119,Furniture,112.46819305419922,2022-07-08,27,0,89.26814270019531,2410.2398529052734,4,7,0,27,11340,2
100119,Furniture,112.46819305419922,2022-07-09,42,0,89.26814270019531,3749.261993408203,5,7,1,27,11382,2
100119,Furniture,112.46819305419922,2022-07-10,17,50,89.40196380615234,5991.51676940918,6,7,1,27,11399,2
100119,Furniture,112.46819305419922,2022-07-11,31,50,89.31046630859376,7233.7589111328125,0,7,0,28,11430,2
100119,Furniture,112.46819305419922,2022-07-12,86,97,97.96302642822266,17961.190545654295,1,7,0,28,11516,2
100119,Furniture,112.46819305419922,2022-07-13,36,0,94.87605285644531,3415.5379028320312,2,7,0,28,11552,2
100119,Furniture,112.46819305419922,2022-07-14,65,58,91.43515014648438,11256.569519042969,3,7,0,28,11617,2
100119,Furniture,112.46819305419922,2022-07-15,32,52,80.7693081665039,6682.43572265625,4,7,0,28,11649,2
100119,Furniture,112.46819305419922,2022-07-16,71,83,97.88918258666993,15127.743927307129,5,7,1,28,11720,2
100119,Furniture,112.46819305419922,2022-07-17,102,106,99.62790451049804,20730.892520141602,6,7,1,28,11822,2
100119,Furniture,112.46819305419922,2022-07-18,29,0,97.5558090209961,2829.1184616088867,0,7,0,29,11851,2
100119,Furniture,112.46819305419922,2022-07-19,31,59,97.7710987854004,8801.888124694824,1,7,0,29,11882,2
100119,Furniture,112.46819305419922,2022-07-20,17,0,97.68219757080078,1660.5973587036133,2,7,0,29,11899,2
100119,Furniture,112.46819305419922,2022-07-21,4,0,97.68219757080078,390.7287902832031,3,7,0,29,11903,2
100119,Furniture,112.46819305419922,2022-07-22,32,0,97.68219757080078,3125.830322265625,4,7,0,29,11935,2
100119,Furniture,112.46819305419922,2022-07-23,31,50,92.13596038818359,7424.329544067383,5,7,1,29,11966,2
100119,Furniture,112.46819305419922,2022-07-24,44,50,96.22629028320313,9050.633544921875,6,7,1,29,12010,2
100119,Furniture,112.46819305419922,2022-07-25,73,95,113.06793258666991,19114.038157653806,0,7,0,30,12083,2
100119,Furniture,112.46819305419922,2022-07-26,55,54,103.59948150634766,11294.352965698243,1,7,0,30,12138,2
100119,Furniture,112.46819305419922,2022-07-27,104,86,112.47340133666992,21323.387478027344,2,7,0,30,12242,2
100119,Furniture,112.46819305419922,2022-07-28,86,154,107.90301071166992,25867.277842407228,3,7,0,30,12328,2
100119,Furniture,112.46819305419922,2022-07-29,37,0,108.33602142333984,4008.432792663574,4,7,0,30,12365,2
100119,Furniture,112.46819305419922,2022-07-30,88,125,126.52222076416015,27163.750854492188,5,7,1,30,12453,2
100119,Furniture,112.46819305419922,2022-07-31,68,87,122.36822158813476,18981.73813598633,6,7,1,30,12521,2
100119,Furniture,112.46819305419922,2022-08-01,78,0,121.59644317626953,9484.522567749023,0,8,0,31,12599,2
100119,Furniture,112.46819305419922,2022-08-02,62,94,99.55804641723633,15294.317755737304,1,8,0,31,12661,2
100119,Furniture,112.46819305419922,2022-08-03,93,118,102.440009765625,21575.34181640625,2,8,0,31,12754,2
100119,Furniture,112.46819305419922,2022-08-04,67,122,115.75548065185546,22125.534407348634,3,8,0,31,12821,2
100119,Furniture,112.46819305419922,2022-08-05,48,0,111.25096130371094,5340.046142578125,4,8,0,31,12869,2
100119,Furniture,112.46819305419922,2022-08-06,95,0,111.25096130371094,10568.841323852539,5,8,1,31,12964,2
100119,Furniture,112.46819305419922,2022-08-07,54,77,117.87525192260742,15486.387207641601,6,8,1,31,13018,2
100119,Furniture,112.46819305419922,2022-08-08,46,59,92.16559509277343,9546.274748535157,0,8,0,32,13064,2
100119,Furniture,112.46819305419922,2022-08-09,95,106,106.15029067993164,21349.955229187013,1,8,0,32,13159,2
100119,Furniture,112.46819305419922,2022-08-10,39,66,98.46823181152344,10259.832081298828,2,8,0,32,13198,2
100119,Furniture,112.46819305419922,2022-08-11,127,129,102.43245651245118,26223.4239541626,3,8,0,32,13325,2
100119,Furniture,112.46819305419922,2022-08-12,38,0,102.07491302490234,3878.846694946289,4,8,0,32,13363,2
100119,Furniture,112.46819305419922,2022-08-13,89,121,114.51991317749022,24167.26454559326,5,8,1,32,13452,2
100119,Furniture,112.46819305419922,2022-08-14,100,98,106.80452056884766,21150.56411376953,6,8,1,32,13552,2
100119,Furniture,112.46819305419922,2022-08-15,14,0,108.43904113769531,1518.1465759277344,0,8,0,33,13566,2
100119,Furniture,112.46819305419922,2022-08-16,93,81,117.07187698364257,20326.84911895752,1,8,0,33,13659,2
100119,Furniture,112.46819305419922,2022-08-17,65,80,112.4943490600586,16306.065377807618,2,8,0,33,13724,2
100119,Furniture,112.46819305419922,2022-08-18,40,0,112.86869812011719,4514.7479248046875,3,8,0,33,13764,2
100119,Furniture,112.46819305419922,2022-08-19,74,104,108.83152542114257,19338.065762329104,4,8,0,33,13838,2
100119,Furniture,112.46819305419922,2022-08-20,56,77,108.10731033325195,14361.948757324219,5,8,1,33,13894,2
100119,Furniture,112.46819305419922,2022-08-21,80,103,116.51146804809571,21390.104887695314,6,8,1,33,13974,2
100119,Furniture,112.46819305419922,2022-08-22,30,0,113.5329360961914,3405.988082885742,0,8,0,34,14004,2
100119,Furniture,112.46819305419922,2022-08-23,125,146,125.70984619140626,34144.02154785156,1,8,0,34,14129,2
100119,Furniture,112.46819305419922,2022-08-24,29,0,122.0596923828125,3539.7310791015625,2,8,0,34,14158,2
100119,Furniture,112.46819305419922,2022-08-25,107,74,112.00794235229492,20419.889663391114,3,8,0,34,14265,2
100119,Furniture,112.46819305419922,2022-08-26,84,64,119.44977981567382,17654.763009033202,4,8,0,34,14349,2
100119,Furniture,112.46819305419922,2022-08-27,64,96,110.65991104125976,17644.78861328125,5,8,1,34,14413,2
100119,Furniture,112.46819305419922,2022-08-28,58,74,106.78289306640625,14058.975595703127,6,8,1,34,14471,2
100119,Furniture,112.46819305419922,2022-08-29,79,73,112.02223709106445,17019.653460388185,0,8,0,35,14550,2
100119,Furniture,112.46819305419922,2022-08-30,41,0,110.7344741821289,4540.113441467285,1,8,0,35,14591,2
100119,Furniture,112.46819305419922,2022-08-31,39,50,108.28496185302734,9626.747024536133,2,8,0,35,14630,2
100119,Furniture,112.46819305419922,2022-09-01,75,72,96.7783578491211,14239.343677368164,3,9,0,35,14705,2
100119,Furniture,112.46819305419922,2022-09-02,19,0,101.08671569824219,1920.6475982666016,4,9,0,35,14724,2
100119,Furniture,112.46819305419922,2022-09-03,54,66,105.87101257324218,12721.189357910156,5,9,1,35,14778,2
100119,Furniture,112.46819305419922,2022-09-04,64,97,109.97550064086914,17752.07408203125,6,9,1,35,14842,2
100119,Furniture,112.46819305419922,2022-09-05,12,0,108.58100128173828,1302.9720153808594,0,9,0,36,14854,2
100119,Furniture,112.46819305419922,2022-09-06,80,56,109.93016601562499,14936.346562499999,1,9,0,36,14934,2
100119,Furniture,112.46819305419922,2022-09-07,48,66,102.87031234741211,11689.589985351562,2,9,0,36,14982,2
100119,Furniture,112.46819305419922,2022-09-08,81,146,109.55277481079102,24933.299519348144,3,9,0,36,15063,2
100119,Furniture,112.46819305419922,2022-09-09,99,98,105.74137451171876,20832.25215332031,4,9,0,36,15162,2
100119,Furniture,112.46819305419922,2022-09-10,66,93,115.62610992431641,18487.256510009764,5,9,1,36,15228,2
100119,Furniture,112.46819305419922,2022-09-11,65,0,111.82221984863281,7268.444290161133,6,9,1,36,15293,2
100119,Furniture,112.46819305419922,2022-09-12,37,0,111.82221984863281,4137.422134399414,0,9,0,37,15330,2
100119,Furniture,112.46819305419922,2022-09-13,61,79,103.38911285400391,14427.871768188477,1,9,0,37,15391,2
100119,Furniture,112.46819305419922,2022-09-14,88,104,95.56563507080078,18299.071772460935,2,9,0,37,15479,2
100119,Furniture,112.46819305419922,2022-09-15,68,73,105.35528976440429,14869.019407958986,3,9,0,37,15547,2
100119,Furniture,112.46819305419922,2022-09-16,18,0,102.5705795288086,1846.2704315185547,4,9,0,37,15565,2
100119,Furniture,112.46819305419922,2022-09-17,91,85,114.82676773071289,20183.871726989746,5,9,1,37,15656,2
100119,Furniture,112.46819305419922,2022-09-18,85,118,113.17566543579102,22997.573124084473,6,9,1,37,15741,2
100119,Furniture,112.46819305419922,2022-09-19,70,57,109.78262145996094,13960.23700439453,0,9,0,38,15811,2
100119,Furniture,112.46819305419922,2022-09-20,68,72,108.21138702392578,15144.628635253906,1,9,0,38,15879,2
100119,Furniture,112.46819305419922,2022-09-21,80,87,101.08350341796876,16858.380546875,2,9,0,38,15959,2
100119,Furniture,112.46819305419922,2022-09-22,66,81,102.94734329223633,15124.749314575194,3,9,0,38,16025,2
100119,Furniture,112.46819305419922,2022-09-23,59,0,103.51468658447266,6107.366508483887,4,9,0,38,16084,2
100119,Furniture,112.46819305419922,2022-09-24,72,110,94.3578498840332,17087.33038330078,5,9,1,38,16156,2
100119,Furniture,112.46819305419922,2022-09-25,73,71,109.93571090698242,15819.113792419434,6,9,1,38,16229,2
100119,Furniture,112.46819305419922,2022-09-26,104,86,110.04513839721679,20867.44878662109,0,9,0,39,16333,2
100119,Furniture,112.46819305419922,2022-09-27,76,89,100.26654815673828,16511.26531982422,1,9,0,39,16409,2
100119,Furniture,112.46819305419922,2022-09-28,88,90,111.45411651611329,19845.14450683594,2,9,0,39,16497,2
100119,Furniture,112.46819305419922,2022-09-29,38,58,107.27577926635743,10288.759224243164,3,9,0,39,16535,2
100119,Furniture,112.46819305419922,2022-09-30,80,0,107.76155853271484,8620.924682617188,4,9,0,39,16615,2
100119,Furniture,112.46819305419922,2022-10-01,31,50,93.44352722167969,7484.498687744141,5,10,1,39,16646,2
100119,Furniture,112.46819305419922,2022-10-02,56,50,102.03952224731445,10806.466491699219,6,10,1,39,16702,2
100119,Furniture,112.46819305419922,2022-10-03,58,67,107.46233932495117,13451.941361694337,0,10,0,40,16760,2
100119,Furniture,112.46819305419922,2022-10-04,67,78,97.49532348632812,14110.913347167969,1,10,0,40,16827,2
100119,Furniture,112.46819305419922,2022-10-05,78,113,99.09411163330078,18920.181414794923,2,10,0,40,16905,2
100119,Furniture,112.46819305419922,2022-10-06,33,0,99.28822326660156,3276.5113677978516,3,10,0,40,16938,2
100119,Furniture,112.46819305419922,2022-10-07,32,50,97.68329940795898,7997.191162109375,4,10,0,40,16970,2
100119,Furniture,112.46819305419922,2022-10-08,44,60,103.86274353027343,10841.041430664063,5,10,1,40,17014,2
100119,Furniture,112.46819305419922,2022-10-09,38,0,101.40548706054688,3853.4085083007812,6,10,1,40,17052,2
100119,Furniture,112.46819305419922,2022-10-10,76,90,112.52029052734375,18724.56416015625,0,10,0,41,17128,2
100119,Furniture,112.46819305419922,2022-10-11,65,81,108.93278411865234,15902.541935424804,1,10,0,41,17193,2
100119,Furniture,112.46819305419922,2022-10-12,99,148,129.28151565551758,32194.120099792483,2,10,0,41,17292,2
100119,Furniture,112.46819305419922,2022-10-13,124,125,116.10842864990235,28908.00030517578,3,10,0,41,17416,2
100119,Furniture,112.46819305419922,2022-10-14,50,0,119.10685729980469,5955.342864990234,4,10,0,41,17466,2
100119,Furniture,112.46819305419922,2022-10-15,106,120,116.76687469482422,26379.277435302734,5,10,1,41,17572,2
100119,Furniture,112.46819305419922,2022-10-16,87,91,126.74144454956054,22574.691351623536,6,10,1,41,17659,2
100119,Furniture,112.46819305419922,2022-10-17,74,65,104.61571090698243,14622.635214233398,0,10,0,42,17733,2
100119,Furniture,112.46819305419922,2022-10-18,115,121,117.7500486755371,27796.991195373535,1,10,0,42,17848,2
100119,Furniture,112.46819305419922,2022-10-19,118,118,137.13797576904295,32364.56228149414,2,10,0,42,17966,2
100119,Furniture,112.46819305419922,2022-10-20,71,88,132.59145812988282,21099.18705444336,3,10,0,42,18037,2
100119,Furniture,112.46819305419922,2022-10-21,52,0,131.58291625976562,6842.3116455078125,4,10,0,42,18089,2
100119,Furniture,112.46819305419922,2022-10-22,86,156,134.72998626708983,32652.257637939452,5,10,1,42,18175,2
100119,Furniture,112.46819305419922,2022-10-23,122,142,117.8600602722168,31000.2547064209,6,10,1,42,18297,2
100119,Furniture,112.46819305419922,2022-10-24,138,163,127.49460189819337,38410.010123901375,0,10,0,43,18435,2
100119,Furniture,112.46819305419922,2022-10-25,70,0,126.12920379638672,8829.04426574707,1,10,0,43,18505,2
100119,Furniture,112.46819305419922,2022-10-26,73,0,126.12920379638672,9207.43187713623,2,10,0,43,18578,2
100119,Furniture,112.46819305419922,2022-10-27,31,54,107.67711471557618,9004.271112365723,3,10,0,43,18609,2
100119,Furniture,112.46819305419922,2022-10-28,50,51,102.41345809936524,10338.575809936523,4,10,0,43,18659,2
100119,Furniture,112.46819305419922,2022-10-29,66,61,102.7772998046875,13062.40357421875,5,10,1,43,18725,2
100119,Furniture,112.46819305419922,2022-10-30,52,50,102.67658950805665,10474.78530883789,6,10,1,43,18777,2
100119,Furniture,112.46819305419922,2022-10-31,75,102,114.35025024414062,20318.287536621094,0,10,0,44,18852,2
100119,Furniture,112.46819305419922,2022-11-01,83,89,109.2878303527832,18792.77983856201,1,11,0,44,18935,2
100119,Furniture,112.46819305419922,2022-11-02,40,64,108.85747375488282,11307.797900390626,2,11,0,44,18975,2
100119,Furniture,112.46819305419922,2022-11-03,77,98,96.27002929687501,16736.16451171875,3,11,0,44,19052,2
100119,Furniture,112.46819305419922,2022-11-04,71,96,112.07628356933594,18833.332266845704,4,11,0,44,19123,2
100119,Furniture,112.46819305419922,2022-11-05,95,112,115.95675384521485,24067.363230590818,5,11,1,44,19218,2
100119,Furniture,112.46819305419922,2022-11-06,57,0,112.17350769042969,6393.889938354492,6,11,1,44,19275,2
100119,Furniture,112.46819305419922,2022-11-07,91,149,118.36903289794921,28522.303987426756,0,11,0,45,19366,2
100119,Furniture,112.46819305419922,2022-11-08,74,0,116.40806579589844,8614.196868896484,1,11,0,45,19440,2
100119,Furniture,112.46819305419922,2022-11-09,111,93,104.32582427978517,21368.612990112306,2,11,0,45,19551,2
100119,Furniture,112.46819305419922,2022-11-10,57,79,107.7002490234375,14634.908388671874,3,11,0,45,19608,2
100119,Furniture,112.46819305419922,2022-11-11,26,0,108.260498046875,2814.77294921875,4,11,0,45,19634,2
100119,Furniture,112.46819305419922,2022-11-12,100,110,126.0048812866211,26516.47625732422,5,11,1,45,19734,2
100119,Furniture,112.46819305419922,2022-11-13,42,0,120.45976257324219,5059.310028076172,6,11,1,45,19776,2
100119,Furniture,112.46819305419922,2022-11-14,68,55,107.9926969909668,13345.016790771486,0,11,0,46,19844,2
100119,Furniture,112.46819305419922,2022-11-15,55,140,115.63691680908204,22589.410848999025,1,11,0,46,19899,2
100119,Furniture,112.46819305419922,2022-11-16,46,0,115.16383361816406,5297.536346435547,2,11,0,46,19945,2
100119,Furniture,112.46819305419922,2022-11-17,54,66,109.23568893432616,13078.694404907226,3,11,0,46,19999,2
100119,Furniture,112.46819305419922,2022-11-18,92,79,118.04353134155274,20152.339766845704,4,11,0,46,20091,2
100119,Furniture,112.46819305419922,2022-11-19,80,94,94.04860076904296,16265.076123046874,5,11,1,46,20171,2
100119,Furniture,112.46819305419922,2022-11-20,107,98,117.67385757446289,24070.61552093506,6,11,1,46,20278,2
100119,Furniture,112.46819305419922,2022-11-21,66,108,107.57149612426758,18661.51748840332,0,11,0,47,20344,2
100119,Furniture,112.46819305419922,2022-11-22,108,133,113.49615005493163,27392.168411865234,1,11,0,47,20452,2
100119,Furniture,112.46819305419922,2022-11-23,85,0,111.91230010986328,9512.545509338379,2,11,0,47,20537,2
100119,Furniture,112.46819305419922,2022-11-24,80,105,106.6121208190918,19686.689331054688,3,11,0,47,20617,2
100119,Furniture,112.46819305419922,2022-11-25,59,79,112.97387298583985,15629.517012329103,4,11,0,47,20676,2
100119,Furniture,112.46819305419922,2022-11-26,43,0,111.01774597167969,4773.763076782227,5,11,1,47,20719,2
100119,Furniture,112.46819305419922,2022-11-27,30,0,111.01774597167969,3330.5323791503906,6,11,1,47,20749,2
100119,Furniture,112.46819305419922,2022-11-28,49,55,107.92328247070313,11218.061682128908,0,11,0,48,20798,2
100119,Furniture,112.46819305419922,2022-11-29,58,85,116.1658772277832,16661.51175842285,1,11,0,48,20856,2
100119,Furniture,112.46819305419922,2022-11-30,85,84,125.24135787963867,21162.120839538577,2,11,0,48,20941,2
100119,Furniture,112.46819305419922,2022-12-01,72,66,99.43075958251953,13773.109379882811,3,12,0,48,21013,2
100119,Furniture,112.46819305419922,2022-12-02,78,58,105.47278854370117,14364.955012817383,4,12,0,48,21091,2
100119,Furniture,112.46819305419922,2022-12-03,58,120,121.71062942504884,21847.973013305666,5,12,1,48,21149,2
100119,Furniture,112.46819305419922,2022-12-04,47,0,118.75125885009766,5581.30916595459,6,12,1,48,21196,2
100119,Furniture,112.46819305419922,2022-12-05,73,101,105.03977508544922,18175.007162475587,0,12,0,49,21269,2
100119,Furniture,112.46819305419922,2022-12-06,101,88,110.31403167724609,20841.604398803713,1,12,0,49,21370,2
100119,Furniture,112.46819305419922,2022-12-07,38,50,109.65126663208008,9648.936264038086,2,12,0,49,21408,2
100119,Furniture,112.46819305419922,2022-12-08,72,101,115.18724716186523,19980.253591308596,3,12,0,49,21480,2
100119,Furniture,112.46819305419922,2022-12-09,51,94,114.56959655761719,16633.678848876953,4,12,0,49,21531,2
100119,Furniture,112.46819305419922,2022-12-10,66,0,114.07919311523438,7529.226745605469,5,12,1,49,21597,2
100119,Furniture,112.46819305419922,2022-12-11,30,0,114.07919311523438,3422.3757934570312,6,12,1,49,21627,2
100119,Furniture,112.46819305419922,2022-12-12,66,62,115.83340072631836,14824.008895874023,0,12,0,50,21693,2
100119,Furniture,112.46819305419922,2022-12-13,45,50,98.00430313110351,9274.487281799316,1,12,0,50,21738,2
100119,Furniture,112.46819305419922,2022-12-14,77,176,134.29565979003905,34494.01160766602,2,12,0,50,21815,2
100119,Furniture,112.46819305419922,2022-12-15,93,0,129.07131958007812,12003.632720947266,3,12,0,50,21908,2
100119,Furniture,112.46819305419922,2022-12-16,83,75,122.28680282592774,19340.649269104004,4,12,0,50,21991,2
100119,Furniture,112.46819305419922,2022-12-17,75,113,130.40050903320312,24569.23635498047,5,12,1,50,22066,2
100119,Furniture,112.46819305419922,2022-12-18,113,193,131.93179016113282,40424.58457641602,6,12,1,50,22179,2
100119,Furniture,112.46819305419922,2022-12-19,46,0,131.26358032226562,6038.124694824219,0,12,0,51,22225,2
100119,Furniture,112.46819305419922,2022-12-20,25,0,131.26358032226562,3281.5895080566406,1,12,0,51,22250,2
100119,Furniture,112.46819305419922,2022-12-21,111,118,123.1014939880371,28170.771665344237,2,12,0,51,22361,2
100119,Furniture,112.46819305419922,2022-12-22,58,0,125.88298797607422,7301.213302612305,3,12,0,51,22419,2
100119,Furniture,112.46819305419922,2022-12-23,71,74,118.77455841064453,17215.397294311522,4,12,0,51,22490,2
100119,Furniture,112.46819305419922,2022-12-24,46,60,101.31057907104491,10633.353274536134,5,12,1,51,22536,2
100119,Furniture,112.46819305419922,2022-12-25,88,106,108.13892349243164,20975.19053466797,6,12,1,51,22624,2
100119,Furniture,112.46819305419922,2022-12-26,76,127,112.75294342041016,22954.997399902342,0,12,0,52,22700,2
100119,Furniture,112.46819305419922,2022-12-27,37,0,111.45588684082031,4123.867813110352,1,12,0,52,22737,2
100119,Furniture,112.46819305419922,2022-12-28,88,74,121.19099655151368,19571.915393066403,2,12,0,52,22825,2
100119,Furniture,112.46819305419922,2022-12-29,40,63,110.2344125366211,11284.813002929688,3,12,0,52,22865,2
100119,Furniture,112.46819305419922,2022-12-30,73,0,113.24882507324219,8267.16423034668,4,12,0,52,22938,2
100119,Furniture,112.46819305419922,2022-12-31,56,76,114.58914718627929,15132.984484863282,5,12,1,52,22994,2
100119,Furniture,112.46819305419922,2023-01-01,62,84,112.23184555053712,16372.168848266601,6,1,1,52,23056,2
100119,Furniture,112.46819305419922,2023-01-02,45,63,108.3572085571289,11667.168770141601,0,1,0,1,23101,2
100119,Furniture,112.46819305419922,2023-01-03,116,117,114.71487518310548,26730.021042480468,1,1,0,1,23217,2
100119,Furniture,112.46819305419922,2023-01-04,48,0,113.25975036621094,5436.468017578125,2,1,0,1,23265,2
100119,Furniture,112.46819305419922,2023-01-05,60,66,109.03148941040038,13729.258729248046,3,1,0,1,23325,2
100119,Furniture,112.46819305419922,2023-01-06,65,56,91.56672882080079,11147.854746704103,4,1,0,1,23390,2
100119,Furniture,112.46819305419922,2023-01-07,17,50,91.04417434692382,5993.56192779541,5,1,1,1,23407,2
100119,Furniture,112.46819305419922,2023-01-08,70,77,89.59047210693359,13156.986094970704,6,1,1,1,23477,2
100119,Furniture,112.46819305419922,2023-01-09,62,75,97.41011077880859,13377.423736572266,0,1,0,2,23539,2
100119,Furniture,112.46819305419922,2023-01-10,98,118,123.2102229309082,26803.003694458006,1,1,0,2,23637,2
100119,Furniture,112.46819305419922,2023-01-11,92,111,115.42682556152343,23444.05590332031,2,1,0,2,23729,2
100119,Furniture,112.46819305419922,2023-01-12,74,0,114.77365112304688,8493.250183105469,3,1,0,2,23803,2
100119,Furniture,112.46819305419922,2023-01-13,84,94,108.89535430908202,19365.21952392578,4,1,0,2,23887,2
100119,Furniture,112.46819305419922,2023-01-14,78,61,108.06943984985352,15041.192616577147,5,1,1,2,23965,2
100119,Furniture,112.46819305419922,2023-01-15,30,50,99.56131332397462,7880.878799438477,6,1,1,2,23995,2
100119,Furniture,112.46819305419922,2023-01-16,62,65,115.42606552124023,14674.062124633789,0,1,0,3,24057,2
100119,Furniture,112.46819305419922,2023-01-17,100,121,127.95057312011718,28384.58462402344,1,1,0,3,24157,2
100119,Furniture,112.46819305419922,2023-01-18,30,0,122.83114624023438,3684.9343872070312,2,1,0,3,24187,2
100119,Furniture,112.46819305419922,2023-01-19,49,75,110.24314605712891,13546.568313598633,3,1,0,3,24236,2
100119,Furniture,112.46819305419922,2023-01-20,28,0,114.99629211425781,3219.8961791992188,4,1,0,3,24264,2
100119,Furniture,112.46819305419922,2023-01-21,89,136,123.76755508422852,27949.334804992675,5,1,1,3,24353,2
100119,Furniture,112.46819305419922,2023-01-22,70,99,115.24837310791015,19401.912235107422,6,1,1,3,24423,2
100119,Furniture,112.46819305419922,2023-01-23,84,0,117.83674621582031,9898.286682128906,0,1,0,4,24507,2
100119,Furniture,112.46819305419922,2023-01-24,81,104,117.12850173950196,21664.207281799318,1,1,0,4,24588,2
100119,Furniture,112.46819305419922,2023-01-25,63,61,111.58317825317383,13841.600459899902,2,1,0,4,24651,2
100119,Furniture,112.46819305419922,2023-01-26,35,0,114.22635650634766,3997.922477722168,3,1,0,4,24686,2
100119,Furniture,112.46819305419922,2023-01-27,67,131,124.22400558471679,24726.656748352052,4,1,0,4,24753,2
100119,Furniture,112.46819305419922,2023-01-28,73,120,107.20167358398437,20441.214343261716,5,1,1,4,24826,2
100119,Furniture,112.46819305419922,2023-01-29,33,0,112.49334716796875,3712.2804565429688,6,1,1,4,24859,2
100119,Furniture,112.46819305419922,2023-01-30,32,0,112.49334716796875,3599.787109375,0,1,0,5,24891,2
100119,Furniture,112.46819305419922,2023-01-31,14,0,112.49334716796875,1574.9068603515625,1,1,0,5,24905,2
100119,Furniture,112.46819305419922,2023-02-01,46,65,105.92122558593749,11703.27275390625,2,2,0,5,24951,2
100119,Furniture,112.46819305419922,2023-02-02,44,0,108.762451171875,4785.5478515625,3,2,0,5,24995,2
100119,Furniture,112.46819305419922,2023-02-03,24,50,87.34049057006837,6226.323547363281,4,2,0,5,25019,2
100119,Furniture,112.46819305419922,2023-02-04,16,0,96.45098114013672,1543.2156982421875,5,2,1,5,25035,2
100119,Furniture,112.46819305419922,2023-02-05,19,0,96.45098114013672,1832.5686416625977,6,2,1,5,25054,2
100119,Furniture,112.46819305419922,2023-02-06,46,82,90.24229263305665,11487.570922241212,0,2,0,6,25100,2
100119,Furniture,112.46819305419922,2023-02-07,17,0,92.00458526611328,1564.0779495239258,1,2,0,6,25117,2
100119,Furniture,112.46819305419922,2023-02-08,49,53,87.95176895141601,8963.91335723877,2,2,0,6,25166,2
100119,Furniture,112.46819305419922,2023-02-09,64,72,95.4467236328125,12998.060625,3,2,0,6,25230,2
100119,Furniture,112.46819305419922,2023-02-10,18,0,93.283447265625,1679.10205078125,4,2,0,6,25248,2
100119,Furniture,112.46819305419922,2023-02-11,30,50,92.52316162109375,7395.189697265625,5,2,1,6,25278,2
100119,Furniture,112.46819305419922,2023-02-12,28,0,92.8563232421875,2599.97705078125,6,2,1,6,25306,2
100119,Furniture,112.46819305419922,2023-02-13,25,50,86.10142913818359,6388.07145690918,0,2,0,7,25331,2
100119,Furniture,112.46819305419922,2023-02-14,24,0,88.88285827636719,2133.1885986328125,1,2,0,7,25355,2
100119,Furniture,112.46819305419922,2023-02-15,65,75,83.84764694213868,11722.494102478027,2,2,0,7,25420,2
100119,Furniture,112.46819305419922,2023-02-16,36,50,98.877744140625,8587.517578125,3,2,0,7,25456,2
100119,Furniture,112.46819305419922,2023-02-17,38,0,92.87548828125,3529.2685546875,4,2,0,7,25494,2
100119,Furniture,112.46819305419922,2023-02-18,46,61,99.62933410644531,10692.598737792969,5,2,1,7,25540,2
100119,Furniture,112.46819305419922,2023-02-19,8,0,97.47866821289062,779.829345703125,6,2,1,7,25548,2
100119,Furniture,112.46819305419922,2023-02-20,36,56,107.24764480590821,9937.83042602539,0,2,0,8,25584,2
100119,Furniture,112.46819305419922,2023-02-21,22,0,103.6952896118164,2281.296371459961,1,2,0,8,25606,2
100119,Furniture,112.46819305419922,2023-02-22,27,50,97.00173065185547,7410.213455200195,2,2,0,8,25633,2
100119,Furniture,112.46819305419922,2023-02-23,24,50,94.00423965454101,6889.903503417969,3,2,0,8,25657,2
100119,Furniture,112.46819305419922,2023-02-24,40,0,96.55847930908203,3862.3391723632812,4,2,0,8,25697,2
100119,Furniture,112.46819305419922,2023-02-25,16,50,89.00587707519531,5767.76806640625,5,2,1,8,25713,2
100119,Furniture,112.46819305419922,2023-02-26,63,54,97.19765350341797,11349.694341430664,6,2,1,8,25776,2
100119,Furniture,112.46819305419922,2023-02-27,35,0,94.70530700683594,3314.685745239258,0,2,0,9,25811,2
100119,Furniture,112.46819305419922,2023-02-28,60,52,98.42488327026368,11012.58599243164,1,2,0,9,25871,2
100119,Furniture,112.46819305419922,2023-03-01,53,107,112.2606169128418,18124.74539276123,2,3,0,9,25924,2
100119,Furniture,112.46819305419922,2023-03-02,55,89,112.7737548828125,16284.513037109375,3,3,0,9,25979,2
100119,Furniture,112.46819305419922,2023-03-03,79,0,111.447509765625,8804.353271484375,4,3,0,9,26058,2
100119,Furniture,112.46819305419922,2023-03-04,62,104,104.80525650024414,17333.611806030276,5,3,1,9,26120,2
100119,Furniture,112.46819305419922,2023-03-05,104,124,110.83046920776367,25295.937595214844,6,3,1,9,26224,2
100119,Furniture,112.46819305419922,2023-03-06,77,76,109.18289138793946,16705.125273742677,0,3,0,10,26301,2
100119,Furniture,112.46819305419922,2023-03-07,116,117,121.57848205566407,28332.00783691406,1,3,0,10,26417,2
100119,Furniture,112.46819305419922,2023-03-08,124,115,125.09833648681641,29874.09744873047,2,3,0,10,26541,2
100119,Furniture,112.46819305419922,2023-03-09,99,98,124.17041687011718,24460.912540283203,3,3,0,10,26640,2
100119,Furniture,112.46819305419922,2023-03-10,35,0,123.51083374023438,4322.879180908203,4,3,0,10,26675,2
100119,Furniture,112.46819305419922,2023-03-11,76,82,110.58290618896484,17446.881740722656,5,3,1,10,26751,2
100119,Furniture,112.46819305419922,2023-03-12,57,71,110.205205078125,14082.25337890625,6,3,1,10,26808,2
100119,Furniture,112.46819305419922,2023-03-13,50,64,99.35852951049804,11250.172951049804,0,3,0,11,26858,2
100119,Furniture,112.46819305419922,2023-03-14,77,106,116.63718902587891,21463.58710998535,1,3,0,11,26935,2
100119,Furniture,112.46819305419922,2023-03-15,52,0,112.53437805175781,5851.787658691406,2,3,0,11,26987,2
100119,Furniture,112.46819305419922,2023-03-16,62,101,117.50726272583009,19213.46057800293,3,3,0,11,27049,2
100119,Furniture,112.46819305419922,2023-03-17,18,0,115.97452545166016,2087.541458129883,4,3,0,11,27067,2
100119,Furniture,112.46819305419922,2023-03-18,84,75,116.38530090332031,18503.690551757812,5,3,1,11,27151,2
100119,Furniture,112.46819305419922,2023-03-19,75,96,108.19197280883789,18442.405921325684,6,3,1,11,27226,2
100119,Furniture,112.46819305419922,2023-03-20,100,98,125.47766128540039,24833.39225708008,0,3,0,12,27326,2
100119,Furniture,112.46819305419922,2023-03-21,46,0,119.88532257080078,5514.724838256836,1,3,0,12,27372,2
100119,Furniture,112.46819305419922,2023-03-22,75,114,119.11153121948243,22504.609682922364,2,3,0,12,27447,2
100119,Furniture,112.46819305419922,2023-03-23,51,85,106.32821517944336,14283.557948303223,3,3,0,12,27498,2
100119,Furniture,112.46819305419922,2023-03-24,38,0,111.53643035888672,4238.384353637695,4,3,0,12,27536,2
100119,Furniture,112.46819305419922,2023-03-25,84,96,121.84516220092773,21977.187249755858,5,3,1,12,27620,2
100119,Furniture,112.46819305419922,2023-03-26,122,114,122.28711700439453,28848.056549072266,6,3,1,12,27742,2
100119,Furniture,112.46819305419922,2023-03-27,114,113,115.60123901367187,26243.232495117187,0,3,0,13,27856,2
100119,Furniture,112.46819305419922,2023-03-28,53,78,94.54206893920897,12145.459307556152,1,3,0,13,27909,2
100119,Furniture,112.46819305419922,2023-03-29,58,0,104.12413787841797,6039.199996948242,2,3,0,13,27967,2
100119,Furniture,112.46819305419922,2023-03-30,53,50,104.22511840820312,10735.052551269531,3,3,0,13,28020,2
100119,Furniture,112.46819305419922,2023-03-31,66,53,109.89530029296876,13046.279638671875,4,3,0,13,28086,2
100119,Furniture,112.46819305419922,2023-04-01,64,61,110.89767471313476,13858.69236328125,5,4,1,13,28150,2
100119,Furniture,112.46819305419922,2023-04-02,56,66,105.23061492919922,12823.928872070312,6,4,1,13,28206,2
100119,Furniture,112.46819305419922,2023-04-03,48,57,107.81381881713867,11324.466606445312,0,4,0,14,28254,2
100119,Furniture,112.46819305419922,2023-04-04,73,112,121.0970082092285,22543.85319854736,1,4,0,14,28327,2
100119,Furniture,112.46819305419922,2023-04-05,98,91,119.38030380249023,22557.629545288088,2,4,0,14,28425,2
100119,Furniture,112.46819305419922,2023-04-06,112,135,132.78888580322266,32894.33041992188,3,4,0,14,28537,2
100119,Furniture,112.46819305419922,2023-04-07,87,127,114.49734680175781,24306.13834350586,4,4,0,14,28624,2
100119,Furniture,112.46819305419922,2023-04-08,37,0,119.40469360351562,4417.973663330078,5,4,1,14,28661,2
100119,Furniture,112.46819305419922,2023-04-09,83,0,119.40469360351562,9910.589569091797,6,4,1,14,28744,2
100119,Furniture,112.46819305419922,2023-04-10,55,123,130.28238464355468,23325.422310791015,0,4,0,15,28799,2
100119,Furniture,112.46819305419922,2023-04-11,80,135,122.20572891235352,26169.416625976562,1,4,0,15,28879,2
100119,Furniture,112.46819305419922,2023-04-12,23,0,124.11145782470703,2854.5635299682617,2,4,0,15,28902,2
100119,Furniture,112.46819305419922,2023-04-13,19,0,124.11145782470703,2358.1176986694336,3,4,0,15,28921,2
100119,Furniture,112.46819305419922,2023-04-14,21,0,124.11145782470703,2606.3406143188477,4,4,0,15,28942,2
100119,Furniture,112.46819305419922,2023-04-15,48,0,124.11145782470703,5957.3499755859375,5,4,1,15,28990,2
100119,Furniture,112.46819305419922,2023-04-16,27,50,105.39785415649413,7942.954124450684,6,4,1,15,29017,2
100119,Furniture,112.46819305419922,2023-04-17,25,0,112.90570831298828,2822.642707824707,0,4,0,16,29042,2
100119,Furniture,112.46819305419922,2023-04-18,8,50,94.61530883789062,5185.06494140625,1,4,0,16,29050,2
100119,Furniture,112.46819305419922,2023-04-19,30,0,101.82061767578125,3054.6185302734375,2,4,0,16,29080,2
100119,Furniture,112.46819305419922,2023-04-20,30,50,93.3882974243164,7397.697845458984,3,4,0,16,29110,2
100119,Furniture,112.46819305419922,2023-04-21,17,0,97.05659484863281,1649.9621124267578,4,4,0,16,29127,2
100119,Furniture,112.46819305419922,2023-04-22,20,50,87.90664474487305,6031.465789794922,5,4,1,16,29147,2
100119,Furniture,112.46819305419922,2023-04-23,72,72,92.12451049804687,13265.92951171875,6,4,1,16,29219,2
100119,Furniture,112.46819305419922,2023-04-24,32,0,92.05902099609375,2945.888671875,0,4,0,17,29251,2
100119,Furniture,112.46819305419922,2023-04-25,68,53,84.08169326782226,10224.610284423828,1,4,0,17,29319,2
100119,Furniture,112.46819305419922,2023-04-26,63,59,95.65038299560547,11657.948257446289,2,4,0,17,29382,2
100119,Furniture,112.46819305419922,2023-04-27,11,50,87.28626358032227,5244.65779876709,3,4,0,17,29393,2
100119,Furniture,112.46819305419922,2023-04-28,27,0,89.33252716064453,2411.9782333374023,4,4,0,17,29420,2
100119,Furniture,112.46819305419922,2023-04-29,29,50,97.78181411743165,7798.435218811035,5,4,1,17,29449,2
100119,Furniture,112.46819305419922,2023-04-30,33,50,96.8266700744629,8057.410224914551,6,4,1,17,29482,2
100119,Furniture,112.46819305419922,2023-05-01,15,0,95.60334014892578,1434.0501022338867,0,5,0,18,29497,2
100119,Furniture,112.46819305419922,2023-05-02,20,0,95.60334014892578,1912.0668029785156,1,5,0,18,29517,2
100119,Furniture,112.46819305419922,2023-05-03,44,50,101.99970565795898,9604.29409790039,2,5,0,18,29561,2
100119,Furniture,112.46819305419922,2023-05-04,37,50,89.17212661743164,7699.577369689941,3,5,0,18,29598,2
100119,Furniture,112.46819305419922,2023-05-05,26,0,93.66425323486328,2435.2705841064453,4,5,0,18,29624,2
100119,Furniture,112.46819305419922,2023-05-06,40,50,100.49109100341798,9071.587280273438,5,5,1,18,29664,2
100119,Furniture,112.46819305419922,2023-05-07,14,0,97.75218200683594,1368.5305480957031,6,5,1,18,29678,2
100119,Furniture,112.46819305419922,2023-05-08,31,50,81.133263092041,6449.752311706543,0,5,0,19,29709,2
100119,Furniture,112.46819305419922,2023-05-09,59,68,98.28464904785156,12518.468587646483,1,5,0,19,29768,2
100119,Furniture,112.46819305419922,2023-05-10,39,50,83.30452529907227,7356.742973327637,2,5,0,19,29807,2
100119,Furniture,112.46819305419922,2023-05-11,35,0,88.51905059814453,3098.1667709350586,3,5,0,19,29842,2
100119,Furniture,112.46819305419922,2023-05-12,26,50,90.26109741210936,6876.6170654296875,4,5,0,19,29868,2
100119,Furniture,112.46819305419922,2023-05-13,84,121,100.16306427001953,20640.614797363283,5,5,1,19,29952,2
100119,Furniture,112.46819305419922,2023-05-14,53,0,97.26612854003906,5155.10481262207,6,5,1,19,30005,2
100119,Furniture,112.46819305419922,2023-05-15,75,112,117.17590805053712,22096.676207580567,0,5,0,20,30080,2
100119,Furniture,112.46819305419922,2023-05-16,88,101,126.26625396728515,23929.63069824219,1,5,0,20,30168,2
100119,Furniture,112.46819305419922,2023-05-17,125,98,108.05523391723634,24234.968479309082,2,5,0,20,30293,2
100119,Furniture,112.46819305419922,2023-05-18,98,112,110.0774397277832,23102.998186645505,3,5,0,20,30391,2
100119,Furniture,112.46819305419922,2023-05-19,45,61,109.1346990966797,11553.802918701173,4,5,0,20,30436,2
100119,Furniture,112.46819305419922,2023-05-20,51,0,110.03939819335938,5612.009307861328,5,5,1,20,30487,2
100119,Furniture,112.46819305419922,2023-05-21,77,110,108.22134780883789,20221.837562561035,6,5,1,20,30564,2
100119,Furniture,112.46819305419922,2023-05-22,39,0,108.69269561767578,4239.0151290893555,0,5,0,21,30603,2
100119,Furniture,112.46819305419922,2023-05-23,50,65,110.53813049316406,12721.663049316405,1,5,0,21,30653,2
100119,Furniture,112.46819305419922,2023-05-24,72,97,122.2596142578125,20756.884453125,2,5,0,21,30725,2
100119,Furniture,112.46819305419922,2023-05-25,60,68,107.64833786010743,13740.120543212892,3,5,0,21,30785,2
100119,Furniture,112.46819305419922,2023-05-26,93,83,111.88822692871094,19694.910208740235,4,5,0,21,30878,2
100119,Furniture,112.46819305419922,2023-05-27,47,50,105.51073303222657,10224.158905029297,5,5,1,21,30925,2
100119,Furniture,112.46819305419922,2023-05-28,79,82,106.87196899414062,17203.831101074218,6,5,1,21,31004,2
100119,Furniture,112.46819305419922,2023-05-29,68,102,114.70376525878906,19585.192075195315,0,5,0,22,31072,2
100119,Furniture,112.46819305419922,2023-05-30,60,0,112.18753051757812,6731.2518310546875,1,5,0,22,31132,2
100119,Furniture,112.46819305419922,2023-05-31,73,83,108.21610549926757,16867.851402893066,2,5,0,22,31205,2
100119,Furniture,112.46819305419922,2023-06-01,57,50,110.54899002075194,11825.444862365723,3,6,0,22,31262,2
100119,Furniture,112.46819305419922,2023-06-02,89,102,98.94137786865235,18852.805260620116,4,6,0,22,31351,2
100119,Furniture,112.46819305419922,2023-06-03,30,0,102.40275573730469,3072.0826721191406,5,6,1,22,31381,2
100119,Furniture,112.46819305419922,2023-06-04,75,96,119.31840911865234,20503.231367797853,6,6,1,22,31456,2
100119,Furniture,112.46819305419922,2023-06-05,94,96,119.76670455932617,22759.14045715332,0,6,0,23,31550,2
100119,Furniture,112.46819305419922,2023-06-06,69,99,118.90983352661132,19985.557026672366,1,6,0,23,31619,2
100119,Furniture,112.46819305419922,2023-06-07,52,0,118.61966705322266,6168.222686767578,2,6,0,23,31671,2
100119,Furniture,112.46819305419922,2023-06-08,76,69,102.5108790588379,14904.12361694336,3,6,0,23,31747,2
100119,Furniture,112.46819305419922,2023-06-09,67,72,111.41787490844726,15492.245237731935,4,6,0,23,31814,2
100119,Furniture,112.46819305419922,2023-06-10,74,92,114.81080154418945,19081.43862854004,5,6,1,23,31888,2
100119,Furniture,112.46819305419922,2023-06-11,92,118,115.39901824951173,24247.339357910154,6,6,1,23,31980,2
100119,Furniture,112.46819305419922,2023-06-12,37,0,114.87803649902344,4250.487350463867,0,6,0,24,32017,2
100119,Furniture,112.46819305419922,2023-06-13,81,103,116.19758239746093,21388.54834838867,1,6,0,24,32098,2
100119,Furniture,112.46819305419922,2023-06-14,95,83,112.69755935668945,20074.536277770996,2,6,0,24,32193,2
100119,Furniture,112.46819305419922,2023-06-15,65,78,109.30214660644532,15608.20905883789,3,6,0,24,32258,2
100119,Furniture,112.46819305419922,2023-06-16,104,140,109.11026077270508,26604.534240722656,4,6,0,24,32362,2
100119,Furniture,112.46819305419922,2023-06-17,60,0,109.62052154541016,6577.231292724609,5,6,1,24,32422,2
100119,Furniture,112.46819305419922,2023-06-18,62,50,89.41169723510743,10121.89045715332,6,6,1,24,32484,2
100119,Furniture,112.46819305419922,2023-06-19,49,53,92.99120086669922,9476.657684936523,0,6,0,25,32533,2
100119,Furniture,112.46819305419922,2023-06-20,72,71,108.11270248413086,15455.739157714845,1,6,0,25,32605,2
100119,Furniture,112.46819305419922,2023-06-21,71,132,118.07158630371094,24153.875255126954,2,6,0,25,32676,2
100119,Furniture,112.46819305419922,2023-06-22,54,0,115.03317260742188,6211.791320800781,3,6,0,25,32730,2
100119,Furniture,112.46819305419922,2023-06-23,64,80,101.43616317749024,14535.508886718751,4,6,0,25,32794,2
100119,Furniture,112.46819305419922,2023-06-24,56,50,97.04624450683593,10312.619384765625,5,6,1,25,32850,2
100119,Furniture,112.46819305419922,2023-06-25,88,81,97.78774978637696,16534.863962402345,6,6,1,25,32938,2
100119,Furniture,112.46819305419922,2023-06-26,36,50,95.34261581420898,8176.328338623047,0,6,0,26,32974,2
100119,Furniture,112.46819305419922,2023-06-27,82,66,88.17238067626954,13108.590430908203,1,6,0,26,33056,2
100119,Furniture,112.46819305419922,2023-06-28,79,75,103.19969528198243,15877.111854553223,2,6,0,26,33135,2
100119,Furniture,112.46819305419922,2023-06-29,75,98,109.26047302246093,18965.53095336914,3,6,0,26,33210,2
100119,Furniture,112.46819305419922,2023-06-30,98,106,118.53552047729492,24211.682013549806,4,6,0,26,33308,2
100119,Furniture,112.46819305419922,2023-07-01,106,102,125.24492828369141,26036.56479614258,5,7,1,26,33414,2
100119,Furniture,112.46819305419922,2023-07-02,76,79,117.97979309082032,18282.548549804687,6,7,1,26,33490,2
100119,Furniture,112.46819305419922,2023-07-03,105,132,124.65908737182617,29584.458348083495,0,7,0,27,33595,2
100119,Furniture,112.46819305419922,2023-07-04,45,0,123.16817474365234,5542.5678634643555,1,7,0,27,33640,2
100119,Furniture,112.46819305419922,2023-07-05,87,81,120.02738555908203,20171.185087280275,2,7,0,27,33727,2
100119,Furniture,112.46819305419922,2023-07-06,56,73,110.77359298706054,14227.002414550781,3,7,0,27,33783,2
100119,Furniture,112.46819305419922,2023-07-07,36,0,114.4671859741211,4120.818695068359,4,7,0,27,33819,2
100119,Furniture,112.46819305419922,2023-07-08,38,50,104.56118560791015,9155.890106201172,5,7,1,27,33857,2
100119,Furniture,112.46819305419922,2023-07-09,50,58,101.40558776855468,10930.15877685547,6,7,1,27,33907,2
100119,Furniture,112.46819305419922,2023-07-10,82,98,115.73993392944337,20888.06916442871,0,7,0,28,33989,2
100119,Furniture,112.46819305419922,2023-07-11,98,175,128.87612915039062,35462.22131347656,1,7,0,28,34087,2
100119,Furniture,112.46819305419922,2023-07-12,52,0,125.25225830078125,6513.117431640625,2,7,0,28,34139,2
100119,Furniture,112.46819305419922,2023-07-13,81,109,126.44850677490234,24037.298097534178,3,7,0,28,34220,2
100119,Furniture,112.46819305419922,2023-07-14,151,195,151.9748376464844,52902.08096923828,4,7,0,28,34371,2
100119,Furniture,112.46819305419922,2023-07-15,130,0,144.72967529296875,18814.857788085938,5,7,1,28,34501,2
100119,Furniture,112.46819305419922,2023-07-16,65,121,118.7422267150879,21777.929472961427,6,7,1,28,34566,2
100119,Furniture,112.46819305419922,2023-07-17,121,133,121.60519470214844,30877.81711791992,0,7,0,29,34687,2
100119,Furniture,112.46819305419922,2023-07-18,69,0,122.43038940429688,8447.696868896484,1,7,0,29,34756,2
100119,Furniture,112.46819305419922,2023-07-19,50,76,115.04751937866212,14439.111937866212,2,7,0,29,34806,2
100119,Furniture,112.46819305419922,2023-07-20,90,104,131.324725189209,25536.570534057617,3,7,0,29,34896,2
100119,Furniture,112.46819305419922,2023-07-21,104,97,118.64876220703124,23868.9725390625,4,7,0,29,35000,2
100119,Furniture,112.46819305419922,2023-07-22,78,109,123.23322784423829,23060.32354370117,5,7,1,29,35078,2
100119,Furniture,112.46819305419922,2023-07-23,47,0,122.72645568847656,5768.143417358398,6,7,1,29,35125,2
100119,Furniture,112.46819305419922,2023-07-24,59,82,102.7683839416504,14338.579305114747,0,7,0,30,35184,2
100119,Furniture,112.46819305419922,2023-07-25,104,129,128.45584365844726,30067.31548095703,1,7,0,30,35288,2
100119,Furniture,112.46819305419922,2023-07-26,70,77,121.5417903137207,17862.080643920897,2,7,0,30,35358,2
100119,Furniture,112.46819305419922,2023-07-27,136,154,142.4387744140625,41418.866640625,3,7,0,30,35494,2
100119,Furniture,112.46819305419922,2023-07-28,118,111,122.8238897705078,28165.12798583984,4,7,0,30,35612,2
100119,Furniture,112.46819305419922,2023-07-29,127,101,131.10571350097655,29861.571229248046,5,7,1,30,35739,2
100119,Furniture,112.46819305419922,2023-07-30,121,101,127.60973846435547,28346.75670837402,6,7,1,30,35860,2
100119,Furniture,112.46819305419922,2023-07-31,101,86,127.1148602294922,23778.05176635742,0,7,0,31,35961,2
100119,Furniture,112.46819305419922,2023-08-01,51,51,114.13056991577147,11641.31813140869,1,8,0,31,36012,2
100119,Furniture,112.46819305419922,2023-08-02,75,93,113.50787322998048,19030.66098449707,2,8,0,31,36087,2
100119,Furniture,112.46819305419922,2023-08-03,83,82,107.44591033935546,17731.761116333008,3,8,0,31,36170,2
100119,Furniture,112.46819305419922,2023-08-04,64,50,107.9571159362793,12326.11083984375,4,8,0,31,36234,2
100119,Furniture,112.46819305419922,2023-08-05,89,108,113.80854278564453,22445.200615844726,5,8,1,31,36323,2
100119,Furniture,112.46819305419922,2023-08-06,32,0,112.49708557128906,3599.90673828125,6,8,1,31,36355,2
100119,Furniture,112.46819305419922,2023-08-07,76,83,124.84282623291016,19877.149587402346,0,8,0,32,36431,2
100119,Furniture,112.46819305419922,2023-08-08,26,0,120.96565246582031,3145.106964111328,1,8,0,32,36457,2
100119,Furniture,112.46819305419922,2023-08-09,54,58,107.18909759521485,11987.022540283204,2,8,0,32,36511,2
100119,Furniture,112.46819305419922,2023-08-10,33,50,89.36356002807617,7273.124961853027,3,8,0,32,36544,2
100119,Furniture,112.46819305419922,2023-08-11,77,93,110.74601104736328,18887.845701293947,4,8,0,32,36621,2
100119,Furniture,112.46819305419922,2023-08-12,41,0,106.93202209472656,4384.212905883789,5,8,1,32,36662,2
100119,Furniture,112.46819305419922,2023-08-13,53,65,109.90032470703125,12978.554418945314,6,8,1,32,36715,2
100119,Furniture,112.46819305419922,2023-08-14,65,125,101.38892868041992,19169.16072845459,0,8,0,33,36780,2
100119,Furniture,112.46819305419922,2023-08-15,106,78,105.68244201660156,19411.75770751953,1,8,0,33,36886,2
100119,Furniture,112.46819305419922,2023-08-16,37,50,103.35929992675781,8985.118194580078,2,8,0,33,36923,2
100119,Furniture,112.46819305419922,2023-08-17,26,0,103.90859985351562,2701.6235961914062,3,8,0,33,36949,2
100119,Furniture,112.46819305419922,2023-08-18,71,86,110.01600433349608,17302.572615356446,4,8,0,33,37020,2
100119,Furniture,112.46819305419922,2023-08-19,88,95,105.00133834838867,19208.025549316408,5,8,1,33,37108,2
100119,Furniture,112.46819305419922,2023-08-20,32,0,106.03267669677734,3393.045654296875,6,8,1,33,37140,2
100119,Furniture,112.46819305419922,2023-08-21,74,83,105.64846481323242,16585.742792358396,0,8,0,34,37214,2
100119,Furniture,112.46819305419922,2023-08-22,80,108,98.09865127563477,18382.944204101565,1,8,0,34,37294,2
100119,Furniture,112.46819305419922,2023-08-23,35,0,100.22730255126953,3507.9555892944336,2,8,0,34,37329,2
100119,Furniture,112.46819305419922,2023-08-24,76,86,117.76541549682617,19131.74315551758,3,8,0,34,37405,2
100119,Furniture,112.46819305419922,2023-08-25,52,55,109.04713348388671,11663.641882324218,4,8,0,34,37457,2
100119,Furniture,112.46819305419922,2023-08-26,89,89,99.50856582641602,17712.524717102053,5,8,1,34,37546,2
100119,Furniture,112.46819305419922,2023-08-27,70,109,123.02581848144531,22246.034587402344,6,8,1,34,37616,2
100119,Furniture,112.46819305419922,2023-08-28,62,0,117.27163696289062,7270.841491699219,0,8,0,35,37678,2
100119,Furniture,112.46819305419922,2023-08-29,66,93,120.51939636230469,19185.55031982422,1,8,0,35,37744,2
100119,Furniture,112.46819305419922,2023-08-30,93,102,114.61309494018555,22335.30565887451,2,8,0,35,37837,2
100119,Furniture,112.46819305419922,2023-08-31,92,81,119.4087745666504,20644.064520263673,3,8,0,35,37929,2
100119,Furniture,112.46819305419922,2023-09-01,48,74,96.3623860168457,11540.349057617188,4,9,0,35,37977,2
100119,Furniture,112.46819305419922,2023-09-02,57,0,104.6647720336914,5965.89200592041,5,9,1,35,38034,2
100119,Furniture,112.46819305419922,2023-09-03,49,66,104.93542266845702,12069.011421508789,6,9,1,35,38083,2
100119,Furniture,112.46819305419922,2023-09-04,77,83,103.50611022949218,16558.420975341796,0,9,0,36,38160,2
100119,Furniture,112.46819305419922,2023-09-05,83,77,117.8617335510254,18828.607769470214,1,9,0,36,38243,2
100119,Furniture,112.46819305419922,2023-09-06,73,94,122.10856140136718,20447.80996459961,2,9,0,36,38316,2
100119,Furniture,112.46819305419922,2023-09-07,82,95,115.68393249511719,20459.36492919922,3,9,0,36,38398,2
100119,Furniture,112.46819305419922,2023-09-08,54,68,113.54721725463867,13831.239463500977,4,9,0,36,38452,2
100119,Furniture,112.46819305419922,2023-09-09,33,0,115.08443450927734,3797.7863388061523,5,9,1,36,38485,2
100119,Furniture,112.46819305419922,2023-09-10,59,55,104.58975341796875,11942.350903320312,6,9,1,36,38544,2
100119,Furniture,112.46819305419922,2023-09-11,65,106,117.93689880371093,20270.246844482423,0,9,0,37,38609,2
100119,Furniture,112.46819305419922,2023-09-12,108,119,126.17941711425782,28684.31409667969,1,9,0,37,38717,2
100119,Furniture,112.46819305419922,2023-09-13,36,0,122.39883422851562,4406.3580322265625,2,9,0,37,38753,2
100119,Furniture,112.46819305419922,2023-09-14,96,163,112.85763778686524,29075.516455078123,3,9,0,37,38849,2
100119,Furniture,112.46819305419922,2023-09-15,32,0,115.16527557373047,3685.288818359375,4,9,0,37,38881,2
100119,Furniture,112.46819305419922,2023-09-16,121,126,123.65272232055665,30557.308801574705,5,9,1,37,39002,2
100119,Furniture,112.46819305419922,2023-09-17,73,0,120.63544464111328,8806.38745880127,6,9,1,37,39075,2
100119,Furniture,112.46819305419922,2023-09-18,68,65,112.04458129882812,14911.033056640626,0,9,0,38,39143,2
100119,Furniture,112.46819305419922,2023-09-19,68,64,110.27629821777344,14563.136557617188,1,9,0,38,39211,2
100119,Furniture,112.46819305419922,2023-09-20,42,50,88.00248153686523,8021.48844909668,2,9,0,38,39253,2
100119,Furniture,112.46819305419922,2023-09-21,53,64,105.0692527770996,12323.690794372558,3,9,0,38,39306,2
100119,Furniture,112.46819305419922,2023-09-22,83,126,107.85968124389649,22602.027086486814,4,9,0,38,39389,2
100119,Furniture,112.46819305419922,2023-09-23,62,84,97.56181060791016,14159.94451538086,5,9,1,38,39451,2
100119,Furniture,112.46819305419922,2023-09-24,32,0,101.38362121582031,3244.27587890625,6,9,1,38,39483,2
100119,Furniture,112.46819305419922,2023-09-25,66,60,99.08823822021483,12491.887445068358,0,9,0,39,39549,2
100119,Furniture,112.46819305419922,2023-09-26,54,76,112.69213088989258,14765.210136108399,1,9,0,39,39603,2
100119,Furniture,112.46819305419922,2023-09-27,18,0,107.45426177978516,1934.1767120361328,2,9,0,39,39621,2
100119,Furniture,112.46819305419922,2023-09-28,107,113,102.59820877075195,22561.83667694092,3,9,0,39,39728,2
100119,Furniture,112.46819305419922,2023-09-29,81,80,109.6959262084961,17658.700045776368,4,9,0,39,39809,2
100119,Furniture,112.46819305419922,2023-09-30,78,57,109.08488784790039,14707.872504272462,5,9,1,39,39887,2
100119,Furniture,112.46819305419922,2023-10-01,83,100,106.14554916381836,19413.151161193848,6,10,1,39,39970,2
100119,Furniture,112.46819305419922,2023-10-02,77,87,114.20984191894532,18759.81565551758,0,10,0,40,40047,2
100119,Furniture,112.46819305419922,2023-10-03,108,127,127.64813461303712,30099.947076416018,1,10,0,40,40155,2
100119,Furniture,112.46819305419922,2023-10-04,116,107,126.870126953125,28275.299453125,2,10,0,40,40271,2
100119,Furniture,112.46819305419922,2023-10-05,88,0,125.01025390625,11000.90234375,3,10,0,40,40359,2
100119,Furniture,112.46819305419922,2023-10-06,47,80,117.69170059204102,14892.009855651855,4,10,0,40,40406,2
100119,Furniture,112.46819305419922,2023-10-07,23,50,90.25335327148437,6239.294250488281,5,10,1,40,40429,2
100119,Furniture,112.46819305419922,2023-10-08,27,0,103.18670654296875,2786.0410766601562,6,10,1,40,40456,2
100119,Furniture,112.46819305419922,2023-10-09,39,50,91.91129608154297,8124.981094360352,0,10,0,41,40495,2
100119,Furniture,112.46819305419922,2023-10-10,20,0,96.92259216308594,1938.4518432617188,1,10,0,41,40515,2
100119,Furniture,112.46819305419922,2023-10-11,39,50,93.57142242431641,8312.55094909668,2,10,0,41,40554,2
100119,Furniture,112.46819305419922,2023-10-12,30,50,90.94171661376953,7239.102996826172,3,10,0,41,40584,2
100119,Furniture,112.46819305419922,2023-10-13,15,0,92.75343322753906,1391.301498413086,4,10,0,41,40599,2
100119,Furniture,112.46819305419922,2023-10-14,33,54,91.75531509399414,7973.360796203613,5,10,1,41,40632,2
100119,Furniture,112.46819305419922,2023-10-15,35,0,92.20063018798828,3227.02205657959,6,10,1,41,40667,2
100119,Furniture,112.46819305419922,2023-10-16,22,0,92.20063018798828,2028.4138641357422,0,10,0,42,40689,2
100119,Furniture,112.46819305419922,2023-10-17,19,50,82.36273147583009,5580.023796081543,1,10,0,42,40708,2
100119,Furniture,112.46819305419922,2023-10-18,51,50,89.38374176025391,9026.091659545898,2,10,0,42,40759,2
100119,Furniture,112.46819305419922,2023-10-19,48,56,93.6994366455078,9764.825917968748,3,10,0,42,40807,2
100119,Furniture,112.46819305419922,2023-10-20,41,50,91.67233581542969,8344.231536865234,4,10,0,42,40848,2
100119,Furniture,112.46819305419922,2023-10-21,48,54,91.46183334350586,9329.156000976564,5,10,1,42,40896,2
100119,Furniture,112.46819305419922,2023-10-22,15,0,91.45366668701172,1371.8050003051758,6,10,1,42,40911,2
100119,Furniture,112.46819305419922,2023-10-23,40,50,98.02538162231446,8853.230529785156,0,10,0,43,40951,2
100119,Furniture,112.46819305419922,2023-10-24,19,0,94.9307632446289,1803.6845016479492,1,10,0,43,40970,2
100119,Furniture,112.46819305419922,2023-10-25,73,75,104.08567977905273,15411.0492477417,2,10,0,43,41043,2
100119,Furniture,112.46819305419922,2023-10-26,82,100,104.68096603393555,19071.71842956543,3,10,0,43,41125,2
100119,Furniture,112.46819305419922,2023-10-27,82,79,103.32830642700196,16636.15225402832,4,10,0,43,41207,2
100119,Furniture,112.46819305419922,2023-10-28,90,137,117.2308139038086,26781.02650268555,5,10,1,43,41297,2
100119,Furniture,112.46819305419922,2023-10-29,84,0,113.62162780761719,9544.216735839844,6,10,1,43,41381,2
100119,Furniture,112.46819305419922,2023-10-30,60,63,101.84039642333985,12514.967570800782,0,10,0,44,41441,2
100119,Furniture,112.46819305419922,2023-10-31,43,50,101.22623992919921,9402.096633911133,1,10,0,44,41484,2
100119,Furniture,112.46819305419922,2023-11-01,70,103,116.18807449340821,20211.48042907715,2,11,0,44,41554,2
100119,Furniture,112.46819305419922,2023-11-02,103,133,104.22176376342773,24524.28333526611,3,11,0,44,41657,2
100119,Furniture,112.46819305419922,2023-11-03,46,0,106.62352752685547,4904.682266235352,4,11,0,44,41703,2
100119,Furniture,112.46819305419922,2023-11-04,43,75,89.36529983520508,10342.375785827637,5,11,1,44,41746,2
100119,Furniture,112.46819305419922,2023-11-05,72,114,112.73740676879882,21214.54657470703,6,11,1,44,41818,2
100119,Furniture,112.46819305419922,2023-11-06,62,0,106.89481353759766,6627.478439331055,0,11,0,45,41880,2
100119,Furniture,112.46819305419922,2023-11-07,82,90,114.79626159667968,19767.38690185547,1,11,0,45,41962,2
100119,Furniture,112.46819305419922,2023-11-08,66,82,107.1370881652832,15825.615637817382,2,11,0,45,42028,2
100119,Furniture,112.46819305419922,2023-11-09,16,0,109.0541763305664,1744.8668212890625,3,11,0,45,42044,2
100119,Furniture,112.46819305419922,2023-11-10,90,77,101.7318670654297,17028.246071777343,4,11,0,45,42134,2
100119,Furniture,112.46819305419922,2023-11-11,34,50,97.54378631591797,8137.937469482422,5,11,1,45,42168,2
100119,Furniture,112.46819305419922,2023-11-12,77,58,103.98872741699219,14011.094022216797,6,11,1,45,42245,2
100119,Furniture,112.46819305419922,2023-11-13,91,115,117.99172073364258,24411.373173522952,0,11,0,46,42336,2
100119,Furniture,112.46819305419922,2023-11-14,68,82,110.40321258544921,16541.95691162109,1,11,0,46,42404,2
100119,Furniture,112.46819305419922,2023-11-15,79,0,111.72642517089844,8826.387588500977,2,11,0,46,42483,2
100119,Furniture,112.46819305419922,2023-11-16,18,50,102.8266064453125,6897.27783203125,3,11,0,46,42501,2
100119,Furniture,112.46819305419922,2023-11-17,59,63,109.17628753662109,13324.84192932129,4,11,0,46,42560,2
100119,Furniture,112.46819305419922,2023-11-18,63,73,101.08497146606445,13722.506404724121,5,11,1,46,42623,2
100119,Furniture,112.46819305419922,2023-11-19,48,74,112.46727798461913,13811.818686523437,6,11,1,46,42671,2
100119,Furniture,112.46819305419922,2023-11-20,57,92,111.13045608520508,16588.52199371338,0,11,0,47,42728,2
100119,Furniture,112.46819305419922,2023-11-21,52,0,110.27091217041016,5734.087432861328,1,11,0,47,42780,2
100119,Furniture,112.46819305419922,2023-11-22,105,153,120.28233520507813,31155.610393066407,2,11,0,47,42885,2
100119,Furniture,112.46819305419922,2023-11-23,45,0,117.72467041015625,5297.610168457031,3,11,0,47,42930,2
100119,Furniture,112.46819305419922,2023-11-24,45,66,114.30765701293944,12655.85913116455,4,11,0,47,42975,2
100119,Furniture,112.46819305419922,2023-11-25,20,0,115.8453140258789,2316.906280517578,5,11,1,47,42995,2
100119,Furniture,112.46819305419922,2023-11-26,109,149,118.69643066406249,30654.221884765626,6,11,1,47,43104,2
100119,Furniture,112.46819305419922,2023-11-27,149,187,125.37871551513672,42207.85722351074,0,11,0,48,43253,2
100119,Furniture,112.46819305419922,2023-11-28,40,0,123.25743103027344,4930.2972412109375,1,11,0,48,43293,2
100119,Furniture,112.46819305419922,2023-11-29,105,132,129.5495361328125,30764.002587890627,2,11,0,48,43398,2
100119,Furniture,112.46819305419922,2023-11-30,50,0,127.299072265625,6364.95361328125,3,11,0,48,43448,2
100119,Furniture,112.46819305419922,2023-12-01,93,88,126.30916137695313,22864.004016113282,4,12,0,48,43541,2
100119,Furniture,112.46819305419922,2023-12-02,119,95,121.04490631103516,25956.047702026368,5,12,1,48,43660,2
100119,Furniture,112.46819305419922,2023-12-03,95,180,130.71678985595702,36079.99007263184,6,12,1,48,43755,2
100119,Furniture,112.46819305419922,2023-12-04,69,0,129.15357971191406,8911.59700012207,0,12,0,49,43824,2
100119,Furniture,112.46819305419922,2023-12-05,84,85,116.41282409667969,19668.734448242187,1,12,0,49,43908,2
100119,Furniture,112.46819305419922,2023-12-06,104,105,115.92145919799805,24225.663513183594,2,12,0,49,44012,2
100119,Furniture,112.46819305419922,2023-12-07,93,93,123.77725769042968,23022.569930419922,3,12,0,49,44105,2
100119,Furniture,112.46819305419922,2023-12-08,59,81,110.38956192016602,15353.78830657959,4,12,0,49,44164,2
100119,Furniture,112.46819305419922,2023-12-09,71,0,114.96912384033203,8162.807792663574,5,12,1,49,44235,2
100119,Furniture,112.46819305419922,2023-12-10,64,100,114.02007247924806,18691.00927734375,6,12,1,49,44299,2
100119,Furniture,112.46819305419922,2023-12-11,39,0,114.2501449584961,4455.755653381348,0,12,0,50,44338,2
100119,Furniture,112.46819305419922,2023-12-12,61,118,105.59720245361328,18800.59869934082,1,12,0,50,44399,2
100119,Furniture,112.46819305419922,2023-12-13,118,138,124.41613174438477,31952.607091674807,2,12,0,50,44517,2
100119,Furniture,112.46819305419922,2023-12-14,46,0,119.31226348876953,5488.364120483398,3,12,0,50,44563,2
100119,Furniture,112.46819305419922,2023-12-15,77,77,112.81126541137695,17372.934873352053,4,12,0,50,44640,2
100119,Furniture,112.46819305419922,2023-12-16,45,50,100.83406051635743,9544.715446472168,5,12,1,50,44685,2
100119,Furniture,112.46819305419922,2023-12-17,76,60,96.57843200683594,13214.481665039064,6,12,1,50,44761,2
100119,Furniture,112.46819305419922,2023-12-18,81,113,107.35328811645508,20875.39267486572,0,12,0,51,44842,2
100119,Furniture,112.46819305419922,2023-12-19,96,90,125.4080891418457,23280.593115234376,1,12,0,51,44938,2
100119,Furniture,112.46819305419922,2023-12-20,48,62,114.82435317993165,12611.017905273438,2,12,0,51,44986,2
100119,Furniture,112.46819305419922,2023-12-21,82,104,109.02820724487304,20220.98598815918,3,12,0,51,45068,2
100119,Furniture,112.46819305419922,2023-12-22,20,0,111.6764144897461,2233.528289794922,4,12,0,51,45088,2
100119,Furniture,112.46819305419922,2023-12-23,115,88,106.29411987304687,21637.487570800782,5,12,1,51,45203,2
100119,Furniture,112.46819305419922,2023-12-24,73,80,107.73133728027344,16480.855242919923,6,12,1,51,45276,2
100119,Furniture,112.46819305419922,2023-12-25,89,84,115.68699340820312,19999.284826660158,0,12,0,52,45365,2
100119,Furniture,112.46819305419922,2023-12-26,61,50,111.97530654907226,12433.607398986816,1,12,0,52,45426,2
100119,Furniture,112.46819305419922,2023-12-27,50,50,98.03125350952149,9803.125350952148,2,12,0,52,45476,2
100119,Furniture,112.46819305419922,2023-12-28,22,0,104.70250701904297,2303.4551544189453,3,12,0,52,45498,2
100119,Furniture,112.46819305419922,2023-12-29,17,50,96.98157760620117,6397.39363861084,4,12,0,52,45515,2
100119,Furniture,112.46819305419922,2023-12-30,44,50,98.28854354858399,9233.97183227539,5,12,1,52,45559,2
100119,Furniture,112.46819305419922,2023-12-31,49,0,99.14708709716797,4858.2072677612305,6,12,1,52,45608,2
100119,Furniture,112.46819305419922,2024-01-01,6,50,92.21852386474609,5056.062286376953,0,1,0,1,45614,2
100119,Furniture,112.46819305419922,2024-01-02,36,0,94.67704772949219,3408.3737182617188,1,1,0,1,45650,2
100119,Furniture,112.46819305419922,2024-01-03,21,50,91.02249496459962,6421.634788513184,2,1,0,1,45671,2
100119,Furniture,112.46819305419922,2024-01-04,37,50,89.71386917114258,7788.156318664551,3,1,0,1,45708,2
100119,Furniture,112.46819305419922,2024-01-05,25,0,91.01773834228516,2275.443458557129,4,1,0,1,45733,2
100119,Furniture,112.46819305419922,2024-01-06,25,50,96.52315078735352,7300.407539367676,5,1,1,1,45758,2
100119,Furniture,112.46819305419922,2024-01-07,30,0,94.07630157470703,2822.289047241211,6,1,1,1,45788,2
100119,Furniture,112.46819305419922,2024-01-08,22,50,88.78688980102538,6329.183151245117,0,1,0,2,45810,2
100119,Furniture,112.46819305419922,2024-01-09,34,51,92.00305007934571,7828.367405395508,1,1,0,2,45844,2
100119,Furniture,112.46819305419922,2024-01-10,22,0,91.5261001586914,2013.574203491211,2,1,0,2,45866,2
100119,Furniture,112.46819305419922,2024-01-11,65,61,97.19483505249023,12236.44855682373,3,1,0,2,45931,2
100119,Furniture,112.46819305419922,2024-01-12,94,120,118.6898323059082,25575.388473510742,4,1,0,2,46025,2
100119,Furniture,112.46819305419922,2024-01-13,109,138,105.46806228637695,25993.827578430177,5,1,1,2,46134,2
100119,Furniture,112.46819305419922,2024-01-14,53,0,107.4261245727539,5693.584602355957,6,1,1,2,46187,2
100119,Furniture,112.46819305419922,2024-01-15,37,0,107.4261245727539,3974.7666091918945,0,1,0,3,46224,2
100119,Furniture,112.46819305419922,2024-01-16,55,56,97.48870208740234,10817.817229614258,1,1,0,3,46279,2
100119,Furniture,112.46819305419922,2024-01-17,60,102,114.14396209716797,18617.57545166016,2,1,0,3,46339,2
100119,Furniture,112.46819305419922,2024-01-18,99,81,100.18991134643554,18110.322446594237,3,1,0,3,46438,2
100119,Furniture,112.46819305419922,2024-01-19,58,57,101.73782043457031,11700.987170410157,4,1,0,3,46496,2
100119,Furniture,112.46819305419922,2024-01-20,76,81,109.59398895263672,17217.636320800782,5,1,1,3,46572,2
100119,Furniture,112.46819305419922,2024-01-21,72,74,100.19574691772462,14623.267556152343,6,1,1,3,46644,2
100119,Furniture,112.46819305419922,2024-01-22,85,66,97.09408462524414,14705.554386291504,0,1,0,4,46729,2
100119,Furniture,112.46819305419922,2024-01-23,39,61,99.1590168762207,9913.723316345215,1,1,0,4,46768,2
100119,Furniture,112.46819305419922,2024-01-24,93,150,106.59400466918945,26001.29486846924,2,1,0,4,46861,2
100119,Furniture,112.46819305419922,2024-01-25,116,112,108.39244583129883,24707.80743286133,3,1,0,4,46977,2
100119,Furniture,112.46819305419922,2024-01-26,146,130,118.57024490356446,32658.671511840817,4,1,0,4,47123,2
100119,Furniture,112.46819305419922,2024-01-27,87,71,118.04035629272461,18622.54199493408,5,1,1,4,47210,2
100119,Furniture,112.46819305419922,2024-01-28,88,71,111.50540786743164,17765.66178466797,6,1,1,4,47298,2
100119,Furniture,112.46819305419922,2024-01-29,82,95,127.1456494140625,22564.11650390625,0,1,0,5,47380,2
100119,Furniture,112.46819305419922,2024-01-30,54,71,104.63409652709962,12946.082424926757,1,1,0,5,47434,2
100120,Furniture,114.78251647949219,2022-01-01,36,266,100.47000061035156,30341.940043945313,5,1,1,52,36,2
100120,Furniture,114.78251647949219,2022-01-02,93,432,116.49991088867188,62304.91342529297,6,1,1,52,129,2
100120,Furniture,114.78251647949219,2022-01-03,85,0,113.12982177734375,9616.034851074219,0,1,0,1,214,2
100120,Furniture,114.78251647949219,2022-01-04,52,424,123.38400619506837,60116.85664428711,1,1,0,1,266,2
100120,Furniture,114.78251647949219,2022-01-06,157,0,119.65801239013672,18786.307945251465,3,1,0,1,423,2
100120,Furniture,114.78251647949219,2022-01-07,111,0,119.65801239013672,13282.039375305176,4,1,0,1,534,2
100120,Furniture,114.78251647949219,2022-01-08,81,0,119.65801239013672,9692.299003601074,5,1,1,1,615,2
100120,Furniture,114.78251647949219,2022-01-09,217,786,129.3391014099121,131070.47001190185,6,1,1,1,832,2
100120,Furniture,114.78251647949219,2022-01-10,22,0,126.97820281982422,2793.520462036133,0,1,0,2,854,2
100120,Furniture,114.78251647949219,2022-01-11,101,0,126.97820281982422,12824.798484802246,1,1,0,2,955,2
100120,Furniture,114.78251647949219,2022-01-12,44,0,126.97820281982422,5587.040924072266,2,1,0,2,999,2
100120,Furniture,114.78251647949219,2022-01-13,126,0,126.97820281982422,15999.253555297852,3,1,0,2,1125,2
100120,Furniture,114.78251647949219,2022-01-14,34,0,126.97820281982422,4317.258895874023,4,1,0,2,1159,2
100120,Furniture,114.78251647949219,2022-01-15,97,0,126.97820281982422,12316.88567352295,5,1,1,2,1256,2
100120,Furniture,114.78251647949219,2022-01-16,90,0,126.97820281982422,11428.03825378418,6,1,1,2,1346,2
100120,Furniture,114.78251647949219,2022-01-17,68,0,126.97820281982422,8634.517791748047,0,1,0,3,1414,2
100120,Furniture,114.78251647949219,2022-01-18,56,0,126.97820281982422,7110.779357910156,1,1,0,3,1470,2
100120,Furniture,114.78251647949219,2022-01-19,124,446,128.47655807495119,73390.52640258789,2,1,0,3,1594,2
100120,Furniture,114.78251647949219,2022-01-20,80,0,127.98311614990234,10238.649291992188,3,1,0,3,1674,2
100120,Furniture,114.78251647949219,2022-01-21,37,0,127.98311614990234,4735.375297546387,4,1,0,3,1711,2
100120,Furniture,114.78251647949219,2022-01-22,87,0,127.98311614990234,11134.531105041504,5,1,1,3,1798,2
100120,Furniture,114.78251647949219,2022-01-23,44,0,127.98311614990234,5631.257110595703,6,1,1,3,1842,2
100120,Furniture,114.78251647949219,2022-01-24,79,0,127.98311614990234,10110.666175842285,0,1,0,4,1921,2
100120,Furniture,114.78251647949219,2022-01-25,34,0,127.98311614990234,4351.42594909668,1,1,0,4,1955,2
100120,Furniture,114.78251647949219,2022-01-26,98,0,127.98311614990234,12542.34538269043,2,1,0,4,2053,2
100120,Furniture,114.78251647949219,2022-01-27,90,336,125.72007537841796,53384.533568115236,3,1,0,4,2143,2
100120,Furniture,114.78251647949219,2022-01-28,84,0,126.42015075683594,10619.292663574219,4,1,0,4,2227,2
100120,Furniture,114.78251647949219,2022-01-29,97,0,126.42015075683594,12262.754623413086,5,1,1,4,2324,2
100120,Furniture,114.78251647949219,2022-01-30,30,283,121.90364593505859,37707.10875610352,6,1,1,4,2354,2
100120,Furniture,114.78251647949219,2022-01-31,44,0,123.67729187011719,5441.800842285156,0,1,0,5,2398,2
100120,Furniture,114.78251647949219,2022-02-01,46,0,123.67729187011719,5689.155426025391,1,2,0,5,2444,2
100120,Furniture,114.78251647949219,2022-02-02,58,0,123.67729187011719,7173.282928466797,2,2,0,5,2502,2
100120,Furniture,114.78251647949219,2022-02-03,115,570,130.9760891723633,90689.55050964357,3,2,0,5,2617,2
100120,Furniture,114.78251647949219,2022-02-04,93,0,128.84217834472656,11982.32258605957,4,2,0,5,2710,2
100120,Furniture,114.78251647949219,2022-02-05,60,0,128.84217834472656,7730.530700683594,5,2,1,5,2770,2
100120,Furniture,114.78251647949219,2022-02-06,111,0,128.84217834472656,14301.481796264648,6,2,1,5,2881,2
100120,Furniture,114.78251647949219,2022-02-07,39,0,128.84217834472656,5024.844955444336,0,2,0,6,2920,2
100120,Furniture,114.78251647949219,2022-02-08,76,0,128.84217834472656,9792.005554199219,1,2,0,6,2996,2
100120,Furniture,114.78251647949219,2022-02-09,73,0,128.84217834472656,9405.479019165039,2,2,0,6,3069,2
100120,Furniture,114.78251647949219,2022-02-10,69,505,107.0201171875,58390.576171875,3,2,0,6,3138,2
100120,Furniture,114.78251647949219,2022-02-11,90,0,113.990234375,10259.12109375,4,2,0,6,3228,2
100120,Furniture,114.78251647949219,2022-02-12,119,0,113.990234375,13564.837890625,5,2,1,6,3347,2
100120,Furniture,114.78251647949219,2022-02-13,76,0,113.990234375,8663.2578125,6,2,1,6,3423,2
100120,Furniture,114.78251647949219,2022-02-14,63,0,113.990234375,7181.384765625,0,2,0,7,3486,2
100120,Furniture,114.78251647949219,2022-02-15,62,0,113.990234375,7067.39453125,1,2,0,7,3548,2
100120,Furniture,114.78251647949219,2022-02-16,69,0,113.990234375,7865.326171875,2,2,0,7,3617,2
100120,Furniture,114.78251647949219,2022-02-17,63,0,113.990234375,7181.384765625,3,2,0,7,3680,2
100120,Furniture,114.78251647949219,2022-02-18,89,444,121.76271392822267,65707.96307922364,4,2,0,7,3769,2
100120,Furniture,114.78251647949219,2022-02-19,71,0,119.48542785644531,8483.465377807617,5,2,1,7,3840,2
100120,Furniture,114.78251647949219,2022-02-20,79,0,119.48542785644531,9439.34880065918,6,2,1,7,3919,2
100120,Furniture,114.78251647949219,2022-02-21,57,0,119.48542785644531,6810.669387817383,0,2,0,8,3976,2
100120,Furniture,114.78251647949219,2022-02-22,73,0,119.48542785644531,8722.436233520508,1,2,0,8,4049,2
100120,Furniture,114.78251647949219,2022-02-23,83,0,119.48542785644531,9917.290512084961,2,2,0,8,4132,2
100120,Furniture,114.78251647949219,2022-02-24,110,332,111.86799880981445,48851.13973815918,3,2,0,8,4242,2
100120,Furniture,114.78251647949219,2022-02-25,114,0,114.5459976196289,13058.243728637695,4,2,0,8,4356,2
100120,Furniture,114.78251647949219,2022-02-26,98,479,122.4093295288086,71613.41858764648,5,2,1,8,4454,2
100120,Furniture,114.78251647949219,2022-02-27,38,0,119.82865905761719,4553.489044189453,6,2,1,8,4492,2
100120,Furniture,114.78251647949219,2022-02-28,76,0,119.82865905761719,9106.978088378906,0,2,0,9,4568,2
100120,Furniture,114.78251647949219,2022-03-01,59,0,119.82865905761719,7069.890884399414,1,3,0,9,4627,2
100120,Furniture,114.78251647949219,2022-03-02,108,0,119.82865905761719,12941.495178222656,2,3,0,9,4735,2
100120,Furniture,114.78251647949219,2022-03-03,101,0,119.82865905761719,12102.694564819336,3,3,0,9,4836,2
100120,Furniture,114.78251647949219,2022-03-04,124,580,122.68899429321289,86747.4305847168,4,3,0,9,4960,2
100120,Furniture,114.78251647949219,2022-03-05,94,0,121.86798858642578,11455.590927124023,5,3,1,9,5054,2
100120,Furniture,114.78251647949219,2022-03-06,74,0,121.86798858642578,9018.231155395508,6,3,1,9,5128,2
100120,Furniture,114.78251647949219,2022-03-07,98,0,121.86798858642578,11943.062881469727,0,3,0,10,5226,2
100120,Furniture,114.78251647949219,2022-03-08,69,0,121.86798858642578,8408.891212463379,1,3,0,10,5295,2
100120,Furniture,114.78251647949219,2022-03-09,56,0,121.86798858642578,6824.607360839844,2,3,0,10,5351,2
100120,Furniture,114.78251647949219,2022-03-10,54,0,121.86798858642578,6580.871383666992,3,3,0,10,5405,2
100120,Furniture,114.78251647949219,2022-03-11,30,0,121.86798858642578,3656.0396575927734,4,3,0,10,5435,2
100120,Furniture,114.78251647949219,2022-03-12,58,0,121.86798858642578,7068.343338012695,5,3,1,10,5493,2
100120,Furniture,114.78251647949219,2022-03-13,144,536,132.74773712158202,91406.14829101563,6,3,1,10,5637,2
100120,Furniture,114.78251647949219,2022-03-14,51,0,129.84547424316406,6622.119186401367,0,3,0,11,5688,2
100120,Furniture,114.78251647949219,2022-03-15,133,0,129.84547424316406,17269.44807434082,1,3,0,11,5821,2
100120,Furniture,114.78251647949219,2022-03-16,52,0,129.84547424316406,6751.964660644531,2,3,0,11,5873,2
100120,Furniture,114.78251647949219,2022-03-17,85,0,129.84547424316406,11036.865310668945,3,3,0,11,5958,2
100120,Furniture,114.78251647949219,2022-03-18,83,492,138.1049624633789,80488.0837689209,4,3,0,11,6041,2
100120,Furniture,114.78251647949219,2022-03-19,83,0,135.4699249267578,11244.003768920898,5,3,1,11,6124,2
100120,Furniture,114.78251647949219,2022-03-20,80,0,135.4699249267578,10837.593994140625,6,3,1,11,6204,2
100120,Furniture,114.78251647949219,2022-03-21,82,0,135.4699249267578,11108.53384399414,0,3,0,12,6286,2
100120,Furniture,114.78251647949219,2022-03-22,38,0,135.4699249267578,5147.857147216797,1,3,0,12,6324,2
100120,Furniture,114.78251647949219,2022-03-23,41,0,135.4699249267578,5554.26692199707,2,3,0,12,6365,2
100120,Furniture,114.78251647949219,2022-03-24,86,0,135.4699249267578,11650.413543701172,3,3,0,12,6451,2
100120,Furniture,114.78251647949219,2022-03-25,66,0,135.4699249267578,8941.015045166016,4,3,0,12,6517,2
100120,Furniture,114.78251647949219,2022-03-26,46,0,135.4699249267578,6231.616546630859,5,3,1,12,6563,2
100120,Furniture,114.78251647949219,2022-03-27,115,399,124.79239501953126,63222.450854492185,6,3,1,12,6678,2
100120,Furniture,114.78251647949219,2022-03-28,57,0,128.0347900390625,7297.9830322265625,0,3,0,13,6735,2
100120,Furniture,114.78251647949219,2022-03-29,32,0,128.0347900390625,4097.11328125,1,3,0,13,6767,2
100120,Furniture,114.78251647949219,2022-03-30,67,0,128.0347900390625,8578.330932617188,2,3,0,13,6834,2
100120,Furniture,114.78251647949219,2022-03-31,48,0,128.0347900390625,6145.669921875,3,3,0,13,6882,2
100120,Furniture,114.78251647949219,2022-04-01,68,466,126.31973709106445,67239.92424438478,4,4,0,13,6950,2
100120,Furniture,114.78251647949219,2022-04-02,88,0,126.8594741821289,11163.633728027344,5,4,1,13,7038,2
100120,Furniture,114.78251647949219,2022-04-03,115,0,126.8594741821289,14588.839530944824,6,4,1,13,7153,2
100120,Furniture,114.78251647949219,2022-04-04,31,0,126.8594741821289,3932.643699645996,0,4,0,14,7184,2
100120,Furniture,114.78251647949219,2022-04-05,66,0,126.8594741821289,8372.725296020508,1,4,0,14,7250,2
100120,Furniture,114.78251647949219,2022-04-06,63,0,126.8594741821289,7992.146873474121,2,4,0,14,7313,2
100120,Furniture,114.78251647949219,2022-04-07,129,490,131.93989959716797,82259.26409606932,3,4,0,14,7442,2
100120,Furniture,114.78251647949219,2022-04-08,104,0,130.30979919433594,13552.219116210938,4,4,0,14,7546,2
100120,Furniture,114.78251647949219,2022-04-09,44,0,130.30979919433594,5733.631164550781,5,4,1,14,7590,2
100120,Furniture,114.78251647949219,2022-04-10,108,0,130.30979919433594,14073.458312988281,6,4,1,14,7698,2
100120,Furniture,114.78251647949219,2022-04-11,66,0,130.30979919433594,8600.446746826172,0,4,0,15,7764,2
100120,Furniture,114.78251647949219,2022-04-12,60,0,130.30979919433594,7818.587951660156,1,4,0,15,7824,2
100120,Furniture,114.78251647949219,2022-04-13,28,0,130.30979919433594,3648.6743774414062,2,4,0,15,7852,2
100120,Furniture,114.78251647949219,2022-04-14,122,720,131.40536041259764,110789.60794067383,3,4,0,15,7974,2
100120,Furniture,114.78251647949219,2022-04-15,51,0,131.1607208251953,6689.196762084961,4,4,0,15,8025,2
100120,Furniture,114.78251647949219,2022-04-16,58,0,131.1607208251953,7607.321807861328,5,4,1,15,8083,2
100120,Furniture,114.78251647949219,2022-04-17,74,0,131.1607208251953,9705.893341064453,6,4,1,15,8157,2
100120,Furniture,114.78251647949219,2022-04-18,78,0,131.1607208251953,10230.536224365234,0,4,0,16,8235,2
100120,Furniture,114.78251647949219,2022-04-19,41,0,131.1607208251953,5377.589553833008,1,4,0,16,8276,2
100120,Furniture,114.78251647949219,2022-04-20,79,0,131.1607208251953,10361.69694519043,2,4,0,16,8355,2
100120,Furniture,114.78251647949219,2022-04-21,73,0,131.1607208251953,9574.732620239258,3,4,0,16,8428,2
100120,Furniture,114.78251647949219,2022-04-22,83,0,131.1607208251953,10886.339828491211,4,4,0,16,8511,2
100120,Furniture,114.78251647949219,2022-04-23,35,0,131.1607208251953,4590.625228881836,5,4,1,16,8546,2
100120,Furniture,114.78251647949219,2022-04-24,38,0,131.1607208251953,4984.107391357422,6,4,1,16,8584,2
100120,Furniture,114.78251647949219,2022-04-25,22,0,131.1607208251953,2885.535858154297,0,4,0,17,8606,2
100120,Furniture,114.78251647949219,2022-04-26,49,0,131.1607208251953,6426.87532043457,1,4,0,17,8655,2
100120,Furniture,114.78251647949219,2022-04-27,24,0,131.1607208251953,3147.8572998046875,2,4,0,17,8679,2
100120,Furniture,114.78251647949219,2022-04-28,51,216,119.86326309204102,31229.102835388185,3,4,0,17,8730,2
100120,Furniture,114.78251647949219,2022-04-29,18,0,124.55652618408203,2242.0174713134766,4,4,0,17,8748,2
100120,Furniture,114.78251647949219,2022-04-30,25,0,124.55652618408203,3113.913154602051,5,4,1,17,8773,2
100120,Furniture,114.78251647949219,2022-05-01,27,0,124.55652618408203,3363.026206970215,6,5,1,17,8800,2
100120,Furniture,114.78251647949219,2022-05-02,17,0,124.55652618408203,2117.4609451293945,0,5,0,18,8817,2
100120,Furniture,114.78251647949219,2022-05-03,31,0,124.55652618408203,3861.252311706543,1,5,0,18,8848,2
100120,Furniture,114.78251647949219,2022-05-04,15,0,124.55652618408203,1868.3478927612305,2,5,0,18,8863,2
100120,Furniture,114.78251647949219,2022-05-05,49,0,124.55652618408203,6103.2697830200195,3,5,0,18,8912,2
100120,Furniture,114.78251647949219,2022-05-06,50,0,124.55652618408203,6227.826309204102,4,5,0,18,8962,2
100120,Furniture,114.78251647949219,2022-05-07,22,0,124.55652618408203,2740.2435760498047,5,5,1,18,8984,2
100120,Furniture,114.78251647949219,2022-05-08,28,0,124.55652618408203,3487.582733154297,6,5,1,18,9012,2
100120,Furniture,114.78251647949219,2022-05-09,28,141,112.61640289306641,18489.048562011718,0,5,0,19,9040,2
100120,Furniture,114.78251647949219,2022-05-10,20,0,117.42280578613281,2348.4561157226562,1,5,0,19,9060,2
100120,Furniture,114.78251647949219,2022-05-11,37,0,117.42280578613281,4344.643814086914,2,5,0,19,9097,2
100120,Furniture,114.78251647949219,2022-05-12,14,0,117.42280578613281,1643.9192810058594,3,5,0,19,9111,2
100120,Furniture,114.78251647949219,2022-05-13,59,259,110.64622344970704,34766.25436706543,4,5,0,19,9170,2
100120,Furniture,114.78251647949219,2022-05-14,63,0,112.74244689941406,7102.774154663086,5,5,1,19,9233,2
100120,Furniture,114.78251647949219,2022-05-15,21,0,112.74244689941406,2367.5913848876953,6,5,1,19,9254,2
100120,Furniture,114.78251647949219,2022-05-16,38,0,112.74244689941406,4284.212982177734,0,5,0,20,9292,2
100120,Furniture,114.78251647949219,2022-05-17,70,318,115.73074768066405,45146.38467529297,1,5,0,20,9362,2
100120,Furniture,114.78251647949219,2022-05-18,61,0,114.75149536132812,6999.841217041016,2,5,0,20,9423,2
100120,Furniture,114.78251647949219,2022-05-19,54,0,114.75149536132812,6196.580749511719,3,5,0,20,9477,2
100120,Furniture,114.78251647949219,2022-05-20,29,0,114.75149536132812,3327.7933654785156,4,5,0,20,9506,2
100120,Furniture,114.78251647949219,2022-05-21,25,0,114.75149536132812,2868.787384033203,5,5,1,20,9531,2
100120,Furniture,114.78251647949219,2022-05-22,31,0,114.75149536132812,3557.296356201172,6,5,1,20,9562,2
100120,Furniture,114.78251647949219,2022-05-23,23,0,114.75149536132812,2639.284393310547,0,5,0,21,9585,2
100120,Furniture,114.78251647949219,2022-05-24,34,0,114.75149536132812,3901.5508422851562,1,5,0,21,9619,2
100120,Furniture,114.78251647949219,2022-05-25,52,0,114.75149536132812,5967.0777587890625,2,5,0,21,9671,2
100120,Furniture,114.78251647949219,2022-05-26,64,209,105.699306640625,28365.911249999997,3,5,0,21,9735,2
100120,Furniture,114.78251647949219,2022-05-27,80,372,116.61926483154298,53474.24237304688,4,5,0,21,9815,2
100120,Furniture,114.78251647949219,2022-05-28,69,0,114.00852966308594,7866.58854675293,5,5,1,21,9884,2
100120,Furniture,114.78251647949219,2022-05-29,36,0,114.00852966308594,4104.307067871094,6,5,1,21,9920,2
100120,Furniture,114.78251647949219,2022-05-30,173,568,135.2741311645508,103080.49938293458,0,5,0,22,10093,2
100120,Furniture,114.78251647949219,2022-05-31,150,0,128.07826232910156,19211.739349365234,1,5,0,22,10243,2
100120,Furniture,114.78251647949219,2022-06-01,91,0,128.07826232910156,11655.121871948242,2,6,0,22,10334,2
100120,Furniture,114.78251647949219,2022-06-02,141,770,139.71155487060548,129641.28847351074,3,6,0,22,10475,2
100120,Furniture,114.78251647949219,2022-06-03,145,0,135.95310974121094,19713.200912475586,4,6,0,22,10620,2
100120,Furniture,114.78251647949219,2022-06-04,129,0,135.95310974121094,17537.95115661621,5,6,1,22,10749,2
100120,Furniture,114.78251647949219,2022-06-05,58,0,135.95310974121094,7885.280364990234,6,6,1,22,10807,2
100120,Furniture,114.78251647949219,2022-06-06,93,0,135.95310974121094,12643.639205932617,0,6,0,23,10900,2
100120,Furniture,114.78251647949219,2022-06-07,71,0,135.95310974121094,9652.670791625977,1,6,0,23,10971,2
100120,Furniture,114.78251647949219,2022-06-08,78,0,135.95310974121094,10604.342559814453,2,6,0,23,11049,2
100120,Furniture,114.78251647949219,2022-06-09,79,0,135.95310974121094,10740.295669555664,3,6,0,23,11128,2
100120,Furniture,114.78251647949219,2022-06-10,74,0,135.95310974121094,10060.53012084961,4,6,0,23,11202,2
100120,Furniture,114.78251647949219,2022-06-11,40,0,135.95310974121094,5438.1243896484375,5,6,1,23,11242,2
100120,Furniture,114.78251647949219,2022-06-12,91,0,135.95310974121094,12371.732986450195,6,6,1,23,11333,2
100120,Furniture,114.78251647949219,2022-06-13,79,0,135.95310974121094,10740.295669555664,0,6,0,24,11412,2
100120,Furniture,114.78251647949219,2022-06-14,81,0,135.95310974121094,11012.201889038086,1,6,0,24,11493,2
100120,Furniture,114.78251647949219,2022-06-15,59,306,114.85866271972657,40041.60220092773,2,6,0,24,11552,2
100120,Furniture,114.78251647949219,2022-06-16,89,0,122.47732543945312,10900.481964111328,3,6,0,24,11641,2
100120,Furniture,114.78251647949219,2022-06-17,74,0,122.47732543945312,9063.322082519531,4,6,0,24,11715,2
100120,Furniture,114.78251647949219,2022-06-18,29,0,122.47732543945312,3551.8424377441406,5,6,1,24,11744,2
100120,Furniture,114.78251647949219,2022-06-19,62,0,122.47732543945312,7593.594177246094,6,6,1,24,11806,2
100120,Furniture,114.78251647949219,2022-06-20,81,333,127.347294921875,53135.741777343756,0,6,0,25,11887,2
100120,Furniture,114.78251647949219,2022-06-21,76,0,125.70458984375,9553.548828125,1,6,0,25,11963,2
100120,Furniture,114.78251647949219,2022-06-22,60,0,125.70458984375,7542.275390625,2,6,0,25,12023,2
100120,Furniture,114.78251647949219,2022-06-23,34,0,125.70458984375,4273.9560546875,3,6,0,25,12057,2
100120,Furniture,114.78251647949219,2022-06-24,84,0,125.70458984375,10559.185546875,4,6,0,25,12141,2
100120,Furniture,114.78251647949219,2022-06-25,103,494,123.125869140625,73249.69904296874,5,6,1,25,12244,2
100120,Furniture,114.78251647949219,2022-06-26,93,0,123.78173828125,11511.70166015625,6,6,1,25,12337,2
100120,Furniture,114.78251647949219,2022-06-27,51,0,123.78173828125,6312.86865234375,0,6,0,26,12388,2
100120,Furniture,114.78251647949219,2022-06-28,90,0,123.78173828125,11140.3564453125,1,6,0,26,12478,2
100120,Furniture,114.78251647949219,2022-06-29,31,0,123.78173828125,3837.23388671875,2,6,0,26,12509,2
100120,Furniture,114.78251647949219,2022-06-30,16,0,123.78173828125,1980.5078125,3,6,0,26,12525,2
100120,Furniture,114.78251647949219,2022-07-01,62,0,123.78173828125,7674.4677734375,4,7,0,26,12587,2
100120,Furniture,114.78251647949219,2022-07-02,24,0,123.78173828125,2970.76171875,5,7,1,26,12611,2
100120,Furniture,114.78251647949219,2022-07-03,33,0,123.78173828125,4084.79736328125,6,7,1,26,12644,2
100120,Furniture,114.78251647949219,2022-07-04,30,0,123.78173828125,3713.4521484375,0,7,0,27,12674,2
100120,Furniture,114.78251647949219,2022-07-05,20,0,123.78173828125,2475.634765625,1,7,0,27,12694,2
100120,Furniture,114.78251647949219,2022-07-06,36,0,123.78173828125,4456.142578125,2,7,0,27,12730,2
100120,Furniture,114.78251647949219,2022-07-07,18,0,123.78173828125,2228.0712890625,3,7,0,27,12748,2
100120,Furniture,114.78251647949219,2022-07-08,51,224,104.39293655395508,27589.969528503418,4,7,0,27,12799,2
100120,Furniture,114.78251647949219,2022-07-09,23,0,110.85587310791016,2549.6850814819336,5,7,1,27,12822,2
100120,Furniture,114.78251647949219,2022-07-10,76,337,114.75759429931641,47758.3043334961,6,7,1,27,12898,2
100120,Furniture,114.78251647949219,2022-07-11,33,0,113.36518859863281,3741.051223754883,0,7,0,28,12931,2
100120,Furniture,114.78251647949219,2022-07-12,47,0,113.36518859863281,5328.163864135742,1,7,0,28,12978,2
100120,Furniture,114.78251647949219,2022-07-13,42,0,113.36518859863281,4761.337921142578,2,7,0,28,13020,2
100120,Furniture,114.78251647949219,2022-07-14,13,0,113.36518859863281,1473.7474517822266,3,7,0,28,13033,2
100120,Furniture,114.78251647949219,2022-07-15,30,0,113.36518859863281,3400.9556579589844,4,7,0,28,13063,2
100120,Furniture,114.78251647949219,2022-07-16,46,0,113.36518859863281,5214.798675537109,5,7,1,28,13109,2
100120,Furniture,114.78251647949219,2022-07-17,16,0,113.36518859863281,1813.843017578125,6,7,1,28,13125,2
100120,Furniture,114.78251647949219,2022-07-18,22,0,113.36518859863281,2494.034149169922,0,7,0,29,13147,2
100120,Furniture,114.78251647949219,2022-07-19,17,0,113.36518859863281,1927.2082061767578,1,7,0,29,13164,2
100120,Furniture,114.78251647949219,2022-07-20,31,0,113.36518859863281,3514.320846557617,2,7,0,29,13195,2
100120,Furniture,114.78251647949219,2022-07-21,22,0,113.36518859863281,2494.034149169922,3,7,0,29,13217,2
100120,Furniture,114.78251647949219,2022-07-22,41,0,113.36518859863281,4647.972732543945,4,7,0,29,13258,2
100120,Furniture,114.78251647949219,2022-07-23,33,0,113.36518859863281,3741.051223754883,5,7,1,29,13291,2
100120,Furniture,114.78251647949219,2022-07-24,36,0,113.36518859863281,4081.1467895507812,6,7,1,29,13327,2
100120,Furniture,114.78251647949219,2022-07-25,109,425,120.85828033447265,65000.22511291504,0,7,0,30,13436,2
100120,Furniture,114.78251647949219,2022-07-26,97,538,119.70819976806641,76059.60075500488,1,7,0,30,13533,2
100120,Furniture,114.78251647949219,2022-07-29,33,0,119.60639953613281,3947.011184692383,4,7,0,30,13566,2
100120,Furniture,114.78251647949219,2022-07-30,87,0,119.60639953613281,10405.756759643555,5,7,1,30,13653,2
100120,Furniture,114.78251647949219,2022-07-31,70,0,119.60639953613281,8372.447967529297,6,7,1,30,13723,2
100120,Furniture,114.78251647949219,2022-08-01,25,0,119.60639953613281,2990.1599884033203,0,8,0,31,13748,2
100120,Furniture,114.78251647949219,2022-08-02,62,0,119.60639953613281,7415.596771240234,1,8,0,31,13810,2
100120,Furniture,114.78251647949219,2022-08-03,186,600,134.1353463745117,107618.22885131834,2,8,0,31,13996,2
100120,Furniture,114.78251647949219,2022-08-04,111,0,128.85069274902344,14302.426895141602,3,8,0,31,14107,2
100120,Furniture,114.78251647949219,2022-08-05,55,0,128.85069274902344,7086.788101196289,4,8,0,31,14162,2
100120,Furniture,114.78251647949219,2022-08-06,80,0,128.85069274902344,10308.055419921875,5,8,1,31,14242,2
100120,Furniture,114.78251647949219,2022-08-07,60,0,128.85069274902344,7731.041564941406,6,8,1,31,14302,2
100120,Furniture,114.78251647949219,2022-08-08,110,0,128.85069274902344,14173.576202392578,0,8,0,32,14412,2
100120,Furniture,114.78251647949219,2022-08-09,66,0,128.85069274902344,8504.145721435547,1,8,0,32,14478,2
100120,Furniture,114.78251647949219,2022-08-10,68,0,128.85069274902344,8761.847106933594,2,8,0,32,14546,2
100120,Furniture,114.78251647949219,2022-08-11,93,0,128.85069274902344,11983.11442565918,3,8,0,32,14639,2
100120,Furniture,114.78251647949219,2022-08-12,79,0,128.85069274902344,10179.204727172852,4,8,0,32,14718,2
100120,Furniture,114.78251647949219,2022-08-13,108,457,123.70536575317382,69368.15900268554,5,8,1,32,14826,2
100120,Furniture,114.78251647949219,2022-08-14,37,0,125.21073150634766,4632.797065734863,6,8,1,32,14863,2
100120,Furniture,114.78251647949219,2022-08-15,56,0,125.21073150634766,7011.800964355469,0,8,0,33,14919,2
100120,Furniture,114.78251647949219,2022-08-16,96,0,125.21073150634766,12020.230224609375,1,8,0,33,15015,2
100120,Furniture,114.78251647949219,2022-08-17,68,0,125.21073150634766,8514.32974243164,2,8,0,33,15083,2
100120,Furniture,114.78251647949219,2022-08-18,62,0,125.21073150634766,7763.065353393555,3,8,0,33,15145,2
100120,Furniture,114.78251647949219,2022-08-19,41,0,125.21073150634766,5133.639991760254,4,8,0,33,15186,2
100120,Furniture,114.78251647949219,2022-08-20,81,418,115.34097579956054,56540.44807952881,5,8,1,33,15267,2
100120,Furniture,114.78251647949219,2022-08-21,113,0,118.3519515991211,13373.770530700684,6,8,1,33,15380,2
100120,Furniture,114.78251647949219,2022-08-22,68,0,118.3519515991211,8047.932708740234,0,8,0,34,15448,2
100120,Furniture,114.78251647949219,2022-08-23,62,0,118.3519515991211,7337.820999145508,1,8,0,34,15510,2
100120,Furniture,114.78251647949219,2022-08-24,53,0,118.3519515991211,6272.653434753418,2,8,0,34,15563,2
100120,Furniture,114.78251647949219,2022-08-25,98,446,127.48395614624023,70348.65540466309,3,8,0,34,15661,2
100120,Furniture,114.78251647949219,2022-08-26,45,0,124.61791229248047,5607.806053161621,4,8,0,34,15706,2
100120,Furniture,114.78251647949219,2022-08-27,110,0,124.61791229248047,13707.970352172852,5,8,1,34,15816,2
100120,Furniture,114.78251647949219,2022-08-28,51,0,124.61791229248047,6355.513526916504,6,8,1,34,15867,2
100120,Furniture,114.78251647949219,2022-08-29,47,0,124.61791229248047,5857.041877746582,0,8,0,35,15914,2
100120,Furniture,114.78251647949219,2022-08-30,18,0,124.61791229248047,2243.1224212646484,1,8,0,35,15932,2
100120,Furniture,114.78251647949219,2022-08-31,38,0,124.61791229248047,4735.480667114258,2,8,0,35,15970,2
100120,Furniture,114.78251647949219,2022-09-01,59,0,124.61791229248047,7352.456825256348,3,9,0,35,16029,2
100120,Furniture,114.78251647949219,2022-09-02,52,0,124.61791229248047,6480.131439208984,4,9,0,35,16081,2
100120,Furniture,114.78251647949219,2022-09-03,93,352,135.9264669799805,61433.54285827637,5,9,1,35,16174,2
100120,Furniture,114.78251647949219,2022-09-04,35,0,132.27293395996094,4629.552688598633,6,9,1,35,16209,2
100120,Furniture,114.78251647949219,2022-09-05,39,0,132.27293395996094,5158.644424438477,0,9,0,36,16248,2
100120,Furniture,114.78251647949219,2022-09-06,87,0,132.27293395996094,11507.745254516602,1,9,0,36,16335,2
100120,Furniture,114.78251647949219,2022-09-07,70,316,130.11042236328126,50006.039130859375,2,9,0,36,16405,2
100120,Furniture,114.78251647949219,2022-09-08,126,0,130.9908447265625,16504.846435546875,3,9,0,36,16531,2
100120,Furniture,114.78251647949219,2022-09-09,57,0,130.9908447265625,7466.4781494140625,4,9,0,36,16588,2
100120,Furniture,114.78251647949219,2022-09-10,59,0,130.9908447265625,7728.4598388671875,5,9,1,36,16647,2
100120,Furniture,114.78251647949219,2022-09-11,62,0,130.9908447265625,8121.432373046875,6,9,1,36,16709,2
100120,Furniture,114.78251647949219,2022-09-12,60,367,125.89586730957032,53227.69407714844,0,9,0,37,16769,2
100120,Furniture,114.78251647949219,2022-09-13,79,0,127.62173461914062,10082.11703491211,1,9,0,37,16848,2
100120,Furniture,114.78251647949219,2022-09-14,74,0,127.62173461914062,9444.008361816406,2,9,0,37,16922,2
100120,Furniture,114.78251647949219,2022-09-15,75,0,127.62173461914062,9571.630096435547,3,9,0,37,16997,2
100120,Furniture,114.78251647949219,2022-09-16,25,0,127.62173461914062,3190.5433654785156,4,9,0,37,17022,2
100120,Furniture,114.78251647949219,2022-09-17,45,0,127.62173461914062,5742.978057861328,5,9,1,37,17067,2
100120,Furniture,114.78251647949219,2022-09-18,70,0,127.62173461914062,8933.521423339844,6,9,1,37,17137,2
100120,Furniture,114.78251647949219,2022-09-19,87,287,104.93027908325195,37635.86856048584,0,9,0,38,17224,2
100120,Furniture,114.78251647949219,2022-09-20,39,0,112.9705581665039,4405.851768493652,1,9,0,38,17263,2
100120,Furniture,114.78251647949219,2022-09-21,66,0,112.9705581665039,7456.056838989258,2,9,0,38,17329,2
100120,Furniture,114.78251647949219,2022-09-22,51,0,112.9705581665039,5761.498466491699,3,9,0,38,17380,2
100120,Furniture,114.78251647949219,2022-09-23,117,396,121.24056259155273,62916.071646423334,4,9,0,38,17497,2
100120,Furniture,114.78251647949219,2022-09-24,88,0,118.66112518310547,10442.179016113281,5,9,1,38,17585,2
100120,Furniture,114.78251647949219,2022-09-25,31,0,118.66112518310547,3678.4948806762695,6,9,1,38,17616,2
100120,Furniture,114.78251647949219,2022-09-26,106,0,118.66112518310547,12578.07926940918,0,9,0,39,17722,2
100120,Furniture,114.78251647949219,2022-09-27,104,364,118.83651657104492,55631.99544677734,1,9,0,39,17826,2
100120,Furniture,114.78251647949219,2022-09-28,43,0,118.77303314208984,5107.240425109863,2,9,0,39,17869,2
100120,Furniture,114.78251647949219,2022-09-29,85,0,118.77303314208984,10095.707817077637,3,9,0,39,17954,2
100120,Furniture,114.78251647949219,2022-09-30,63,0,118.77303314208984,7482.70108795166,4,9,0,39,18017,2
100120,Furniture,114.78251647949219,2022-10-01,62,0,118.77303314208984,7363.92805480957,5,10,1,39,18079,2
100120,Furniture,114.78251647949219,2022-10-02,67,0,118.77303314208984,7957.7932205200195,6,10,1,39,18146,2
100120,Furniture,114.78251647949219,2022-10-03,71,0,118.77303314208984,8432.885353088379,0,10,0,40,18217,2
100120,Furniture,114.78251647949219,2022-10-04,28,0,118.77303314208984,3325.6449279785156,1,10,0,40,18245,2
100120,Furniture,114.78251647949219,2022-10-05,54,295,115.55766098022461,40096.41738586426,2,10,0,40,18299,2
100120,Furniture,114.78251647949219,2022-10-06,82,450,110.42472732543945,57949.33528137207,3,10,0,40,18381,2
100120,Furniture,114.78251647949219,2022-10-07,91,0,112.5894546508789,10245.64037322998,4,10,0,40,18472,2
100120,Furniture,114.78251647949219,2022-10-08,27,0,112.5894546508789,3039.9152755737305,5,10,1,40,18499,2
100120,Furniture,114.78251647949219,2022-10-09,88,0,112.5894546508789,9907.872009277344,6,10,1,40,18587,2
100120,Furniture,114.78251647949219,2022-10-10,39,0,112.5894546508789,4390.988731384277,0,10,0,41,18626,2
100120,Furniture,114.78251647949219,2022-10-11,57,0,112.5894546508789,6417.598915100098,1,10,0,41,18683,2
100120,Furniture,114.78251647949219,2022-10-12,79,0,112.5894546508789,8894.566917419434,2,10,0,41,18762,2
100120,Furniture,114.78251647949219,2022-10-13,79,0,112.5894546508789,8894.566917419434,3,10,0,41,18841,2
100120,Furniture,114.78251647949219,2022-10-14,107,341,124.69401809692383,56914.9798727417,4,10,0,41,18948,2
100120,Furniture,114.78251647949219,2022-10-15,88,0,120.19803619384766,10577.427185058594,5,10,1,41,19036,2
100120,Furniture,114.78251647949219,2022-10-16,131,0,120.19803619384766,15745.942741394043,6,10,1,41,19167,2
100120,Furniture,114.78251647949219,2022-10-17,67,0,120.19803619384766,8053.268424987793,0,10,0,42,19234,2
100120,Furniture,114.78251647949219,2022-10-18,52,345,119.0777374267578,47163.18469238281,1,10,0,42,19286,2
100120,Furniture,114.78251647949219,2022-10-19,99,0,119.45547485351562,11826.092010498047,2,10,0,42,19385,2
100120,Furniture,114.78251647949219,2022-10-20,38,0,119.45547485351562,4539.308044433594,3,10,0,42,19423,2
100120,Furniture,114.78251647949219,2022-10-21,58,0,119.45547485351562,6928.417541503906,4,10,0,42,19481,2
100120,Furniture,114.78251647949219,2022-10-22,109,487,133.08079284667969,80941.25284057617,5,10,1,42,19590,2
100120,Furniture,114.78251647949219,2022-10-23,49,0,128.78158569335938,6310.297698974609,6,10,1,42,19639,2
100120,Furniture,114.78251647949219,2022-10-24,78,0,128.78158569335938,10044.963684082031,0,10,0,43,19717,2
100120,Furniture,114.78251647949219,2022-10-25,59,0,128.78158569335938,7598.113555908203,1,10,0,43,19776,2
100120,Furniture,114.78251647949219,2022-10-26,78,0,128.78158569335938,10044.963684082031,2,10,0,43,19854,2
100120,Furniture,114.78251647949219,2022-10-27,56,0,128.78158569335938,7211.768798828125,3,10,0,43,19910,2
100120,Furniture,114.78251647949219,2022-10-28,154,726,149.97502563476564,135115.42789550783,4,10,0,43,20064,2
100120,Furniture,114.78251647949219,2022-10-29,55,0,144.49005126953125,7946.952819824219,5,10,1,43,20119,2
100120,Furniture,114.78251647949219,2022-10-30,42,0,144.49005126953125,6068.5821533203125,6,10,1,43,20161,2
100120,Furniture,114.78251647949219,2022-10-31,29,0,144.49005126953125,4190.211486816406,0,10,0,44,20190,2
100120,Furniture,114.78251647949219,2022-11-01,123,0,144.49005126953125,17772.276306152344,1,11,0,44,20313,2
100120,Furniture,114.78251647949219,2022-11-02,36,0,144.49005126953125,5201.641845703125,2,11,0,44,20349,2
100120,Furniture,114.78251647949219,2022-11-03,74,0,144.49005126953125,10692.263793945312,3,11,0,44,20423,2
100120,Furniture,114.78251647949219,2022-11-04,68,0,144.49005126953125,9825.323486328125,4,11,0,44,20491,2
100120,Furniture,114.78251647949219,2022-11-05,132,0,144.49005126953125,19072.686767578125,5,11,1,44,20623,2
100120,Furniture,114.78251647949219,2022-11-06,67,0,144.49005126953125,9680.833435058594,6,11,1,44,20690,2
100120,Furniture,114.78251647949219,2022-11-07,92,0,144.49005126953125,13293.084716796875,0,11,0,45,20782,2
100120,Furniture,114.78251647949219,2022-11-08,48,0,144.49005126953125,6935.5224609375,1,11,0,45,20830,2
100120,Furniture,114.78251647949219,2022-11-09,104,464,121.50675628662108,66929.00530761719,2,11,0,45,20934,2
100120,Furniture,114.78251647949219,2022-11-10,31,0,127.30351257324219,3946.408889770508,3,11,0,45,20965,2
100120,Furniture,114.78251647949219,2022-11-11,30,0,127.30351257324219,3819.1053771972656,4,11,0,45,20995,2
100120,Furniture,114.78251647949219,2022-11-12,68,0,127.30351257324219,8656.638854980469,5,11,1,45,21063,2
100120,Furniture,114.78251647949219,2022-11-13,94,0,127.30351257324219,11966.530181884766,6,11,1,45,21157,2
100120,Furniture,114.78251647949219,2022-11-14,68,0,127.30351257324219,8656.638854980469,0,11,0,46,21225,2
100120,Furniture,114.78251647949219,2022-11-15,40,0,127.30351257324219,5092.1405029296875,1,11,0,46,21265,2
100120,Furniture,114.78251647949219,2022-11-16,57,0,127.30351257324219,7256.300216674805,2,11,0,46,21322,2
100120,Furniture,114.78251647949219,2022-11-17,94,355,116.30914123535156,51400.87855224609,3,11,0,46,21416,2
100120,Furniture,114.78251647949219,2022-11-18,90,0,119.45828247070312,10751.245422363281,4,11,0,46,21506,2
100120,Furniture,114.78251647949219,2022-11-19,75,0,119.45828247070312,8959.371185302734,5,11,1,46,21581,2
100120,Furniture,114.78251647949219,2022-11-20,26,0,119.45828247070312,3105.9153442382812,6,11,1,46,21607,2
100120,Furniture,114.78251647949219,2022-11-21,46,0,119.45828247070312,5495.080993652344,0,11,0,47,21653,2
100120,Furniture,114.78251647949219,2022-11-22,114,480,111.06400085449218,65223.91219482422,1,11,0,47,21767,2
100120,Furniture,114.78251647949219,2022-11-23,42,0,113.10800170898438,4750.536071777344,2,11,0,47,21809,2
100120,Furniture,114.78251647949219,2022-11-24,108,0,113.10800170898438,12215.664184570312,3,11,0,47,21917,2
100120,Furniture,114.78251647949219,2022-11-25,16,0,113.10800170898438,1809.72802734375,4,11,0,47,21933,2
100120,Furniture,114.78251647949219,2022-11-26,116,0,113.10800170898438,13120.528198242188,5,11,1,47,22049,2
100120,Furniture,114.78251647949219,2022-11-27,28,0,113.10800170898438,3167.0240478515625,6,11,1,47,22077,2
100120,Furniture,114.78251647949219,2022-11-28,111,559,129.7291566467285,88751.23277557372,0,11,0,48,22188,2
100120,Furniture,114.78251647949219,2022-11-29,64,0,125.63831329345703,8040.85205078125,1,11,0,48,22252,2
100120,Furniture,114.78251647949219,2022-11-30,49,0,125.63831329345703,6156.2773513793945,2,11,0,48,22301,2
100120,Furniture,114.78251647949219,2022-12-01,65,0,125.63831329345703,8166.490364074707,3,12,0,48,22366,2
100120,Furniture,114.78251647949219,2022-12-02,69,0,125.63831329345703,8669.043617248535,4,12,0,48,22435,2
100120,Furniture,114.78251647949219,2022-12-03,148,0,125.63831329345703,18594.47036743164,5,12,1,48,22583,2
100120,Furniture,114.78251647949219,2022-12-04,72,0,125.63831329345703,9045.958557128906,6,12,1,48,22655,2
100120,Furniture,114.78251647949219,2022-12-05,104,384,126.52469482421876,61821.1365234375,0,12,0,49,22759,2
100120,Furniture,114.78251647949219,2022-12-06,43,0,126.2493896484375,5428.7237548828125,1,12,0,49,22802,2
100120,Furniture,114.78251647949219,2022-12-07,66,0,126.2493896484375,8332.459716796875,2,12,0,49,22868,2
100120,Furniture,114.78251647949219,2022-12-08,88,434,126.35906143188477,65973.59481201172,3,12,0,49,22956,2
100120,Furniture,114.78251647949219,2022-12-09,114,0,126.31812286376953,14400.266006469727,4,12,0,49,23070,2
100120,Furniture,114.78251647949219,2022-12-10,58,0,126.31812286376953,7326.451126098633,5,12,1,49,23128,2
100120,Furniture,114.78251647949219,2022-12-11,35,0,126.31812286376953,4421.134300231934,6,12,1,49,23163,2
100120,Furniture,114.78251647949219,2022-12-12,93,0,126.31812286376953,11747.585426330566,0,12,0,50,23256,2
100120,Furniture,114.78251647949219,2022-12-13,83,0,126.31812286376953,10484.404197692871,1,12,0,50,23339,2
100120,Furniture,114.78251647949219,2022-12-14,117,461,133.50830780029298,78014.62402526855,2,12,0,50,23456,2
100120,Furniture,114.78251647949219,2022-12-15,48,0,131.04661560058594,6290.237548828125,3,12,0,50,23504,2
100120,Furniture,114.78251647949219,2022-12-16,75,0,131.04661560058594,9828.496170043945,4,12,0,50,23579,2
100120,Furniture,114.78251647949219,2022-12-17,205,837,124.05394470214844,127959.79732788085,5,12,1,50,23784,2
100120,Furniture,114.78251647949219,2022-12-18,68,0,126.11788940429688,8576.016479492188,6,12,1,50,23852,2
100120,Furniture,114.78251647949219,2022-12-19,121,0,126.11788940429688,15260.264617919922,0,12,0,51,23973,2
100120,Furniture,114.78251647949219,2022-12-20,55,0,126.11788940429688,6936.483917236328,1,12,0,51,24028,2
100120,Furniture,114.78251647949219,2022-12-21,92,0,126.11788940429688,11602.845825195312,2,12,0,51,24120,2
100120,Furniture,114.78251647949219,2022-12-22,60,0,126.11788940429688,7567.0733642578125,3,12,0,51,24180,2
100120,Furniture,114.78251647949219,2022-12-23,96,0,126.11788940429688,12107.3173828125,4,12,0,51,24276,2
100120,Furniture,114.78251647949219,2022-12-24,94,0,126.11788940429688,11855.081604003906,5,12,1,51,24370,2
100120,Furniture,114.78251647949219,2022-12-25,87,0,126.11788940429688,10972.256378173828,6,12,1,51,24457,2
100120,Furniture,114.78251647949219,2022-12-26,209,608,135.4846578979492,112005.80700134278,0,12,0,52,24666,2
100120,Furniture,114.78251647949219,2022-12-27,94,0,132.18931579589844,12425.795684814453,1,12,0,52,24760,2
100120,Furniture,114.78251647949219,2022-12-28,65,0,132.18931579589844,8592.305526733398,2,12,0,52,24825,2
100120,Furniture,114.78251647949219,2022-12-29,61,0,132.18931579589844,8063.548263549805,3,12,0,52,24886,2
100120,Furniture,114.78251647949219,2022-12-30,60,0,132.18931579589844,7931.358947753906,4,12,0,52,24946,2
100120,Furniture,114.78251647949219,2022-12-31,42,0,132.18931579589844,5551.951263427734,5,12,1,52,24988,2
100120,Furniture,114.78251647949219,2023-01-01,58,0,132.18931579589844,7666.980316162109,6,1,1,52,25046,2
100120,Furniture,114.78251647949219,2023-01-02,84,0,132.18931579589844,11103.902526855469,0,1,0,1,25130,2
100120,Furniture,114.78251647949219,2023-01-03,64,0,132.18931579589844,8460.1162109375,1,1,0,1,25194,2
100120,Furniture,114.78251647949219,2023-01-04,58,0,132.18931579589844,7666.980316162109,2,1,0,1,25252,2
100120,Furniture,114.78251647949219,2023-01-05,46,0,132.18931579589844,6080.708526611328,3,1,0,1,25298,2
100120,Furniture,114.78251647949219,2023-01-06,63,0,132.18931579589844,8327.926895141602,4,1,0,1,25361,2
100120,Furniture,114.78251647949219,2023-01-07,51,323,119.83311981201172,43606.33822082519,5,1,1,1,25412,2
100120,Furniture,114.78251647949219,2023-01-08,41,0,124.28623962402344,5095.735824584961,6,1,1,1,25453,2
100120,Furniture,114.78251647949219,2023-01-09,98,0,124.28623962402344,12180.051483154297,0,1,0,2,25551,2
100120,Furniture,114.78251647949219,2023-01-10,61,0,124.28623962402344,7581.46061706543,1,1,0,2,25612,2
100120,Furniture,114.78251647949219,2023-01-11,88,0,124.28623962402344,10937.189086914062,2,1,0,2,25700,2
100120,Furniture,114.78251647949219,2023-01-12,48,0,124.28623962402344,5965.739501953125,3,1,0,2,25748,2
100120,Furniture,114.78251647949219,2023-01-13,17,0,124.28623962402344,2112.8660736083984,4,1,0,2,25765,2
100120,Furniture,114.78251647949219,2023-01-14,46,225,113.4382438659668,29992.068435668945,5,1,1,2,25811,2
100120,Furniture,114.78251647949219,2023-01-15,57,0,117.6264877319336,6704.709800720215,6,1,1,2,25868,2
100120,Furniture,114.78251647949219,2023-01-16,144,518,113.74180908203125,74888.74101562501,0,1,0,3,26012,2
100120,Furniture,114.78251647949219,2023-01-17,36,0,114.8336181640625,4134.01025390625,1,1,0,3,26048,2
100120,Furniture,114.78251647949219,2023-01-18,112,0,114.8336181640625,12861.365234375,2,1,0,3,26160,2
100120,Furniture,114.78251647949219,2023-01-19,93,0,114.8336181640625,10679.526489257812,3,1,0,3,26253,2
100120,Furniture,114.78251647949219,2023-01-20,96,0,114.8336181640625,11024.02734375,4,1,0,3,26349,2
100120,Furniture,114.78251647949219,2023-01-21,71,0,114.8336181640625,8153.1868896484375,5,1,1,3,26420,2
100120,Furniture,114.78251647949219,2023-01-22,81,471,122.2924415588379,68327.37553253173,6,1,1,3,26501,2
100120,Furniture,114.78251647949219,2023-01-23,95,0,120.18488311767578,11417.5638961792,0,1,0,4,26596,2
100120,Furniture,114.78251647949219,2023-01-24,63,0,120.18488311767578,7571.647636413574,1,1,0,4,26659,2
100120,Furniture,114.78251647949219,2023-01-25,57,0,120.18488311767578,6850.5383377075195,2,1,0,4,26716,2
100120,Furniture,114.78251647949219,2023-01-26,63,0,120.18488311767578,7571.647636413574,3,1,0,4,26779,2
100120,Furniture,114.78251647949219,2023-01-27,47,0,120.18488311767578,5648.689506530762,4,1,0,4,26826,2
100120,Furniture,114.78251647949219,2023-01-28,10,0,120.18488311767578,1201.8488311767578,5,1,1,4,26836,2
100120,Furniture,114.78251647949219,2023-01-29,14,0,120.18488311767578,1682.588363647461,6,1,1,4,26850,2
100120,Furniture,114.78251647949219,2023-01-30,11,0,120.18488311767578,1322.0337142944336,0,1,0,5,26861,2
100120,Furniture,114.78251647949219,2023-01-31,27,0,120.18488311767578,3244.991844177246,1,1,0,5,26888,2
100120,Furniture,114.78251647949219,2023-02-01,41,0,120.18488311767578,4927.580207824707,2,2,0,5,26929,2
100120,Furniture,114.78251647949219,2023-02-02,23,0,120.18488311767578,2764.252311706543,3,2,0,5,26952,2
100120,Furniture,114.78251647949219,2023-02-03,29,0,120.18488311767578,3485.3616104125977,4,2,0,5,26981,2
100120,Furniture,114.78251647949219,2023-02-04,43,0,120.18488311767578,5167.949974060059,5,2,1,5,27024,2
100120,Furniture,114.78251647949219,2023-02-05,49,236,103.65949493408203,28507.07050354004,6,2,1,5,27073,2
100120,Furniture,114.78251647949219,2023-02-06,35,0,109.19898986816406,3821.964645385742,0,2,0,6,27108,2
100120,Furniture,114.78251647949219,2023-02-07,25,0,109.19898986816406,2729.9747467041016,1,2,0,6,27133,2
100120,Furniture,114.78251647949219,2023-02-08,52,0,109.19898986816406,5678.347473144531,2,2,0,6,27185,2
100120,Furniture,114.78251647949219,2023-02-09,26,0,109.19898986816406,2839.1737365722656,3,2,0,6,27211,2
100120,Furniture,114.78251647949219,2023-02-10,65,205,103.51178833007813,27620.332482910155,4,2,0,6,27276,2
100120,Furniture,114.78251647949219,2023-02-11,35,0,105.85357666015625,3704.8751831054688,5,2,1,6,27311,2
100120,Furniture,114.78251647949219,2023-02-12,37,0,105.85357666015625,3916.5823364257812,6,2,1,6,27348,2
100120,Furniture,114.78251647949219,2023-02-13,10,0,105.85357666015625,1058.5357666015625,0,2,0,7,27358,2
100120,Furniture,114.78251647949219,2023-02-14,25,0,105.85357666015625,2646.3394165039062,1,2,0,7,27383,2
100120,Furniture,114.78251647949219,2023-02-15,67,256,116.74210342407227,38499.211858825685,2,2,0,7,27450,2
100120,Furniture,114.78251647949219,2023-02-16,34,0,112.55420684814453,3826.843032836914,3,2,0,7,27484,2
100120,Furniture,114.78251647949219,2023-02-17,40,0,112.55420684814453,4502.168273925781,4,2,0,7,27524,2
100120,Furniture,114.78251647949219,2023-02-18,30,0,112.55420684814453,3376.626205444336,5,2,1,7,27554,2
100120,Furniture,114.78251647949219,2023-02-19,21,0,112.55420684814453,2363.638343811035,6,2,1,7,27575,2
100120,Furniture,114.78251647949219,2023-02-20,50,0,112.55420684814453,5627.710342407227,0,2,0,8,27625,2
100120,Furniture,114.78251647949219,2023-02-21,26,0,112.55420684814453,2926.409378051758,1,2,0,8,27651,2
100120,Furniture,114.78251647949219,2023-02-22,69,462,112.38284103393555,59658.45206268311,2,2,0,8,27720,2
100120,Furniture,114.78251647949219,2023-02-23,35,0,112.4256820678711,3934.8988723754883,3,2,0,8,27755,2
100120,Furniture,114.78251647949219,2023-02-24,37,0,112.4256820678711,4159.7502365112305,4,2,0,8,27792,2
100120,Furniture,114.78251647949219,2023-02-25,27,0,112.4256820678711,3035.4934158325195,5,2,1,8,27819,2
100120,Furniture,114.78251647949219,2023-02-26,10,0,112.4256820678711,1124.256820678711,6,2,1,8,27829,2
100120,Furniture,114.78251647949219,2023-02-27,35,0,112.4256820678711,3934.8988723754883,0,2,0,9,27864,2
100120,Furniture,114.78251647949219,2023-02-28,24,0,112.4256820678711,2698.2163696289062,1,2,0,9,27888,2
100120,Furniture,114.78251647949219,2023-03-01,102,0,112.4256820678711,11467.419570922852,2,3,0,9,27990,2
100120,Furniture,114.78251647949219,2023-03-02,95,370,113.74457000732423,53024.7183013916,3,3,0,9,28085,2
100120,Furniture,114.78251647949219,2023-03-03,63,0,113.25914001464844,7135.325820922852,4,3,0,9,28148,2
100120,Furniture,114.78251647949219,2023-03-04,100,0,113.25914001464844,11325.914001464844,5,3,1,9,28248,2
100120,Furniture,114.78251647949219,2023-03-05,137,0,113.25914001464844,15516.502182006836,6,3,1,9,28385,2
100120,Furniture,114.78251647949219,2023-03-06,191,788,122.46436767578125,121018.33845214843,0,3,0,10,28576,2
100120,Furniture,114.78251647949219,2023-03-07,61,0,120.5787353515625,7355.3028564453125,1,3,0,10,28637,2
100120,Furniture,114.78251647949219,2023-03-08,86,0,120.5787353515625,10369.771240234375,2,3,0,10,28723,2
100120,Furniture,114.78251647949219,2023-03-09,68,0,120.5787353515625,8199.35400390625,3,3,0,10,28791,2
100120,Furniture,114.78251647949219,2023-03-10,70,0,120.5787353515625,8440.511474609375,4,3,0,10,28861,2
100120,Furniture,114.78251647949219,2023-03-11,40,0,120.5787353515625,4823.1494140625,5,3,1,10,28901,2
100120,Furniture,114.78251647949219,2023-03-12,63,0,120.5787353515625,7596.4603271484375,6,3,1,10,28964,2
100120,Furniture,114.78251647949219,2023-03-13,40,0,120.5787353515625,4823.1494140625,0,3,0,11,29004,2
100120,Furniture,114.78251647949219,2023-03-14,94,0,120.5787353515625,11334.401123046875,1,3,0,11,29098,2
100120,Furniture,114.78251647949219,2023-03-15,72,406,116.3158171081543,55069.29766357422,2,3,0,11,29170,2
100120,Furniture,114.78251647949219,2023-03-16,133,0,117.9016342163086,15680.917350769043,3,3,0,11,29303,2
100120,Furniture,114.78251647949219,2023-03-17,56,0,117.9016342163086,6602.491516113281,4,3,0,11,29359,2
100120,Furniture,114.78251647949219,2023-03-18,87,0,117.9016342163086,10257.442176818848,5,3,1,11,29446,2
100120,Furniture,114.78251647949219,2023-03-19,35,0,117.9016342163086,4126.557197570801,6,3,1,11,29481,2
100120,Furniture,114.78251647949219,2023-03-20,46,0,117.9016342163086,5423.475173950195,0,3,0,12,29527,2
100120,Furniture,114.78251647949219,2023-03-21,47,0,117.9016342163086,5541.376808166504,1,3,0,12,29574,2
100120,Furniture,114.78251647949219,2023-03-22,119,414,129.28418853759766,70022.33687194824,2,3,0,12,29693,2
100120,Furniture,114.78251647949219,2023-03-23,143,0,125.50837707519531,17947.69792175293,3,3,0,12,29836,2
100120,Furniture,114.78251647949219,2023-03-24,94,0,125.50837707519531,11797.78744506836,4,3,0,12,29930,2
100120,Furniture,114.78251647949219,2023-03-25,55,0,125.50837707519531,6902.960739135742,5,3,1,12,29985,2
100120,Furniture,114.78251647949219,2023-03-26,70,0,125.50837707519531,8785.586395263672,6,3,1,12,30055,2
100120,Furniture,114.78251647949219,2023-03-27,29,0,125.50837707519531,3639.742935180664,0,3,0,13,30084,2
100120,Furniture,114.78251647949219,2023-03-28,112,490,135.56402862548828,82534.12241210937,1,3,0,13,30196,2
100120,Furniture,114.78251647949219,2023-03-29,35,0,133.11805725097656,4659.13200378418,2,3,0,13,30231,2
100120,Furniture,114.78251647949219,2023-03-30,80,0,133.11805725097656,10649.444580078125,3,3,0,13,30311,2
100120,Furniture,114.78251647949219,2023-03-31,37,0,133.11805725097656,4925.368118286133,4,3,0,13,30348,2
100120,Furniture,114.78251647949219,2023-04-01,93,0,133.11805725097656,12379.97932434082,5,4,1,13,30441,2
100120,Furniture,114.78251647949219,2023-04-02,64,0,133.11805725097656,8519.5556640625,6,4,1,13,30505,2
100120,Furniture,114.78251647949219,2023-04-03,45,0,133.11805725097656,5990.312576293945,0,4,0,14,30550,2
100120,Furniture,114.78251647949219,2023-04-04,105,390,111.17701782226563,53138.22374267578,1,4,0,14,30655,2
100120,Furniture,114.78251647949219,2023-04-05,67,0,117.82403564453125,7894.210388183594,2,4,0,14,30722,2
100120,Furniture,114.78251647949219,2023-04-06,120,0,117.82403564453125,14138.88427734375,3,4,0,14,30842,2
100120,Furniture,114.78251647949219,2023-04-07,47,0,117.82403564453125,5537.729675292969,4,4,0,14,30889,2
100120,Furniture,114.78251647949219,2023-04-08,62,0,117.82403564453125,7305.0902099609375,5,4,1,14,30951,2
100120,Furniture,114.78251647949219,2023-04-09,37,0,117.82403564453125,4359.489318847656,6,4,1,14,30988,2
100120,Furniture,114.78251647949219,2023-04-10,102,360,108.61164138793944,49494.45484313965,0,4,0,15,31090,2
100120,Furniture,114.78251647949219,2023-04-11,38,0,111.2632827758789,4228.004745483398,1,4,0,15,31128,2
100120,Furniture,114.78251647949219,2023-04-12,27,0,111.2632827758789,3004.1086349487305,2,4,0,15,31155,2
100120,Furniture,114.78251647949219,2023-04-13,11,0,111.2632827758789,1223.896110534668,3,4,0,15,31166,2
100120,Furniture,114.78251647949219,2023-04-14,27,0,111.2632827758789,3004.1086349487305,4,4,0,15,31193,2
100120,Furniture,114.78251647949219,2023-04-15,23,0,111.2632827758789,2559.055503845215,5,4,1,15,31216,2
100120,Furniture,114.78251647949219,2023-04-16,59,0,111.2632827758789,6564.5336837768555,6,4,1,15,31275,2
100120,Furniture,114.78251647949219,2023-04-17,35,0,111.2632827758789,3894.2148971557617,0,4,0,16,31310,2
100120,Furniture,114.78251647949219,2023-04-18,56,0,111.2632827758789,6230.743835449219,1,4,0,16,31366,2
100120,Furniture,114.78251647949219,2023-04-19,34,0,111.2632827758789,3782.951614379883,2,4,0,16,31400,2
100120,Furniture,114.78251647949219,2023-04-20,48,161,103.78565673828125,21331.223046875,3,4,0,16,31448,2
100120,Furniture,114.78251647949219,2023-04-21,46,0,106.9713134765625,4920.680419921875,4,4,0,16,31494,2
100120,Furniture,114.78251647949219,2023-04-22,38,0,106.9713134765625,4064.909912109375,5,4,1,16,31532,2
100120,Furniture,114.78251647949219,2023-04-23,52,323,99.70159927368164,36810.43632446289,6,4,1,16,31584,2
100120,Furniture,114.78251647949219,2023-04-24,4,0,101.83319854736328,407.3327941894531,0,4,0,17,31588,2
100120,Furniture,114.78251647949219,2023-04-25,46,0,101.83319854736328,4684.327133178711,1,4,0,17,31634,2
100120,Furniture,114.78251647949219,2023-04-26,25,0,101.83319854736328,2545.829963684082,2,4,0,17,31659,2
100120,Furniture,114.78251647949219,2023-04-27,38,0,101.83319854736328,3869.6615447998047,3,4,0,17,31697,2
100120,Furniture,114.78251647949219,2023-04-28,52,0,101.83319854736328,5295.326324462891,4,4,0,17,31749,2
100120,Furniture,114.78251647949219,2023-04-29,27,0,101.83319854736328,2749.4963607788086,5,4,1,17,31776,2
100120,Furniture,114.78251647949219,2023-04-30,39,0,101.83319854736328,3971.494743347168,6,4,1,17,31815,2
100120,Furniture,114.78251647949219,2023-05-01,70,0,101.83319854736328,7128.32389831543,0,5,0,18,31885,2
100120,Furniture,114.78251647949219,2023-05-02,65,239,100.0595620727539,30315.523069458006,1,5,0,18,31950,2
100120,Furniture,114.78251647949219,2023-05-03,37,0,100.64912414550781,3724.017593383789,2,5,0,18,31987,2
100120,Furniture,114.78251647949219,2023-05-04,64,0,100.64912414550781,6441.5439453125,3,5,0,18,32051,2
100120,Furniture,114.78251647949219,2023-05-05,51,0,100.64912414550781,5133.105331420898,4,5,0,18,32102,2
100120,Furniture,114.78251647949219,2023-05-06,46,202,98.34300109863281,24248.19610107422,5,5,1,18,32148,2
100120,Furniture,114.78251647949219,2023-05-07,25,0,99.24600219726562,2481.1500549316406,6,5,1,18,32173,2
100120,Furniture,114.78251647949219,2023-05-08,45,0,99.24600219726562,4466.070098876953,0,5,0,19,32218,2
100120,Furniture,114.78251647949219,2023-05-09,25,0,99.24600219726562,2481.1500549316406,1,5,0,19,32243,2
100120,Furniture,114.78251647949219,2023-05-10,40,0,99.24600219726562,3969.840087890625,2,5,0,19,32283,2
100120,Furniture,114.78251647949219,2023-05-11,32,0,99.24600219726562,3175.8720703125,3,5,0,19,32315,2
100120,Furniture,114.78251647949219,2023-05-12,51,281,103.53358917236328,34675.92609558105,4,5,0,19,32366,2
100120,Furniture,114.78251647949219,2023-05-13,41,0,102.21717834472656,4190.904312133789,5,5,1,19,32407,2
100120,Furniture,114.78251647949219,2023-05-14,62,0,102.21717834472656,6337.465057373047,6,5,1,19,32469,2
100120,Furniture,114.78251647949219,2023-05-15,95,398,107.71590255737306,53638.46148590088,0,5,0,20,32564,2
100120,Furniture,114.78251647949219,2023-05-16,74,0,105.9518051147461,7840.433578491211,1,5,0,20,32638,2
100120,Furniture,114.78251647949219,2023-05-17,89,0,105.9518051147461,9429.710655212402,2,5,0,20,32727,2
100120,Furniture,114.78251647949219,2023-05-18,118,584,122.95116622924805,88739.03523010254,3,5,0,20,32845,2
100120,Furniture,114.78251647949219,2023-05-19,41,0,117.7423324584961,4827.43563079834,4,5,0,20,32886,2
100120,Furniture,114.78251647949219,2023-05-20,43,0,117.7423324584961,5062.920295715332,5,5,1,20,32929,2
100120,Furniture,114.78251647949219,2023-05-21,78,0,117.7423324584961,9183.901931762695,6,5,1,20,33007,2
100120,Furniture,114.78251647949219,2023-05-22,47,0,117.7423324584961,5533.889625549316,0,5,0,21,33054,2
100120,Furniture,114.78251647949219,2023-05-23,19,0,117.7423324584961,2237.104316711426,1,5,0,21,33073,2
100120,Furniture,114.78251647949219,2023-05-24,72,0,117.7423324584961,8477.447937011719,2,5,0,21,33145,2
100120,Furniture,114.78251647949219,2023-05-25,70,0,117.7423324584961,8241.963272094727,3,5,0,21,33215,2
100120,Furniture,114.78251647949219,2023-05-26,72,0,117.7423324584961,8477.447937011719,4,5,0,21,33287,2
100120,Furniture,114.78251647949219,2023-05-27,99,0,117.7423324584961,11656.490913391113,5,5,1,21,33386,2
100120,Furniture,114.78251647949219,2023-05-28,69,0,117.7423324584961,8124.2209396362305,6,5,1,21,33455,2
100120,Furniture,114.78251647949219,2023-05-29,28,0,117.7423324584961,3296.7853088378906,0,5,0,22,33483,2
100120,Furniture,114.78251647949219,2023-05-30,93,341,117.14145919799805,50789.43141082764,1,5,0,22,33576,2
100120,Furniture,114.78251647949219,2023-05-31,56,0,117.3429183959961,6571.203430175781,2,5,0,22,33632,2
100120,Furniture,114.78251647949219,2023-06-01,33,0,117.3429183959961,3872.316307067871,3,6,0,22,33665,2
100120,Furniture,114.78251647949219,2023-06-02,73,0,117.3429183959961,8566.033042907715,4,6,0,22,33738,2
100120,Furniture,114.78251647949219,2023-06-03,61,0,117.3429183959961,7157.918022155762,5,6,1,22,33799,2
100120,Furniture,114.78251647949219,2023-06-04,124,382,118.97006607055664,60335.57638549805,6,6,1,22,33923,2
100120,Furniture,114.78251647949219,2023-06-05,70,0,118.44013214111328,8290.80924987793,0,6,0,23,33993,2
100120,Furniture,114.78251647949219,2023-06-06,116,0,118.44013214111328,13739.05532836914,1,6,0,23,34109,2
100120,Furniture,114.78251647949219,2023-06-07,59,0,118.44013214111328,6987.967796325684,2,6,0,23,34168,2
100120,Furniture,114.78251647949219,2023-06-08,67,384,122.61366271972656,55738.23080444336,3,6,0,23,34235,2
100120,Furniture,114.78251647949219,2023-06-09,144,0,121.22732543945312,17456.73486328125,4,6,0,23,34379,2
100120,Furniture,114.78251647949219,2023-06-10,57,0,121.22732543945312,6909.957550048828,5,6,1,23,34436,2
100120,Furniture,114.78251647949219,2023-06-11,114,381,111.54630599975586,54193.797767944336,6,6,1,23,34550,2
100120,Furniture,114.78251647949219,2023-06-12,61,0,115.37261199951172,7037.729331970215,0,6,0,24,34611,2
100120,Furniture,114.78251647949219,2023-06-13,48,0,115.37261199951172,5537.8853759765625,1,6,0,24,34659,2
100120,Furniture,114.78251647949219,2023-06-14,112,0,115.37261199951172,12921.732543945312,2,6,0,24,34771,2
100120,Furniture,114.78251647949219,2023-06-15,89,0,115.37261199951172,10268.162467956543,3,6,0,24,34860,2
100120,Furniture,114.78251647949219,2023-06-16,70,0,115.37261199951172,8076.08283996582,4,6,0,24,34930,2
100120,Furniture,114.78251647949219,2023-06-17,51,0,115.37261199951172,5884.003211975098,5,6,1,24,34981,2
100120,Furniture,114.78251647949219,2023-06-18,55,0,115.37261199951172,6345.4936599731445,6,6,1,24,35036,2
100120,Furniture,114.78251647949219,2023-06-19,38,254,107.36041046142577,30735.711195068357,0,6,0,25,35074,2
100120,Furniture,114.78251647949219,2023-06-20,24,0,110.20082092285156,2644.8197021484375,1,6,0,25,35098,2
100120,Furniture,114.78251647949219,2023-06-21,71,0,110.20082092285156,7824.258285522461,2,6,0,25,35169,2
100120,Furniture,114.78251647949219,2023-06-22,68,339,123.62781112670899,51666.69231323243,3,6,0,25,35237,2
100120,Furniture,114.78251647949219,2023-06-23,111,0,118.64562225341797,13169.664070129395,4,6,0,25,35348,2
100120,Furniture,114.78251647949219,2023-06-24,53,0,118.64562225341797,6288.217979431152,5,6,1,25,35401,2
100120,Furniture,114.78251647949219,2023-06-25,71,0,118.64562225341797,8423.839179992676,6,6,1,25,35472,2
100120,Furniture,114.78251647949219,2023-06-26,58,0,118.64562225341797,6881.446090698242,0,6,0,26,35530,2
100120,Furniture,114.78251647949219,2023-06-27,115,414,128.2116818237305,68720.47681945801,1,6,0,26,35645,2
100120,Furniture,114.78251647949219,2023-06-28,172,0,125.21336364746094,21536.69854736328,2,6,0,26,35817,2
100120,Furniture,114.78251647949219,2023-06-29,86,0,125.21336364746094,10768.34927368164,3,6,0,26,35903,2
100120,Furniture,114.78251647949219,2023-06-30,5,335,124.75598052978515,42358.959805297854,4,6,0,26,35908,2
100120,Furniture,114.78251647949219,2023-07-01,28,0,124.93196105957031,3498.0949096679688,5,7,1,26,35936,2
100120,Furniture,114.78251647949219,2023-07-02,195,663,150.59196228027344,133437.70528930664,6,7,1,26,36131,2
100120,Furniture,114.78251647949219,2023-07-03,138,0,141.55392456054688,19534.44158935547,0,7,0,27,36269,2
100120,Furniture,114.78251647949219,2023-07-04,24,0,141.55392456054688,3397.294189453125,1,7,0,27,36293,2
100120,Furniture,114.78251647949219,2023-07-05,61,0,141.55392456054688,8634.78939819336,2,7,0,27,36354,2
100120,Furniture,114.78251647949219,2023-07-06,112,0,141.55392456054688,15854.03955078125,3,7,0,27,36466,2
100120,Furniture,114.78251647949219,2023-07-07,48,0,141.55392456054688,6794.58837890625,4,7,0,27,36514,2
100120,Furniture,114.78251647949219,2023-07-08,100,0,141.55392456054688,14155.392456054688,5,7,1,27,36614,2
100120,Furniture,114.78251647949219,2023-07-09,40,0,141.55392456054688,5662.156982421875,6,7,1,27,36654,2
100120,Furniture,114.78251647949219,2023-07-10,119,0,141.55392456054688,16844.917022705078,0,7,0,28,36773,2
100120,Furniture,114.78251647949219,2023-07-11,68,0,141.55392456054688,9625.666870117188,1,7,0,28,36841,2
100120,Furniture,114.78251647949219,2023-07-12,79,0,141.55392456054688,11182.760040283203,2,7,0,28,36920,2
100120,Furniture,114.78251647949219,2023-07-13,58,0,141.55392456054688,8210.127624511719,3,7,0,28,36978,2
100120,Furniture,114.78251647949219,2023-07-14,32,0,141.55392456054688,4529.7255859375,4,7,0,28,37010,2
100120,Furniture,114.78251647949219,2023-07-15,44,0,141.55392456054688,6228.3726806640625,5,7,1,28,37054,2
100120,Furniture,114.78251647949219,2023-07-16,110,432,125.28878448486327,66673.65258666992,6,7,1,28,37164,2
100120,Furniture,114.78251647949219,2023-07-17,73,0,129.11756896972656,9425.582534790039,0,7,0,29,37237,2
100120,Furniture,114.78251647949219,2023-07-18,61,0,129.11756896972656,7876.17170715332,1,7,0,29,37298,2
100120,Furniture,114.78251647949219,2023-07-19,22,0,129.11756896972656,2840.5865173339844,2,7,0,29,37320,2
100120,Furniture,114.78251647949219,2023-07-20,82,0,129.11756896972656,10587.640655517578,3,7,0,29,37402,2
100120,Furniture,114.78251647949219,2023-07-21,55,0,129.11756896972656,7101.466293334961,4,7,0,29,37457,2
100120,Furniture,114.78251647949219,2023-07-22,126,495,105.16812225341798,63280.59680786133,5,7,1,29,37583,2
100120,Furniture,114.78251647949219,2023-07-23,68,0,110.66624450683594,7525.304626464844,6,7,1,29,37651,2
100120,Furniture,114.78251647949219,2023-07-24,93,0,110.66624450683594,10291.960739135742,0,7,0,30,37744,2
100120,Furniture,114.78251647949219,2023-07-25,8,0,110.66624450683594,885.3299560546875,1,7,0,30,37752,2
100120,Furniture,114.78251647949219,2023-07-26,65,472,111.92649047851563,60280.96376220703,2,7,0,30,37817,2
100120,Furniture,114.78251647949219,2023-07-27,86,0,111.49298095703125,9588.396362304688,3,7,0,30,37903,2
100120,Furniture,114.78251647949219,2023-07-28,55,0,111.49298095703125,6132.113952636719,4,7,0,30,37958,2
100120,Furniture,114.78251647949219,2023-07-29,100,0,111.49298095703125,11149.298095703125,5,7,1,30,38058,2
100120,Furniture,114.78251647949219,2023-07-30,68,0,111.49298095703125,7581.522705078125,6,7,1,30,38126,2
100120,Furniture,114.78251647949219,2023-07-31,64,0,111.49298095703125,7135.55078125,0,7,0,31,38190,2
100120,Furniture,114.78251647949219,2023-08-01,79,0,111.49298095703125,8807.945495605469,1,8,0,31,38269,2
100120,Furniture,114.78251647949219,2023-08-02,85,0,111.49298095703125,9476.903381347656,2,8,0,31,38354,2
100120,Furniture,114.78251647949219,2023-08-03,66,514,128.47127624511717,76506.36846435546,3,8,0,31,38420,2
100120,Furniture,114.78251647949219,2023-08-04,76,0,124.02255249023438,9425.713989257812,4,8,0,31,38496,2
100120,Furniture,114.78251647949219,2023-08-05,123,0,124.02255249023438,15254.773956298828,5,8,1,31,38619,2
100120,Furniture,114.78251647949219,2023-08-06,98,0,124.02255249023438,12154.210144042969,6,8,1,31,38717,2
100120,Furniture,114.78251647949219,2023-08-07,65,0,124.02255249023438,8061.465911865234,0,8,0,32,38782,2
100120,Furniture,114.78251647949219,2023-08-08,112,444,125.45688888549805,69914.42311035156,1,8,0,32,38894,2
100120,Furniture,114.78251647949219,2023-08-09,152,0,124.9737777709961,18996.014221191406,2,8,0,32,39046,2
100120,Furniture,114.78251647949219,2023-08-10,91,0,124.9737777709961,11372.613777160645,3,8,0,32,39137,2
100120,Furniture,114.78251647949219,2023-08-11,96,0,124.9737777709961,11997.482666015625,4,8,0,32,39233,2
100120,Furniture,114.78251647949219,2023-08-12,84,0,124.9737777709961,10497.797332763672,5,8,1,32,39317,2
100120,Furniture,114.78251647949219,2023-08-13,33,0,124.9737777709961,4124.134666442871,6,8,1,32,39350,2
100120,Furniture,114.78251647949219,2023-08-14,107,328,125.33112869262695,54545.31154022217,0,8,0,33,39457,2
100120,Furniture,114.78251647949219,2023-08-15,71,0,125.2122573852539,8890.070274353027,1,8,0,33,39528,2
100120,Furniture,114.78251647949219,2023-08-16,58,0,125.2122573852539,7262.310928344727,2,8,0,33,39586,2
100120,Furniture,114.78251647949219,2023-08-17,60,0,125.2122573852539,7512.735443115234,3,8,0,33,39646,2
100120,Furniture,114.78251647949219,2023-08-18,91,385,119.89180145263671,56571.10786437988,4,8,0,33,39737,2
100120,Furniture,114.78251647949219,2023-08-19,57,0,121.58360290527344,6930.265365600586,5,8,1,33,39794,2
100120,Furniture,114.78251647949219,2023-08-20,64,0,121.58360290527344,7781.3505859375,6,8,1,33,39858,2
100120,Furniture,114.78251647949219,2023-08-21,56,0,121.58360290527344,6808.6817626953125,0,8,0,34,39914,2
100120,Furniture,114.78251647949219,2023-08-22,112,404,131.71435867309572,69061.25634277344,1,8,0,34,40026,2
100120,Furniture,114.78251647949219,2023-08-23,38,0,127.9587173461914,4862.431259155273,2,8,0,34,40064,2
100120,Furniture,114.78251647949219,2023-08-24,76,0,127.9587173461914,9724.862518310547,3,8,0,34,40140,2
100120,Furniture,114.78251647949219,2023-08-25,76,0,127.9587173461914,9724.862518310547,4,8,0,34,40216,2
100120,Furniture,114.78251647949219,2023-08-26,51,0,127.9587173461914,6525.894584655762,5,8,1,34,40267,2
100120,Furniture,114.78251647949219,2023-08-27,77,0,127.9587173461914,9852.821235656738,6,8,1,34,40344,2
100120,Furniture,114.78251647949219,2023-08-28,71,0,127.9587173461914,9085.06893157959,0,8,0,35,40415,2
100120,Furniture,114.78251647949219,2023-08-29,54,0,127.9587173461914,6909.770736694336,1,8,0,35,40469,2
100120,Furniture,114.78251647949219,2023-08-30,82,393,123.41049102783202,58206.200528564455,2,8,0,35,40551,2
100120,Furniture,114.78251647949219,2023-08-31,69,0,124.74098205566406,8607.12776184082,3,8,0,35,40620,2
100120,Furniture,114.78251647949219,2023-09-01,49,0,124.74098205566406,6112.308120727539,4,9,0,35,40669,2
100120,Furniture,114.78251647949219,2023-09-02,26,0,124.74098205566406,3243.2655334472656,5,9,1,35,40695,2
100120,Furniture,114.78251647949219,2023-09-03,89,0,124.74098205566406,11101.947402954102,6,9,1,35,40784,2
100120,Furniture,114.78251647949219,2023-09-04,91,0,124.74098205566406,11351.42936706543,0,9,0,36,40875,2
100120,Furniture,114.78251647949219,2023-09-05,71,291,115.80025466918946,41233.23616302491,1,9,0,36,40946,2
100120,Furniture,114.78251647949219,2023-09-06,60,0,118.9205093383789,7135.230560302734,2,9,0,36,41006,2
100120,Furniture,114.78251647949219,2023-09-07,48,0,118.9205093383789,5708.1844482421875,3,9,0,36,41054,2
100120,Furniture,114.78251647949219,2023-09-08,44,0,118.9205093383789,5232.502410888672,4,9,0,36,41098,2
100120,Furniture,114.78251647949219,2023-09-09,74,0,118.9205093383789,8800.117691040039,5,9,1,36,41172,2
100120,Furniture,114.78251647949219,2023-09-10,91,361,106.5286311340332,47155.01086639404,6,9,1,36,41263,2
100120,Furniture,114.78251647949219,2023-09-11,90,0,110.2172622680664,9919.553604125977,0,9,0,37,41353,2
100120,Furniture,114.78251647949219,2023-09-12,35,0,110.2172622680664,3857.604179382324,1,9,0,37,41388,2
100120,Furniture,114.78251647949219,2023-09-13,85,524,116.15386840820312,71521.81762939453,2,9,0,37,41473,2
100120,Furniture,114.78251647949219,2023-09-14,183,0,114.36773681640625,20929.295837402344,3,9,0,37,41656,2
100120,Furniture,114.78251647949219,2023-09-15,74,0,114.36773681640625,8463.212524414062,4,9,0,37,41730,2
100120,Furniture,114.78251647949219,2023-09-16,71,0,114.36773681640625,8120.109313964844,5,9,1,37,41801,2
100120,Furniture,114.78251647949219,2023-09-17,84,0,114.36773681640625,9606.889892578125,6,9,1,37,41885,2
100120,Furniture,114.78251647949219,2023-09-18,106,0,114.36773681640625,12122.980102539062,0,9,0,38,41991,2
100120,Furniture,114.78251647949219,2023-09-19,63,0,114.36773681640625,7205.167419433594,1,9,0,38,42054,2
100120,Furniture,114.78251647949219,2023-09-20,166,466,133.82522674560545,86030.97527954102,2,9,0,38,42220,2
100120,Furniture,114.78251647949219,2023-09-21,61,0,128.98045349121094,7867.807662963867,3,9,0,38,42281,2
100120,Furniture,114.78251647949219,2023-09-22,55,0,128.98045349121094,7093.924942016602,4,9,0,38,42336,2
100120,Furniture,114.78251647949219,2023-09-23,27,0,128.98045349121094,3482.4722442626953,5,9,1,38,42363,2
100120,Furniture,114.78251647949219,2023-09-24,71,0,128.98045349121094,9157.612197875977,6,9,1,38,42434,2
100120,Furniture,114.78251647949219,2023-09-25,38,0,128.98045349121094,4901.257232666016,0,9,0,39,42472,2
100120,Furniture,114.78251647949219,2023-09-26,81,356,123.79253890991211,53620.89130340576,1,9,0,39,42553,2
100120,Furniture,114.78251647949219,2023-09-27,44,0,125.52507781982422,5523.103424072266,2,9,0,39,42597,2
100120,Furniture,114.78251647949219,2023-09-28,79,0,125.52507781982422,9916.481147766113,3,9,0,39,42676,2
100120,Furniture,114.78251647949219,2023-09-29,55,0,125.52507781982422,6903.879280090332,4,9,0,39,42731,2
100120,Furniture,114.78251647949219,2023-09-30,65,0,125.52507781982422,8159.130058288574,5,9,1,39,42796,2
100120,Furniture,114.78251647949219,2023-10-01,73,0,125.52507781982422,9163.330680847168,6,10,1,39,42869,2
100120,Furniture,114.78251647949219,2023-10-02,50,0,125.52507781982422,6276.253890991211,0,10,0,40,42919,2
100120,Furniture,114.78251647949219,2023-10-03,71,362,124.65403457641602,53907.092909851075,1,10,0,40,42990,2
100120,Furniture,114.78251647949219,2023-10-04,36,0,124.88806915283203,4495.970489501953,2,10,0,40,43026,2
100120,Furniture,114.78251647949219,2023-10-05,88,0,124.88806915283203,10990.150085449219,3,10,0,40,43114,2
100120,Furniture,114.78251647949219,2023-10-06,71,650,124.89761657714844,90052.56155395508,4,10,0,40,43185,2
100120,Furniture,114.78251647949219,2023-10-07,46,0,124.89523315429688,5745.180725097656,5,10,1,40,43231,2
100120,Furniture,114.78251647949219,2023-10-08,24,0,124.89523315429688,2997.485595703125,6,10,1,40,43255,2
100120,Furniture,114.78251647949219,2023-10-09,44,0,124.89523315429688,5495.3902587890625,0,10,0,41,43299,2
100120,Furniture,114.78251647949219,2023-10-10,21,0,124.89523315429688,2622.7998962402344,1,10,0,41,43320,2
100120,Furniture,114.78251647949219,2023-10-11,18,0,124.89523315429688,2248.1141967773438,2,10,0,41,43338,2
100120,Furniture,114.78251647949219,2023-10-12,24,0,124.89523315429688,2997.485595703125,3,10,0,41,43362,2
100120,Furniture,114.78251647949219,2023-10-13,33,0,124.89523315429688,4121.542694091797,4,10,0,41,43395,2
100120,Furniture,114.78251647949219,2023-10-14,37,0,124.89523315429688,4621.123626708984,5,10,1,41,43432,2
100120,Furniture,114.78251647949219,2023-10-15,31,0,124.89523315429688,3871.752227783203,6,10,1,41,43463,2
100120,Furniture,114.78251647949219,2023-10-16,23,0,124.89523315429688,2872.590362548828,0,10,0,42,43486,2
100120,Furniture,114.78251647949219,2023-10-17,39,0,124.89523315429688,4870.914093017578,1,10,0,42,43525,2
100120,Furniture,114.78251647949219,2023-10-18,31,0,124.89523315429688,3871.752227783203,2,10,0,42,43556,2
100120,Furniture,114.78251647949219,2023-10-19,24,0,124.89523315429688,2997.485595703125,3,10,0,42,43580,2
100120,Furniture,114.78251647949219,2023-10-20,25,0,124.89523315429688,3122.380828857422,4,10,0,42,43605,2
100120,Furniture,114.78251647949219,2023-10-21,35,0,124.89523315429688,4371.333160400391,5,10,1,42,43640,2
100120,Furniture,114.78251647949219,2023-10-22,27,0,124.89523315429688,3372.1712951660156,6,10,1,42,43667,2
100120,Furniture,114.78251647949219,2023-10-23,75,0,124.89523315429688,9367.142486572266,0,10,0,43,43742,2
100120,Furniture,114.78251647949219,2023-10-24,26,0,124.89523315429688,3247.2760620117188,1,10,0,43,43768,2
100120,Furniture,114.78251647949219,2023-10-25,91,0,124.89523315429688,11365.466217041016,2,10,0,43,43859,2
100120,Furniture,114.78251647949219,2023-10-26,114,517,130.13031097412107,82631.97090209961,3,10,0,43,43973,2
100120,Furniture,114.78251647949219,2023-10-27,48,0,128.8406219482422,6184.349853515625,4,10,0,43,44021,2
100120,Furniture,114.78251647949219,2023-10-28,43,0,128.8406219482422,5540.146743774414,5,10,1,43,44064,2
100120,Furniture,114.78251647949219,2023-10-29,52,0,128.8406219482422,6699.712341308594,6,10,1,43,44116,2
100120,Furniture,114.78251647949219,2023-10-30,74,0,128.8406219482422,9534.206024169922,0,10,0,44,44190,2
100120,Furniture,114.78251647949219,2023-10-31,65,0,128.8406219482422,8374.640426635742,1,10,0,44,44255,2
100120,Furniture,114.78251647949219,2023-11-01,53,0,128.8406219482422,6828.552963256836,2,11,0,44,44308,2
100120,Furniture,114.78251647949219,2023-11-02,32,0,128.8406219482422,4122.89990234375,3,11,0,44,44340,2
100120,Furniture,114.78251647949219,2023-11-03,91,368,117.10437316894532,52655.54591674805,4,11,0,44,44431,2
100120,Furniture,114.78251647949219,2023-11-04,59,0,121.05874633789062,7142.466033935547,5,11,1,44,44490,2
100120,Furniture,114.78251647949219,2023-11-05,51,0,121.05874633789062,6173.996063232422,6,11,1,44,44541,2
100120,Furniture,114.78251647949219,2023-11-06,59,0,121.05874633789062,7142.466033935547,0,11,0,45,44600,2
100120,Furniture,114.78251647949219,2023-11-07,68,0,121.05874633789062,8231.994750976562,1,11,0,45,44668,2
100120,Furniture,114.78251647949219,2023-11-08,37,0,121.05874633789062,4479.173614501953,2,11,0,45,44705,2
100120,Furniture,114.78251647949219,2023-11-09,12,0,121.05874633789062,1452.7049560546875,3,11,0,45,44717,2
100120,Furniture,114.78251647949219,2023-11-10,87,338,112.46365127563476,47040.62532196045,4,11,0,45,44804,2
100120,Furniture,114.78251647949219,2023-11-11,36,0,115.47730255126953,4157.182891845703,5,11,1,45,44840,2
100120,Furniture,114.78251647949219,2023-11-12,49,0,115.47730255126953,5658.387825012207,6,11,1,45,44889,2
100120,Furniture,114.78251647949219,2023-11-13,58,0,115.47730255126953,6697.683547973633,0,11,0,46,44947,2
100120,Furniture,114.78251647949219,2023-11-14,71,482,127.28379913330077,71985.16947692871,1,11,0,46,45018,2
100120,Furniture,114.78251647949219,2023-11-15,100,0,123.39759826660156,12339.759826660156,2,11,0,46,45118,2
100120,Furniture,114.78251647949219,2023-11-16,62,0,123.39759826660156,7650.651092529297,3,11,0,46,45180,2
100120,Furniture,114.78251647949219,2023-11-17,50,0,123.39759826660156,6169.879913330078,4,11,0,46,45230,2
100120,Furniture,114.78251647949219,2023-11-18,47,0,123.39759826660156,5799.687118530273,5,11,1,46,45277,2
100120,Furniture,114.78251647949219,2023-11-19,83,0,123.39759826660156,10242.00065612793,6,11,1,46,45360,2
100120,Furniture,114.78251647949219,2023-11-20,36,0,123.39759826660156,4442.313537597656,0,11,0,47,45396,2
100120,Furniture,114.78251647949219,2023-11-21,44,0,123.39759826660156,5429.494323730469,1,11,0,47,45440,2
100120,Furniture,114.78251647949219,2023-11-22,72,0,123.39759826660156,8884.627075195312,2,11,0,47,45512,2
100120,Furniture,114.78251647949219,2023-11-23,24,0,123.39759826660156,2961.5423583984375,3,11,0,47,45536,2
100120,Furniture,114.78251647949219,2023-11-24,47,0,123.39759826660156,5799.687118530273,4,11,0,47,45583,2
100120,Furniture,114.78251647949219,2023-11-25,81,251,109.9248454284668,35605.12495941162,5,11,1,47,45664,2
100120,Furniture,114.78251647949219,2023-11-26,104,515,122.18757019042968,76563.96459960938,6,11,1,47,45768,2
100120,Furniture,114.78251647949219,2023-11-27,81,0,119.92514038085938,9713.93637084961,0,11,0,48,45849,2
100120,Furniture,114.78251647949219,2023-11-28,41,0,119.92514038085938,4916.930755615234,1,11,0,48,45890,2
100120,Furniture,114.78251647949219,2023-11-29,105,0,119.92514038085938,12592.139739990234,2,11,0,48,45995,2
100120,Furniture,114.78251647949219,2023-11-30,39,0,119.92514038085938,4677.080474853516,3,11,0,48,46034,2
100120,Furniture,114.78251647949219,2023-12-01,115,0,119.92514038085938,13791.391143798828,4,12,0,48,46149,2
100120,Furniture,114.78251647949219,2023-12-02,126,566,117.06051071166992,80609.64869934082,5,12,1,48,46275,2
100120,Furniture,114.78251647949219,2023-12-03,76,0,117.96102142333984,8965.037628173828,6,12,1,48,46351,2
100120,Furniture,114.78251647949219,2023-12-04,72,0,117.96102142333984,8493.193542480469,0,12,0,49,46423,2
100120,Furniture,114.78251647949219,2023-12-05,85,0,117.96102142333984,10026.686820983887,1,12,0,49,46508,2
100120,Furniture,114.78251647949219,2023-12-06,72,0,117.96102142333984,8493.193542480469,2,12,0,49,46580,2
100120,Furniture,114.78251647949219,2023-12-07,62,0,117.96102142333984,7313.58332824707,3,12,0,49,46642,2
100120,Furniture,114.78251647949219,2023-12-08,63,0,117.96102142333984,7431.54434967041,4,12,0,49,46705,2
100120,Furniture,114.78251647949219,2023-12-09,42,0,117.96102142333984,4954.362899780273,5,12,1,49,46747,2
100120,Furniture,114.78251647949219,2023-12-10,47,0,117.96102142333984,5544.168006896973,6,12,1,49,46794,2
100120,Furniture,114.78251647949219,2023-12-11,115,471,108.60026794433594,62578.78162719727,0,12,0,50,46909,2
100120,Furniture,114.78251647949219,2023-12-12,48,0,111.58053588867188,5355.86572265625,1,12,0,50,46957,2
100120,Furniture,114.78251647949219,2023-12-13,131,0,111.58053588867188,14617.050201416016,2,12,0,50,47088,2
100120,Furniture,114.78251647949219,2023-12-14,78,0,111.58053588867188,8703.281799316406,3,12,0,50,47166,2
100120,Furniture,114.78251647949219,2023-12-15,56,0,111.58053588867188,6248.510009765625,4,12,0,50,47222,2
100120,Furniture,114.78251647949219,2023-12-16,121,515,127.65764953613281,83212.41118774413,5,12,1,50,47343,2
100120,Furniture,114.78251647949219,2023-12-17,87,0,122.52529907226562,10659.70101928711,6,12,1,50,47430,2
100120,Furniture,114.78251647949219,2023-12-18,56,0,122.52529907226562,6861.416748046875,0,12,0,51,47486,2
100120,Furniture,114.78251647949219,2023-12-19,105,0,122.52529907226562,12865.15640258789,1,12,0,51,47591,2
100120,Furniture,114.78251647949219,2023-12-20,81,0,122.52529907226562,9924.549224853516,2,12,0,51,47672,2
100120,Furniture,114.78251647949219,2023-12-21,43,0,122.52529907226562,5268.587860107422,3,12,0,51,47715,2
100120,Furniture,114.78251647949219,2023-12-22,111,0,122.52529907226562,13600.308197021484,4,12,0,51,47826,2
100120,Furniture,114.78251647949219,2023-12-23,65,380,121.28385513305665,53837.801167297366,5,12,1,51,47891,2
100120,Furniture,114.78251647949219,2023-12-24,50,0,121.70771026611328,6085.385513305664,6,12,1,51,47941,2
100120,Furniture,114.78251647949219,2023-12-25,106,0,121.70771026611328,12901.017288208008,0,12,0,52,48047,2
100120,Furniture,114.78251647949219,2023-12-26,47,0,121.70771026611328,5720.262382507324,1,12,0,52,48094,2
100120,Furniture,114.78251647949219,2023-12-27,46,0,121.70771026611328,5598.554672241211,2,12,0,52,48140,2
100120,Furniture,114.78251647949219,2023-12-28,19,0,121.70771026611328,2312.4464950561523,3,12,0,52,48159,2
100120,Furniture,114.78251647949219,2023-12-29,33,0,121.70771026611328,4016.3544387817383,4,12,0,52,48192,2
100120,Furniture,114.78251647949219,2023-12-30,18,0,121.70771026611328,2190.738784790039,5,12,1,52,48210,2
100120,Furniture,114.78251647949219,2023-12-31,18,0,121.70771026611328,2190.738784790039,6,12,1,52,48228,2
100120,Furniture,114.78251647949219,2024-01-01,18,0,121.70771026611328,2190.738784790039,0,1,0,1,48246,2
100120,Furniture,114.78251647949219,2024-01-02,24,0,121.70771026611328,2920.9850463867188,1,1,0,1,48270,2
100120,Furniture,114.78251647949219,2024-01-03,22,0,121.70771026611328,2677.569625854492,2,1,0,1,48292,2
100120,Furniture,114.78251647949219,2024-01-04,21,0,121.70771026611328,2555.861915588379,3,1,0,1,48313,2
100120,Furniture,114.78251647949219,2024-01-05,61,253,112.53849349975586,34699.93620697022,4,1,0,1,48374,2
100120,Furniture,114.78251647949219,2024-01-06,27,0,115.85698699951172,3128.1386489868164,5,1,1,1,48401,2
100120,Furniture,114.78251647949219,2024-01-07,13,0,115.85698699951172,1506.1408309936523,6,1,1,1,48414,2
100120,Furniture,114.78251647949219,2024-01-08,27,0,115.85698699951172,3128.1386489868164,0,1,0,2,48441,2
100120,Furniture,114.78251647949219,2024-01-09,69,0,115.85698699951172,7994.132102966309,1,1,0,2,48510,2
100120,Furniture,114.78251647949219,2024-01-10,72,0,115.85698699951172,8341.703063964844,2,1,0,2,48582,2
100120,Furniture,114.78251647949219,2024-01-11,77,458,125.00210754394531,67671.61456176758,3,1,0,2,48659,2
100120,Furniture,114.78251647949219,2024-01-12,82,0,122.91421508789062,10078.965637207031,4,1,0,2,48741,2
100120,Furniture,114.78251647949219,2024-01-13,35,0,122.91421508789062,4301.997528076172,5,1,1,2,48776,2
100120,Furniture,114.78251647949219,2024-01-14,51,0,122.91421508789062,6268.624969482422,6,1,1,2,48827,2
100120,Furniture,114.78251647949219,2024-01-15,40,0,122.91421508789062,4916.568603515625,0,1,0,3,48867,2
100120,Furniture,114.78251647949219,2024-01-16,80,0,122.91421508789062,9833.13720703125,1,1,0,3,48947,2
100120,Furniture,114.78251647949219,2024-01-17,81,0,122.91421508789062,9956.05142211914,2,1,0,3,49028,2
100120,Furniture,114.78251647949219,2024-01-18,136,452,111.62219985961914,64783.11836181641,3,1,0,3,49164,2
100120,Furniture,114.78251647949219,2024-01-19,68,0,114.31439971923828,7773.379180908203,4,1,0,3,49232,2
100120,Furniture,114.78251647949219,2024-01-20,69,0,114.31439971923828,7887.693580627441,5,1,1,3,49301,2
100120,Furniture,114.78251647949219,2024-01-21,10,473,117.54120330810547,57262.624066162105,6,1,1,3,49311,2
100120,Furniture,114.78251647949219,2024-01-22,64,0,116.48240661621094,7454.8740234375,0,1,0,4,49375,2
100120,Furniture,114.78251647949219,2024-01-23,85,0,116.48240661621094,9901.00456237793,1,1,0,4,49460,2
100120,Furniture,114.78251647949219,2024-01-24,52,0,116.48240661621094,6057.085144042969,2,1,0,4,49512,2
100120,Furniture,114.78251647949219,2024-01-25,52,0,116.48240661621094,6057.085144042969,3,1,0,4,49564,2
100120,Furniture,114.78251647949219,2024-01-26,48,0,116.48240661621094,5591.155517578125,4,1,0,4,49612,2
100120,Furniture,114.78251647949219,2024-01-27,90,0,116.48240661621094,10483.416595458984,5,1,1,4,49702,2
100120,Furniture,114.78251647949219,2024-01-28,118,0,116.48240661621094,13744.92398071289,6,1,1,4,49820,2
100120,Furniture,114.78251647949219,2024-01-29,83,0,116.48240661621094,9668.039749145508,0,1,0,5,49903,2
100120,Furniture,114.78251647949219,2024-01-30,54,248,113.6412582397461,34098.25588989258,1,1,0,5,49957,2
